阿巴卡韦	a ba ka wei	1
阿巴卡韦拉米夫定	a ba ka wei la mi fu ding	1
阿巴卡韦双夫定	a ba ka wei shuang fu ding	1
阿柏西普	a bai xi pu	1
阿苯	a ben	1
阿苯达唑	a ben da zuo	1
阿比多尔	a bi duo er	1
阿比特龙	a bi te long	1
阿达木单抗	a da mu dan kang	1
阿达帕林	a da pa lin	1
阿德福韦酯	a de fu wei zhi	1
阿尔维林	a er wei lin	1
阿法骨化醇	a fa gu hua chun	1
阿伐斯汀	a fa si ting	1
阿法替尼	a fa ti ni	1
阿酚咖	a fen ka	1
阿酚咖敏	a fen ka min	1
阿夫唑嗪	a fu zuo qin	1
阿格列汀	a ge lie ting	1
阿戈美拉汀	a ge mei la ting	1
阿加曲班	a jia qu ban	1
阿桔	a ju	1
阿咖	a ka	1
阿卡波糖	a ka bo tang	1
阿咖酚	a ka fen	1
阿克他利	a ke ta li	1
阿来替尼	a lai ti ni	1
阿利吉仑	a li ji lun	1
阿立哌唑	a li pai zuo	1
阿利沙坦酯	a li sha tan zhi	1
阿仑膦酸钠	a lun lin suan na	1
阿仑膦酸钠维	a lun lin suan na wei	1
阿罗洛尔	a luo luo er	1
阿洛西林	a luo xi lin	1
阿米卡星	a mi ka xing	1
阿米卡星氯化钠	a mi ka xing lv hua na	1
阿米洛利	a mi luo li	1
阿米替林	a mi ti lin	1
阿莫地喹	a mo di kui	1
阿莫罗芬	a mo luo fen	1
阿莫西林	a mo xi lin	1
阿莫西林氟氯西林	a mo xi lin fu lv xi lin	1
阿莫西林克拉维酸	a mo xi lin ke la wei suan	1
阿莫西林舒巴坦	a mo xi lin shu ba tan	1
阿莫西林舒巴坦匹酯	a mo xi lin shu ba tan pi zhi	1
阿莫西林双氯西林	a mo xi lin shuang lv xi lin	1
阿那曲唑	a na qu zuo	1
阿帕替尼	a pa ti ni	1
阿哌沙班	a pai sha ban	1
阿片	a pian	1
阿普林定	a pu lin ding	1
阿扑吗啡	a pu ma fei	1
阿普唑仑	a pu zuo lun	1
阿奇霉素	a qi mei su	1
阿奇霉素枸橼酸二氢钠	a qi mei su ju yuan suan er qing na	1
阿奇霉素磷酸二氢钠	a qi mei su lin suan er qing na	1
阿奇霉素氯化钠	a qi mei su lv hua na	1
阿奇霉素葡萄糖	a qi mei su pu tao tang	1
阿曲库铵	a qu ku an	1
阿柔比星	a rou bi xing	1
阿瑞匹坦	a rui pi tan	1
阿舒瑞韦	a shu rui wei	1
阿司待因	a si dai yin	1
阿司可咖	a si ke ka	1
阿司匹林	a si pi lin	1
阿司匹林可待因	a si pi lin ke dai yin	1
阿司匹林双嘧达莫	a si pi lin shuang mi da mo	1
阿司匹林维	a si pi lin wei	1
阿糖胞苷	a tang bao gan	1
阿糖苷酶	a tang gan mei	1
阿糖腺苷	a tang xian gan	1
阿替卡因肾上腺素	a ti ka yin shen shang xian su	1
阿替洛尔	a ti luo er	1
阿替普酶	a ti pu mei	1
阿托伐他汀	a tuo fa ta ting	1
阿托品	a tuo pin	1
阿托品异丙嗪	a tuo pin yi bing qin	1
阿托西班	a tuo xi ban	1
阿维	a wei	1
阿魏酸钠	a wei suan na	1
阿魏酸钠氯化钠	a wei suan na lv hua na	1
阿魏酸钠葡萄糖	a wei suan na pu tao tang	1
阿魏酸哌嗪	a wei suan pai qin	1
阿昔洛韦	a xi luo wei	1
阿昔洛韦氯化钠	a xi luo wei lv hua na	1
阿昔洛韦葡萄糖	a xi luo wei pu tao tang	1
阿西美辛	a xi mei xin	1
阿昔莫司	a xi mo si	1
阿昔替尼	a xi ti ni	1
阿扎胞苷	a zha bao gan	1
阿扎那韦	a zha na wei	1
阿扎司琼	a zha si qiong	1
阿扎司琼氯化钠	a zha si qiong lv hua na	1
阿折地平	a zhe di ping	1
艾博韦泰	ai bo wei tai	1
艾地苯醌	ai di ben kun	1
艾多沙班	ai duo sha ban	1
艾尔巴韦格拉瑞韦	ai er ba wei ge la rui wei	1
癌抗原免疫放射分析药盒	ai kang yuan mian yi fang she fen xi yao he	1
艾考恩丙替	ai kao en bing ti	1
埃克替尼	ai ke ti ni	1
艾拉莫德	ai la mo de	1
艾美赛珠单抗	ai mei sai zhu dan kang	1
癌胚抗原放免药盒	ai pei kang yuan fang mian yao he	1
癌胚抗原放射免疫分析药盒	ai pei kang yuan fang she mian yi fen xi yao he	1
艾普拉唑	ai pu la zuo	1
爱普列特	ai pu lie te	1
艾曲泊帕乙醇胺	ai qu bo pa yi chun an	1
艾瑞昔布	ai rui xi bu	1
艾塞那肽	ai sai na tai	1
艾司洛尔	ai si luo er	1
艾司西酞普兰	ai si xi tai pu lan	1
艾司唑仑	ai si zuo lun	1
埃索美拉唑艾司奥美拉唑	ai suo mei la zuo ai si ao mei la zuo	1
安吖啶	an a ding	1
桉氨	an an	1
氨苯蝶啶	an ben die ding	1
氨苯蝶啶氢氯噻嗪	an ben die ding qing lv sai qin	1
氨苯砜	an ben feng	1
氨苯伪麻	an ben wei ma	1
氨苄西林	an bian xi lin	1
氨苄西林丙磺舒	an bian xi lin bing huang shu	1
氨苄西林氯唑西林	an bian xi lin lv zuo xi lin	1
氨苄西林舒巴坦	an bian xi lin shu ba tan	1
氨茶碱	an cha jian	1
氨茶碱氯化钠	an cha jian lv hua na	1
氨碘肽	an dian tai	1
胺碘酮	an dian tong	1
氨丁三醇	an ding san chun	1
氨非咖	an fei ka	1
氨非咖敏	an fei ka min	1
安非他酮	an fei ta tong	1
氨酚巴妥	an fen ba tuo	1
氨酚比林	an fen bi lin	1
氨酚柴胡	an fen chai hu	1
氨酚待因	an fen dai yin	1
氨酚甲硫氨酸	an fen jia liu an suan	1
氨酚咖黄烷胺	an fen ka huang wan an	1
氨酚咖那敏	an fen ka na min	1
氨酚咖匹林	an fen ka pi lin	1
氨酚拉明	an fen la ming	1
氨酚氯雷伪麻	an fen lv lei wei ma	1
氨酚氯汀伪麻	an fen lv ting wei ma	1
氨酚麻美	an fen ma mei	1
氨酚美芬伪麻	an fen mei fen wei ma	1
氨酚美伪	an fen mei wei	1
氨酚那敏三味浸膏	an fen na min san wei jin gao	1
氨酚那敏维那敏	an fen na min wei na min	1
氨酚帕马溴	an fen pa ma xiu	1
氨酚匹林咖啡因	an fen pi lin ka fei yin	1
氨酚羟考酮	an fen qiang kao tong	1
氨酚氢可酮	an fen qing ke tong	1
氨酚曲麻	an fen qu ma	1
氨酚曲马多	an fen qu ma duo	1
氨酚沙芬	an fen sha fen	1
氨酚双氢可待因	an fen shuang qing ke dai yin	1
氨酚烷胺咖敏	an fen wan an ka min	1
氨酚烷胺那敏	an fen wan an na min	1
氨酚维	an fen wei	1
氨酚伪麻	an fen wei ma	1
氨酚伪麻氯汀	an fen wei ma lv ting	1
氨酚伪麻美芬	an fen wei ma mei fen	1
氨酚伪麻美芬氨麻美敏	an fen wei ma mei fen an ma mei min	1
氨酚伪麻美芬苯酚伪麻	an fen wei ma mei fen ben fen wei ma	1
氨酚伪麻那敏	an fen wei ma na min	1
氨酚异丙嗪	an fen yi bing qin	1
氨酚右敏	an fen you min	1
氨磺必利	an huang bi li	1
氨基比林咖啡因	an ji bi lin ka fei yin	1
氨基己酸	an ji ji suan	1
氨基己酸氯化钠	an ji ji suan lv hua na	1
氨基葡萄糖	an ji pu tao tang	1
氨基葡萄糖氯化钾	an ji pu tao tang lv hua jia	1
氨基酸	an ji suan	1
氨基酸葡萄糖	an ji suan pu tao tang	1
氨甲苯酸	an jia ben suan	1
氨甲苯酸氯化钠	an jia ben suan lv hua na	1
氨甲苯酸葡萄糖	an jia ben suan pu tao tang	1
氨甲环酸	an jia huan suan	1
氨甲环酸氯化钠	an jia huan suan lv hua na	1
氨金黄敏	an jin huang min	1
氨咖甘	an ka gan	1
氨咖黄敏	an ka huang min	1
氨咖柳胺	an ka liu an	1
氨咖麻敏	an ka ma min	1
氨咖敏	an ka min	1
氨咖愈敏	an ka yu min	1
氨来呫诺	an lai tie nuo	1
氨酪酸	an lao suan	1
氨酪酸氯化钠	an lao suan lv hua na	1
氨力农	an li nong	1
安立生坦	an li sheng tan	1
氨林酚咖	an lin fen ka	1
氨磷汀	an lin ting	1
氨硫脲	an liu niao	1
氨鲁米特	an lu mi te	1
安罗替尼	an luo ti ni	1
氨氯地平	an lv di ping	1
氨氯地平阿托伐他汀	an lv di ping a tuo fa ta ting	1
氨氯地平贝那普利	an lv di ping bei na pu li	1
氨氯地平叶酸	an lv di ping ye suan	1
氨麻苯美	an ma ben mei	1
氨麻美敏	an ma mei min	1
氨麻美明	an ma mei ming	1
氨麻溴敏	an ma xiu min	1
安眠酮	an mian tong	1
安那度尔	an na du er	1
安钠咖	an na ka	1
安乃近	an nai jin	1
安乃近氯丙嗪	an nai jin lv bing qin	1
桉柠蒎	an ning pai	1
安普乐定	an pu le ding	1
氨曲南	an qu nan	1
安他唑啉	an ta zuo lin	1
氨肽素	an tai su	1
氨肽素硫酸锌	an tai su liu suan xin	1
氨糖美辛	an tang mei xin	1
氨酮戊酸	an tong wu suan	1
安妥沙星	an tuo sha xing	1
氨溴索	an xiu suo	1
氨溴索氯化钠	an xiu suo lv hua na	1
氨溴索葡萄糖	an xiu suo pu tao tang	1
氨溴特罗	an xiu te luo	1
桉油尿素	an you niao su	1
氨愈美麻	an yu mei ma	1
昂丹司琼	ang dan si qiong	1
昂丹司琼氯化钠	ang dan si qiong lv hua na	1
昂丹司琼葡萄糖	ang dan si qiong pu tao tang	1
奥比帕利	ao bi pa li	1
奥布卡因	ao bu ka yin	1
奥达特罗	ao da te luo	1
奥氮平	ao dan ping	1
奥芬溴铵	ao fen xiu an	1
奥卡西平	ao ka xi ping	1
奥拉米特	ao la mi te	1
奥拉帕利	ao la pa li	1
奥拉西坦	ao la xi tan	1
奥利司他	ao li si ta	1
奥洛他定	ao luo ta ding	1
奥马珠单抗	ao ma zhu dan kang	1
奥美拉唑	ao mei la zuo	1
奥美拉唑碳酸氢钠	ao mei la zuo tan suan qing na	1
奥美沙坦酯	ao mei sha tan zhi	1
奥美沙坦酯氨氯地平	ao mei sha tan zhi an lv di ping	1
奥美沙坦酯氢氯噻嗪	ao mei sha tan zhi qing lv sai qin	1
奥普力农	ao pu li nong	1
奥曲肽	ao qu tai	1
奥沙拉秦	ao sha la qin	1
奥沙利铂	ao sha li bo	1
奥沙利铂甘露醇	ao sha li bo gan lu chun	1
奥沙普秦	ao sha pu qin	1
奥沙西泮	ao sha xi pan	1
奥司他韦	ao si ta wei	1
奥替溴铵	ao ti xiu an	1
奥昔布宁	ao xi bu ning	1
奥昔非君	ao xi fei jun	1
奥昔康唑	ao xi kang zuo	1
奥希替尼	ao xi ti ni	1
奥硝唑	ao xiao zuo	1
奥硝唑氯化钠	ao xiao zuo lv hua na	1
奥硝唑葡萄糖	ao xiao zuo pu tao tang	1
奥扎格雷	ao zha ge lei	1
奥扎格雷氯化钠	ao zha ge lei lv hua na	1
奥扎格雷葡萄糖	ao zha ge lei pu tao tang	1
巴氨西林	ba an xi lin	1
巴利昔单抗	ba li xi dan kang	1
巴柳氮钠	ba liu dan na	1
巴龙霉素	ba long mei su	1
巴洛沙星	ba luo sha xing	1
巴氯芬	ba lv fen	1
巴尼地平	ba ni di ping	1
巴曲酶	ba qu mei	1
八维钙锌	ba wei gai xin	1
白蛋白放射免疫分析药盒	bai dan bai fang she mian yi fen xi yao he	1
白蛋白放射免疫诊断试剂	bai dan bai fang she mian yi zhen duan shi ji	1
白喉抗毒素	bai hou kang du su	1
白眉蛇毒血凝酶	bai mei she du xue ning mei	1
白葡奈氏菌	bai pu nai shi jun	1
白葡萄球菌	bai pu tao qiu jun	1
百日咳菌苗	bai ri ke jun miao	1
百日咳疫苗	bai ri ke yi miao	1
白芍总苷	bai shao zong gan	1
白消安	bai xiao an	1
班布特罗	ban bu te luo	1
半胱氨酸	ban guang an suan	1
斑蝥素	ban mao su	1
斑蝥酸钠	ban mao suan na	1
斑蝥酸钠维生素	ban mao suan na wei sheng su	1
半水合雌二醇	ban shui he ci er chun	1
胞磷胆碱	bao lin dan jian	1
胞磷胆碱胞二磷胆碱	bao lin dan jian bao er lin dan jian	1
胞磷胆碱肌苷	bao lin dan jian ji gan	1
胞磷胆碱氯化钠	bao lin dan jian lv hua na	1
胞磷胆碱葡萄糖	bao lin dan jian pu tao tang	1
包醛氧淀粉	bao quan yang dian fen	1
保泰松	bao tai song	1
棓丙酯	bei bing zhi	1
棓丙酯氯化钠	bei bing zhi lv hua na	1
棓丙酯葡萄糖	bei bing zhi pu tao tang	1
贝达喹啉	bei da kui lin	1
贝伐珠单抗	bei fa zhu dan kang	1
贝凡洛尔	bei fan luo er	1
倍氯米松	bei lv mi song	1
倍氯米松福莫特罗	bei lv mi song fu mo te luo	1
贝美格	bei mei ge	1
贝美前列素	bei mei qian lie su	1
贝美素噻吗洛尔	bei mei su sai ma luo er	1
贝米肝素钠	bei mi gan su na	1
贝敏伪麻	bei min wei ma	1
贝那鲁肽	bei na lu tai	1
贝那普利	bei na pu li	1
贝那普利氢氯噻嗪	bei na pu li qing lv sai qin	1
贝那替秦	bei na ti qin	1
贝尼地平	bei ni di ping	1
贝诺酯	bei nuo zhi	1
贝诺酯维	bei nuo zhi wei	1
北芪精	bei qi jing	1
贝前列素	bei qian lie su	1
倍他胡萝卜素	bei ta hu luo bo su	1
倍他洛尔	bei ta luo er	1
倍他米松	bei ta mi song	1
倍他米松新霉素	bei ta mi song xin mei su	1
倍他司汀	bei ta si ting	1
贝他斯汀	bei ta si ting	1
倍他司汀氯化钠	bei ta si ting lv hua na	1
苯氨咪唑啉	ben an mi zuo lin	1
苯巴比妥	ben ba bi tuo	1
苯巴比妥东莨菪碱	ben ba bi tuo dong lang dang jian	1
苯丙氨酯	ben bing an zhi	1
苯丙醇	ben bing chun	1
苯丙哌林	ben bing pai lin	1
苯丙酸诺龙	ben bing suan nuo long	1
苯达莫司汀	ben da mo si ting	1
苯丁酸氮芥	ben ding suan dan jie	1
苯酚伪麻	ben fen wei ma	1
苯海拉明	ben hai la ming	1
苯海拉明薄荷脑	ben hai la ming bo he nao	1
苯海索	ben hai suo	1
苯环壬酯	ben huan ren zhi	1
苯磺顺阿曲库铵	ben huang shun a qu ku an	1
苯甲醇	ben jia chun	1
苯甲酸	ben jia suan	1
苯甲酸苄酯	ben jia suan bian zhi	1
苯甲酸雌二醇	ben jia suan ci er chun	1
苯甲托品	ben jia tuo pin	1
苯羟甲胺	ben qiang jia an	1
苯噻啶	ben sai ding	1
苯妥英钠	ben tuo ying na	1
本维莫德	ben wei mo de	1
本芴醇	ben wu chun	1
苯西卤铵	ben xi lu an	1
苯酰甲硝唑	ben xian jia xiao zuo	1
苯溴马隆	ben xiu ma long	1
苯扎贝特	ben zha bei te	1
苯扎氯铵	ben zha lv an	1
苯扎溴铵	ben zha xiu an	1
苯佐卡因	ben zuo ka yin	1
苯唑西林	ben zuo xi lin	1
比阿培南	bi a pei nan	1
吡贝地尔	bi bei di er	1
比伐芦定	bi fa lu ding	1
吡非尼酮	bi fei ni tong	1
吡格列酮	bi ge lie tong	1
吡格列酮二甲双胍	bi ge lie tong er jia shuang gua	1
比卡鲁胺	bi ka lu an	1
吡喹酮	bi kui tong	1
吡拉西坦	bi la xi tan	1
吡拉西坦氯化钠	bi la xi tan lv hua na	1
吡拉西坦葡萄糖	bi la xi tan pu tao tang	1
吡拉西坦乙酰胺吡咯烷酮	bi la xi tan yi xian an bi luo wan tong	1
吡硫醇	bi liu chun	1
吡硫醇氯化钠	bi liu chun lv hua na	1
吡硫醇葡萄糖	bi liu chun pu tao tang	1
吡硫翁	bi liu weng	1
吡硫翁锌	bi liu weng xin	1
吡咯替尼	bi luo ti ni	1
吡罗昔康	bi luo xi kang	1
铋镁豆蔻	bi mei dou kou	1
吡美莫司	bi mei mo si	1
铋镁碳酸氢钠	bi mei tan suan qing na	1
吡嘧司特	bi mi si te	1
吡诺克辛	bi nuo ke xin	1
吡哌酸	bi pai suan	1
吡嗪酰胺	bi qin xian an	1
吡柔比星	bi rou bi xing	1
比沙可啶	bi sha ke ding	1
比索洛尔	bi suo luo er	1
比索洛尔氢氯噻嗪	bi suo luo er qing lv sai qin	1
苄达赖氨酸	bian da lai an suan	1
苄达明	bian da ming	1
苄氟噻嗪	bian fu sai qin	1
苄普地尔	bian pu di er	1
苄星青霉素	bian xing qing mei su	1
变应原抗原溶媒	bian ying yuan kang yuan rong mei	1
表柔比星	biao rou bi xing	1
标准桃金娘油	biao zhun tao jin niang you	1
别嘌醇	bie piao chun	1
丙氨瑞林	bing an rui lin	1
丙氨酰谷氨酰胺	bing an xian gu an xian an	1
丙吡胺	bing bi an	1
丙泊酚	bing bo fen	1
丙泊酚中长链脂肪乳	bing bo fen zhong chang lian zhi fang ru	1
丙酚替诺福韦	bing fen ti nuo fu wei	1
丙谷胺	bing gu an	1
丙磺舒	bing huang shu	1
丙卡巴肼	bing ka ba jing	1
丙卡特罗	bing ka te luo	1
丙硫氧嘧啶	bing liu yang mi ding	1
丙硫异烟胺	bing liu yi yan an	1
丙美卡因	bing mei ka yin	1
丙米嗪	bing mi qin	1
丙帕他莫	bing pa ta mo	1
丙哌维林	bing pai wei lin	1
丙酸睾酮	bing suan gao tong	1
丙酸氯倍他索	bing suan lv bei ta suo	1
丙戊酸镁	bing wu suan mei	1
丙戊酸钠	bing wu suan na	1
丙戊酰胺	bing wu xian an	1
丙型肝炎病毒抗体诊断试剂盒	bing xing gan yan bing du kang ti zhen duan shi ji he	1
冰樟桉氟轻松	bing zhang an fu qing song	1
伯氨喹	bo an kui	1
博安霉素	bo an mei su	1
薄荷桉油	bo he an you	1
薄荷喉	bo he hou	1
薄荷茴桉苯甲酸钠	bo he hui an ben jia suan na	1
薄荷尿素	bo he niao su	1
薄荷麝香草	bo he she xiang cao	1
博来霉素	bo lai mei su	1
玻璃酸酶	bo li suan mei	1
玻璃酸钠	bo li suan na	1
菠萝蛋白酶	bo luo dan bai mei	1
泊沙康唑	bo sha kang zuo	1
波生坦	bo sheng tan	1
薄芝糖肽	bo zhi tang tai	1
布比卡因	bu bi ka yin	1
布地奈德	bu di nai de	1
布地奈德福莫特罗	bu di nai de fu mo te luo	1
布酚宁	bu fen ning	1
布桂嗪	bu gui qin	1
布康唑	bu kang zuo	1
布拉氏酵母菌	bu la shi jiao mu jun	1
布林佐胺	bu lin zuo an	1
布林佐胺噻吗洛尔	bu lin zuo an sai ma luo er	1
布洛芬	bu luo fen	1
布洛伪麻	bu luo wei ma	1
布洛伪麻那敏	bu luo wei ma na min	1
布美他尼	bu mei ta ni	1
布南色林	bu nan se lin	1
布氏菌活疫苗	bu shi jun huo yi miao	1
布氏菌素	bu shi jun su	1
布替萘芬	bu ti nai fen	1
布托啡诺	bu tuo fei nuo	1
补液盐	bu ye yan	1
参皇	can huang	1
参维灵	can wei ling	1
参芎葡萄糖	can xiong pu tao tang	1
草分枝杆菌	cao fen zhi gan jun	1
草木犀流浸液	cao mu xi liu jin ye	1
草乌甲素	cao wu jia su	1
层粘连蛋白放射免疫分析药盒	ceng zhan lian dan bai fang she mian yi fen xi yao he	1
茶苯海明	cha ben hai ming	1
茶碱	cha jian	1
茶碱氯化钠	cha jian lv hua na	1
茶碱麻黄碱	cha jian ma huang jian	1
茶碱葡萄糖	cha jian pu tao tang	1
茶碱沙丁胺醇	cha jian sha ding an chun	1
茶碱愈创甘油醚	cha jian yu chuang gan you mi	1
茶新那敏	cha xin na min	1
茶愈	cha yu	1
长春胺	chang chun an	1
长春地辛	chang chun di xin	1
长春碱	chang chun jian	1
长春瑞滨	chang chun rui bin	1
长春西汀	chang chun xi ting	1
长春西汀氯化钠	chang chun xi ting lv hua na	1
长春西汀葡萄糖	chang chun xi ting pu tao tang	1
长春新碱	chang chun xin jian	1
肠道病毒型灭活疫苗细胞	chang dao bing du xing mie huo yi miao xi bao	1
肠多糖	chang duo tang	1
长链脂肪乳	chang lian zhi fang ru	1
肠内营养粉	chang nei ying yang fen	1
肠内营养剂	chang nei ying yang ji	1
肠外营养液	chang wai ying yang ye	1
橙皮	cheng pi	1
赤芝孢子多糖	chi zhi bao zi duo tang	1
虫草被孢菌	chong cao bei bao jun	1
虫草胶雷菌	chong cao jiao lei jun	1
虫草头孢菌	chong cao tou bao jun	1
重组促卵泡素	chong zu cu luan pao su	1
重组带状疱疹疫苗细胞	chong zu dai zhuang pao zhen yi miao xi bao	1
重组改构人肿瘤坏死因子	chong zu gai gou ren zhong liu huai si yin zi	1
重组甘精胰岛素	chong zu gan jing yi dao su	1
重组抗人源化单克隆抗体	chong zu kang ren yuan hua dan ke long kang ti	1
重组赖脯胰岛素	chong zu lai pu yi dao su	1
重组链激酶	chong zu lian ji mei	1
重组牛碱性成纤维细胞生长因子	chong zu niu jian xing cheng xian wei xi bao sheng zhang yin zi	1
重组葡激酶	chong zu pu ji mei	1
重组人白介素	chong zu ren bai jie su	1
重组人白介素酵母	chong zu ren bai jie su jiao mu	1
重组人表皮生长因子	chong zu ren biao pi sheng zhang yin zi	1
重组人表皮生长因子酵母	chong zu ren biao pi sheng zhang yin zi jiao mu	1
重组人表皮生长因子衍生物	chong zu ren biao pi sheng zhang yin zi yan sheng wu	1
重组人促红素细胞	chong zu ren cu hong su xi bao	1
重组人促黄体激素	chong zu ren cu huang ti ji su	1
重组人促卵泡激素	chong zu ren cu luan pao ji su	1
重组人干扰素	chong zu ren gan rao su	1
重组人干扰素假单胞菌	chong zu ren gan rao su jia dan bao jun	1
重组人干扰素酵母	chong zu ren gan rao su jiao mu	1
重组人碱性成纤维细胞生长因子	chong zu ren jian xing cheng xian wei xi bao sheng zhang yin zi	1
重组人粒细胞刺激因子	chong zu ren li xi bao ci ji yin zi	1
重组人粒细胞刺激因子细胞	chong zu ren li xi bao ci ji yin zi xi bao	1
重组人粒细胞巨噬细胞刺激因子	chong zu ren li xi bao ju shi xi bao ci ji yin zi	1
重组人脑利钠肽	chong zu ren nao li na tai	1
重组人尿激酶原	chong zu ren niao ji mei yuan	1
重组人凝血因子	chong zu ren ning xue yin zi	1
重组人绒促性素	chong zu ren rong cu xing su	1
重组人生长激素	chong zu ren sheng zhang ji su	1
重组人酸性成纤维细胞生长因子	chong zu ren suan xing cheng xian wei xi bao sheng zhang yin zi	1
重组人腺病毒	chong zu ren xian bing du	1
重组人型腺病毒	chong zu ren xing xian bing du	1
重组人血管内皮抑制素	chong zu ren xue guan nei pi yi zhi su	1
重组人血小板生成素	chong zu ren xue xiao ban sheng cheng su	1
重组人胰岛素	chong zu ren yi dao su	1
重组人组织型纤溶酶原激活剂	chong zu ren zu zhi xing xian rong mei yuan ji huo ji	1
重组特立帕肽	chong zu te li pa tai	1
重组戊型肝炎疫苗大肠埃希菌	chong zu wu xing gan yan yi miao da chang ai xi jun	1
重组细胞因子基因衍生蛋白	chong zu xi bao yin zi ji yin yan sheng dan bai	1
重组亚单位菌体霍乱疫苗	chong zu ya dan wei jun ti huo luan yi miao	1
重组乙型肝炎疫苗汉逊酵母	chong zu yi xing gan yan yi miao han xun jiao mu	1
重组乙型肝炎疫苗酒酿酵母	chong zu yi xing gan yan yi miao jiu niang jiao mu	1
重组乙型肝炎疫苗细胞	chong zu yi xing gan yan yi miao xi bao	1
穿琥宁	chuan hu ning	1
穿琥宁氯化钠	chuan hu ning lv hua na	1
川芎嗪	chuan xiong qin	1
川芎嗪氯化钠	chuan xiong qin lv hua na	1
川芎嗪葡萄糖	chuan xiong qin pu tao tang	1
垂体后叶	chui ti hou ye	1
垂体前叶肾上腺皮质提取物	chui ti qian ye shen shang xian pi zhi ti qu wu	1
雌二醇	ci er chun	1
雌二醇雌二醇地屈孕酮	ci er chun ci er chun di qu yun tong	1
雌二醇屈螺酮	ci er chun qu luo tong	1
雌二醇炔诺酮	ci er chun que nuo tong	1
雌莫司汀	ci mo si ting	1
雌三醇	ci san chun	1
次水杨酸铋	ci shui yang suan bi	1
次硝酸铋碱式硝酸铋	ci xiao suan bi jian shi xiao suan bi	1
醋氨苯砜	cu an ben feng	1
醋氨己酸锌	cu an ji suan xin	1
醋丙氢可的松	cu bing qing ke di song	1
促肝细胞生长素	cu gan xi bao sheng zhang su	1
促甲状腺激素放免药盒	cu jia zhuang xian ji su fang mian yao he	1
醋甲唑胺	cu jia zuo an	1
醋柳黄酮	cu liu huang tong	1
醋氯芬酸	cu lv fen suan	1
促皮质素	cu pi zhi su	1
醋羟胺酸	cu qiang an suan	1
醋酸钙	cu suan gai	1
醋酸钠林格	cu suan na lin ge	1
醋硝香豆素	cu xiao xiang dou su	1
达比加群酯	da bi jia qun zhi	1
达泊西汀	da bo xi ting	1
大豆磷脂	da dou lin zhi	1
达肝素钠	da gan su na	1
达格列净	da ge lie jing	1
大观霉素	da guan mei su	1
大黄碳酸氢钠	da huang tan suan qing na	1
大黄叶绿素铜	da huang ye lv su tong	1
达卡巴嗪	da ka ba qin	1
达克罗宁	da ke luo ning	1
达克罗宁氯己定硫	da ke luo ning lv ji ding liu	1
达可替尼	da ke ti ni	1
达拉他韦	da la ta wei	1
大流行流感病毒裂解疫苗	da liu xing liu gan bing du lie jie yi miao	1
大流行流感病毒灭活疫苗	da liu xing liu gan bing du mie huo yi miao	1
达芦那韦	da lu na wei	1
达芦那韦考比司他	da lu na wei kao bi si ta	1
达那唑	da na zuo	1
达诺瑞韦	da nuo rui wei	1
达塞布韦	da sai bu wei	1
达沙替尼	da sha ti ni	1
大蒜	da suan	1
大蒜素	da suan su	1
达托霉素	da tuo mei su	1
蛋白琥珀酸铁	dan bai hu po suan tie	1
胆茶碱	dan cha jian	1
氮甲	dan jia	1
胆碱	dan jian	1
氮芥	dan jie	1
单磷酸阿糖腺苷	dan lin suan a tang xian gan	1
单氯芬那酸	dan lv fen na suan	1
丹皮酚	dan pi fen	1
丹曲林	dan qu lin	1
丹参川芎嗪	dan shen chuan xiong qin	1
丹参酮	dan shen tong	1
氮斯汀	dan si ting	1
胆酸钠	dan suan na	1
单糖浆	dan tang jiang	1
单唾液酸四己糖神经节苷脂	dan tuo ye suan si ji tang shen jing jie gan zhi	1
胆维丁	dan wei ding	1
单硝酸异山梨酯	dan xiao suan yi shan li zhi	1
单硝酸异山梨酯氯化钠	dan xiao suan yi shan li zhi lv hua na	1
单硝酸异山梨酯葡萄糖	dan xiao suan yi shan li zhi pu tao tang	1
胆影葡胺	dan ying pu an	1
胆汁槟榔维	dan zhi bing lang wei	1
氮卓斯汀	dan zhuo si ting	1
锝比西酯	de bi xi zhi	1
锝二巯丁二酸盐	de er qiu ding er suan yan	1
德谷门冬双胰岛素	de gu men dong shuang yi dao su	1
德谷胰岛素	de gu yi dao su	1
锝甲氧异腈	de jia yang yi jing	1
锝聚合白蛋白	de ju he bai dan bai	1
德拉马尼	de la ma ni	1
锝喷替酸盐	de pen ti suan yan	1
锝双半胱氨酸	de shuang ban guang an suan	1
锝双半胱乙酯	de shuang ban guang yi zhi	1
锝司它比	de si ta bi	1
锝替曲膦	de ti qu lin	1
锝亚甲基二膦酸盐	de ya jia ji er lin suan yan	1
锝依替菲宁	de yi ti fei ning	1
锝植酸盐	de zhi suan yan	1
地奥司明	di ao si ming	1
地巴唑	di ba zuo	1
地蒽酚	di en fen	1
地尔硫	di er liu	1
地芬尼多	di fen ni duo	1
低分子肝素	di fen zi gan su	1
地氟烷	di fu wan	1
低钙腹膜透析液	di gai fu mo tou xi ye	1
地高辛	di gao xin	1
地红霉素	di hong mei su	1
地加瑞克	di jia rui ke	1
低精蛋白锌胰岛素	di jing dan bai xin yi dao su	1
地夸磷索	di kua lin suo	1
地喹氯铵	di kui lv an	1
地喹氯铵短杆菌素	di kui lv an duan gan jun su	1
地拉罗司	di la luo si	1
地拉卓	di la zhuo	1
地氯雷他定	di lv lei ta ding	1
地美索酯	di mei suo zhi	1
地奈德	di nai de	1
地诺前列素	di nuo qian lie su	1
地诺前列酮	di nuo qian lie tong	1
地诺孕素	di nuo yun su	1
地匹福林	di pi fu lin	1
地屈孕酮	di qu yun tong	1
地塞米松	di sai mi song	1
地塞米松磷酸钠	di sai mi song lin suan na	1
地塞米松棕榈酸酯	di sai mi song zong lv suan zhi	1
地舒单抗	di shu dan kang	1
地特胰岛素	di te yi dao su	1
地西泮	di xi pan	1
地西他滨	di xi ta bin	1
地衣芽孢杆菌活菌	di yi ya bao gan jun huo jun	1
地佐辛	di zuo xin	1
碘癌胚抗原放射免疫分析药盒	dian ai pei kang yuan fang she mian yi fen xi yao he	1
碘白蛋白放射免疫分析药盒	dian bai dan bai fang she mian yi fen xi yao he	1
碘苯酯	dian ben zhi	1
碘比醇	dian bi chun	1
碘雌二醇放射免疫分析药盒	dian ci er chun fang she mian yi fen xi yao he	1
碘雌三醇放射免疫分析药盒	dian ci san chun fang she mian yi fen xi yao he	1
碘催乳素放射免疫分析药盒	dian cui ru su fang she mian yi fen xi yao he	1
碘地高辛放射免疫分析药盒	dian di gao xin fang she mian yi fen xi yao he	1
碘酊	dian ding	1
碘番酸	dian fan suan	1
淀粉酶	dian fen mei	1
碘佛醇	dian fo chun	1
碘苷	dian gan	1
碘甘胆酸放射免疫分析药盒	dian gan dan suan fang she mian yi fen xi yao he	1
碘甘油	dian gan you	1
碘睾酮放射免疫分析药盒	dian gao tong fang she mian yi fen xi yao he	1
碘海醇	dian hai chun	1
碘化铵	dian hua an	1
碘化钾	dian hua jia	1
碘化钠	dian hua na	1
碘化油	dian hua you	1
碘甲胎蛋白放射免疫分析药盒	dian jia tai dan bai fang she mian yi fen xi yao he	1
碘甲状腺球蛋白抗体分析药盒	dian jia zhuang xian qiu dan bai kang ti fen xi yao he	1
碘甲状腺素放射免疫分析药盒	dian jia zhuang xian su fang she mian yi fen xi yao he	1
碘甲状腺微粒体抗体分析药盒	dian jia zhuang xian wei li ti kang ti fen xi yao he	1
碘解磷定	dian jie lin ding	1
碘聚醇醚	dian ju chun mi	1
碘克沙醇	dian ke sha chun	1
碘克沙酸葡胺	dian ke sha suan pu an	1
碘美普尔	dian mei pu er	1
碘美妥昔单抗	dian mei tuo xi dan kang	1
碘美妥昔单抗皮试制	dian mei tuo xi dan kang pi shi zhi	1
碘密封籽源	dian mi feng zi yuan	1
碘免疫球蛋白放射免疫分析药盒	dian mian yi qiu dan bai fang she mian yi fen xi yao he	1
碘帕醇	dian pa chun	1
碘皮质醇放射免疫分析药盒	dian pi zhi chun fang she mian yi fen xi yao he	1
碘普罗胺	dian pu luo an	1
碘羟拉葡胺	dian qiang la pu an	1
颠茄	dian qie	1
颠茄磺苄啶	dian qie huang bian ding	1
碘曲仑	dian qu lun	1
碘醛固酮放射免疫分析药盒	dian quan gu tong fang she mian yi fen xi yao he	1
碘人生长激素放射免疫分析药盒	dian ren sheng zhang ji su fang she mian yi fen xi yao he	1
碘人肽放射免疫分析药盒	dian ren tai fang she mian yi fen xi yao he	1
碘塞罗宁	dian sai luo ning	1
碘散	dian san	1
碘酸钾	dian suan jia	1
碘他拉葡甲胺	dian ta la pu jia an	1
碘糖	dian tang	1
碘糖蛋白放射免疫分析药盒	dian tang dan bai fang she mian yi fen xi yao he	1
碘糖类抗原免疫放射分析药盒	dian tang lei kang yuan mian yi fang she fen xi yao he	1
碘铁蛋白放射免疫分析药盒	dian tie dan bai fang she mian yi fen xi yao he	1
碘脱氧核糖核酸抗体分析药盒	dian tuo yang he tang he suan kang ti fen xi yao he	1
碘胃泌素放射免疫分析药盒	dian wei mi su fang she mian yi fen xi yao he	1
碘微球蛋白放射免疫分析药盒	dian wei qiu dan bai fang she mian yi fen xi yao he	1
碘心钠素放射免疫分析药盒	dian xin na su fang she mian yi fen xi yao he	1
碘血管紧张素放射免疫分析药盒	dian xue guan jin zhang su fang she mian yi fen xi yao he	1
靛胭脂	dian yan zhi	1
碘胰岛素放射免疫分析药盒	dian yi dao su fang she mian yi fen xi yao he	1
碘胰高血糖素放射免疫分析药盒	dian yi gao xue tang su fang she mian yi fen xi yao he	1
靛玉红	dian yu hong	1
碘孕酮放射免疫分析药盒	dian yun tong fang she mian yi fen xi yao he	1
丁胺卡那霉素	ding an ka na mei su	1
丁苯羟酸	ding ben qiang suan	1
丁苯酞	ding ben tai	1
丁苯酞氯化钠	ding ben tai lv hua na	1
丁丙诺啡	ding bing nuo fei	1
丁丙诺啡纳洛酮	ding bing nuo fei na luo tong	1
丁卡因	ding ka yin	1
丁螺环酮	ding luo huan tong	1
丁硼	ding peng	1
丁酸氢化可的松	ding suan qing hua ke di song	1
丁香罗勒油	ding xiang luo le you	1
丁溴东莨菪碱	ding xiu dong lang dang jian	1
冻疮膏	dong chuang gao	1
东莨菪碱	dong lang dang jian	1
动物源长效胰岛素	dong wu yuan chang xiao yi dao su	1
动物源短效胰岛素	dong wu yuan duan xiao yi dao su	1
动物源预混胰岛素	dong wu yuan yu hun yi dao su	1
动物源中效胰岛素	dong wu yuan zhong xiao yi dao su	1
豆腐果苷	dou fu guo gan	1
痘苗病毒致炎兔皮提取物	dou miao bing du zhi yan tu pi ti qu wu	1
度拉糖肽	du la tang tai	1
度洛西汀	du luo xi ting	1
毒毛花苷	du mao hua gan	1
度米芬	du mi fen	1
度他雄胺	du ta xiong an	1
杜香油	du xiang you	1
短棒杆菌	duan bang gan jun	1
短肽型肠内营养剂	duan tai xing chang nei ying yang ji	1
对氨基水杨酸钙	dui an ji shui yang suan gai	1
对氨基水杨酸钠	dui an ji shui yang suan na	1
对伞花烃	dui san hua ting	1
对乙酰氨基酚	dui yi xian an ji fen	1
对乙酰氨基酚维生素	dui yi xian an ji fen wei sheng su	1
对乙酰氨基酚异丙嗪	dui yi xian an ji fen yi bing qin	1
多巴胺	duo ba an	1
多巴酚丁胺	duo ba fen ding an	1
多巴酚丁胺葡萄糖	duo ba fen ding an pu tao tang	1
多巴丝肼	duo ba si jing	1
多磺酸粘多糖	duo huang suan nian duo tang	1
多价气性坏疽抗毒素	duo jia qi xing huai ju kang du su	1
多库酯钠	duo ku zhi na	1
多库酯钠丹蒽醌	duo ku zhi na dan en kun	1
多拉司琼	duo la si qiong	1
多酶	duo mei	1
多奈哌齐	duo nai pai qi	1
多萘哌齐	duo nai pai qi	1
多粘菌素多粘菌素	duo nian jun su duo nian jun su	1
多廿烷醇	duo nian wan chun	1
多潘立酮	duo pan li tong	1
多柔比星	duo rou bi xing	1
多塞平	duo sai ping	1
多沙普仑	duo sha pu lun	1
多沙唑嗪	duo sha zuo qin	1
多司马酯	duo si ma zhi	1
多索茶碱	duo suo cha jian	1
多索茶碱氯化钠	duo suo cha jian lv hua na	1
多索茶碱葡萄糖	duo suo cha jian pu tao tang	1
多糖蛋白	duo tang dan bai	1
多糖铁复合物	duo tang tie fu he wu	1
多替阿巴拉米	duo ti a ba la mi	1
多替拉韦	duo ti la wei	1
多维	duo wei	1
多维赖氨酸	duo wei lai an suan	1
多维铁	duo wei tie	1
多维元素	duo wei yuan su	1
多西环素	duo xi huan su	1
多烯磷脂酰胆碱	duo xi lin zhi xian dan jian	1
多烯酸乙酯	duo xi suan yi zhi	1
多西他赛	duo xi ta sai	1
多种微量元素	duo zhong wei liang yuan su	1
多种维生素	duo zhong wei sheng su	1
多种维生素种复合维生素	duo zhong wei sheng su zhong fu he wei sheng su	1
多种油脂肪乳	duo zhong you zhi fang ru	1
厄贝沙坦	e bei sha tan	1
厄贝沙坦氢氯噻嗪	e bei sha tan qing lv sai qin	1
厄多司坦	e duo si tan	1
厄洛替尼	e luo ti ni	1
鹅去氧胆酸	e qu yang dan suan	1
厄他培南	e ta pei nan	1
莪术油	e zhu you	1
莪术油葡萄糖	e zhu you pu tao tang	1
恩氟烷	en fu wan	1
恩夫韦肽	en fu wei tai	1
恩格列净	en ge lie jing	1
恩曲利替	en qu li ti	1
恩曲他滨	en qu ta bin	1
恩曲他滨丙酚替诺福韦	en qu ta bin bing fen ti nuo fu wei	1
恩曲他滨替诺福韦	en qu ta bin ti nuo fu wei	1
恩他卡朋	en ta ka peng	1
恩他卡朋双多巴	en ta ka peng shuang duo ba	1
恩替卡韦	en ti ka wei	1
二氮嗪	er dan qin	1
二丁酰环磷腺苷	er ding xian huan lin xian gan	1
二氟尼柳	er fu ni liu	1
二甲弗林	er jia fu lin	1
二甲硅油	er jia gui you	1
二甲双胍	er jia shuang gua	1
二甲双胍恩格列净	er jia shuang gua en ge lie jing	1
二甲双胍格列本脲	er jia shuang gua ge lie ben niao	1
二甲双胍格列吡嗪	er jia shuang gua ge lie bi qin	1
二甲双胍格列齐特	er jia shuang gua ge lie qi te	1
二甲双胍马来酸罗格列酮	er jia shuang gua ma lai suan luo ge lie tong	1
二甲双胍维格列汀	er jia shuang gua wei ge lie ting	1
二磷酸果糖	er lin suan guo tang	1
二硫化硒	er liu hua xi	1
二氯醋酸二异丙胺葡萄糖酸钠	er lv cu suan er yi bing an pu tao tang suan na	1
二氯乙酸二异丙胺	er lv yi suan er yi bing an	1
二羟丙茶碱	er qiang bing cha jian	1
二羟丙茶碱氯化钠	er qiang bing cha jian lv hua na	1
二氢埃托啡	er qing ai tuo fei	1
二氢加兰他敏	er qing jia lan ta min	1
二氢麦角碱	er qing mai jiao jian	1
二氢麦角隐亭	er qing mai jiao yin ting	1
二巯丙醇	er qiu bing chun	1
二巯丙磺钠	er qiu bing huang na	1
二巯丁二钠	er qiu ding er na	1
二巯丁二酸	er qiu ding er suan	1
二十二醇	er shi er chun	1
儿童标准桃金娘油	er tong biao zhun tao jin niang you	1
儿童复方氨酚肾素	er tong fu fang an fen shen su	1
儿童维钙	er tong wei gai	1
二维呋喃唑酮	er wei fu nan zuo tong	1
二维钙赖氨酸	er wei gai lai an suan	1
二维葡钙	er wei pu gai	1
二维葡磷钙	er wei pu lin gai	1
二维葡醛内酯	er wei pu quan nei zhi	1
二维三七桂利嗪	er wei san qi gui li qin	1
二维亚铁	er wei ya tie	1
二维鱼肝油	er wei yu gan you	1
二溴甘露醇	er xiu gan lu chun	1
二氧丙嗪	er yang bing qin	1
二氧丙嗪苯丙哌林	er yang bing qin ben bing pai lin	1
二氧异丙嗪	er yang yi bing qin	1
二乙基二硫代氨基甲酸钠	er yi ji er liu dai an ji jia suan na	1
二乙酰氨乙酸乙二胺	er yi xian an yi suan yi er an	1
二乙酰氨乙酸乙二胺氯化钠	er yi xian an yi suan yi er an lv hua na	1
二乙酰氨乙酸乙二胺葡萄糖	er yi xian an yi suan yi er an pu tao tang	1
伐地那非	fa di na fei	1
法可林	fa ke lin	1
法罗培南	fa luo pei nan	1
法莫替丁	fa mo ti ding	1
法莫替丁钙镁	fa mo ti ding gai mei	1
法莫替丁氯化钠	fa mo ti ding lv hua na	1
法莫替丁葡萄糖	fa mo ti ding pu tao tang	1
伐尼克兰	fa ni ke lan	1
法舒地尔	fa shu di er	1
伐昔洛韦	fa xi luo wei	1
泛硫乙胺	fan liu yi an	1
反三碘甲腺原氨酸放免药盒	fan san dian jia xian yuan an suan fang mian yao he	1
泛酸钙	fan suan gai	1
泛昔洛韦	fan xi luo wei	1
泛影葡胺	fan ying pu an	1
泛影酸钠	fan ying suan na	1
放射性碘化钠	fang she xing dian hua na	1
放线菌素	fang xian jun su	1
非布丙醇	fei bu bing chun	1
非布司他	fei bu si ta	1
非洛地平	fei luo di ping	1
非那吡啶	fei na bi ding	1
非那雄胺	fei na xiong an	1
非尼拉敏萘甲唑啉	fei ni la min nai jia zuo lin	1
非诺贝特	fei nuo bei te	1
非诺洛芬	fei nuo luo fen	1
非普拉宗	fei pu la zong	1
非索非那定	fei suo fei na ding	1
肺炎球菌多糖疫苗	fei yan qiu jun duo tang yi miao	1
酚氨咖敏	fen an ka min	1
酚苄明	fen bian ming	1
芬布芬	fen bu fen	1
粉尘螨	fen chen man	1
粉尘螨皮肤点刺诊断试剂盒	fen chen man pi fu dian ci zhen duan shi ji he	1
酚磺酞	fen huang tai	1
酚磺乙胺	fen huang yi an	1
酚磺乙胺氯化钠	fen huang yi an lv hua na	1
酚磺乙胺葡萄糖	fen huang yi an pu tao tang	1
酚咖	fen ka	1
酚咖麻敏	fen ka ma min	1
酚麻美	fen ma mei	1
酚麻美敏	fen ma mei min	1
酚美愈伪麻	fen mei yu wei ma	1
酚明伪麻	fen ming wei ma	1
奋乃静	fen nai jing	1
酚酞	fen tai	1
芬太尼	fen tai ni	1
酚妥拉明	fen tuo la ming	1
蜂毒	feng du	1
蜂胶	feng jiao	1
风疹减毒活疫苗人二倍体细胞	feng zhen jian du huo yi miao ren er bei ti xi bao	1
风疹减毒活疫苗兔肾细胞	feng zhen jian du huo yi miao tu shen xi bao	1
氟胞嘧啶	fu bao mi ding	1
氟胞嘧啶氯化钠	fu bao mi ding lv hua na	1
氟比洛芬	fu bi luo fen	1
氟比洛芬酯	fu bi luo fen zhi	1
氟吡汀	fu bi ting	1
呋苄西林	fu bian xi lin	1
呋布西林	fu bu xi lin	1
氟达拉滨	fu da la bin	1
福多司坦	fu duo si tan	1
福尔可定	fu er ke ding	1
氟伐他汀	fu fa ta ting	1
复方阿苯达唑	fu fang a ben da zuo	1
复方阿嗪米特	fu fang a qin mi te	1
复方阿司匹林	fu fang a si pi lin	1
复方阿替卡因	fu fang a ti ka yin	1
复方阿托品麻黄碱	fu fang a tuo pin ma huang jian	1
复方阿魏酸钠阿司匹林	fu fang a wei suan na a si pi lin	1
复方氨苯蝶啶	fu fang an ben die ding	1
复方氨茶碱	fu fang an cha jian	1
复方氨茶碱暴马子	fu fang an cha jian bao ma zi	1
复方氨酚苯海拉明	fu fang an fen ben hai la ming	1
复方氨酚穿心莲	fu fang an fen chuan xin lian	1
复方氨酚甲麻	fu fang an fen jia ma	1
复方氨酚美沙	fu fang an fen mei sha	1
复方氨酚那敏	fu fang an fen na min	1
复方氨酚葡锌	fu fang an fen pu xin	1
复方氨酚肾素	fu fang an fen shen su	1
复方氨酚烷胺	fu fang an fen wan an	1
复方氨酚溴敏	fu fang an fen xiu min	1
复方氨酚愈敏	fu fang an fen yu min	1
复方氨基比林	fu fang an ji bi lin	1
复方氨基比林茶碱	fu fang an ji bi lin cha jian	1
复方氨基丁酸维	fu fang an ji ding suan wei	1
复方氨基嘌呤	fu fang an ji piao ling	1
复方氨基酸	fu fang an ji suan	1
复方氨基酸双肽	fu fang an ji suan shuang tai	1
复方氨基酸维生素	fu fang an ji suan wei sheng su	1
复方氨基酸脂质	fu fang an ji suan zhi zhi	1
复方氨林巴比妥	fu fang an lin ba bi tuo	1
复方氨敏狗仔花	fu fang an min gou zai hua	1
复方氨敏虎杖	fu fang an min hu zhang	1
复方氨肽素	fu fang an tai su	1
复方氨维	fu fang an wei	1
复方安息香酊	fu fang an xi xiang ding	1
复方八维甲睾酮	fu fang ba wei jia gao tong	1
复方保泰松鸡血藤	fu fang bao tai song ji xue teng	1
复方北豆根氨酚那敏	fu fang bei dou gen an fen na min	1
复方倍氯米松新霉素	fu fang bei lv mi song xin mei su	1
复方倍氯米松樟脑无极膏	fu fang bei lv mi song zhang nao wu ji gao	1
复方贝母氯化铵	fu fang bei mu lv hua an	1
复方倍他胡萝卜素	fu fang bei ta hu luo bo su	1
复方倍他米松	fu fang bei ta mi song	1
复方苯巴比妥溴化钠	fu fang ben ba bi tuo xiu hua na	1
复方苯海拉明	fu fang ben hai la ming	1
复方苯海拉明克罗米通	fu fang ben hai la ming ke luo mi tong	1
复方苯海拉明麻黄碱	fu fang ben hai la ming ma huang jian	1
复方苯甲酸	fu fang ben jia suan	1
复方苯硝那敏	fu fang ben xiao na min	1
复方苯佐卡因	fu fang ben zuo ka yin	1
复方吡拉西坦	fu fang bi la xi tan	1
复方吡拉西坦脑蛋白水解物	fu fang bi la xi tan nao dan bai shui jie wu	1
复方别嘌醇	fu fang bie piao chun	1
复方丙谷胺	fu fang bing gu an	1
复方丙谷胺西咪替丁	fu fang bing gu an xi mi ti ding	1
复方丙酸氯倍他索	fu fang bing suan lv bei ta suo	1
复方薄荷柳酯	fu fang bo he liu zhi	1
复方薄荷脑	fu fang bo he nao	1
复方菠萝蛋白酶	fu fang bo luo dan bai mei	1
复方薄樟桉	fu fang bo zhang an	1
复方布洛芬	fu fang bu luo fen	1
复方茶碱	fu fang cha jian	1
复方茶碱甲麻黄碱	fu fang cha jian jia ma huang jian	1
复方茶碱麻黄碱	fu fang cha jian ma huang jian	1
复方茶酮	fu fang cha tong	1
复方川芎吲哚美辛	fu fang chuan xiong yin duo mei xin	1
复方雌二醇	fu fang ci er chun	1
复方次没食子酸铋	fu fang ci mei shi zi suan bi	1
复方刺五加硫胺	fu fang ci wu jia liu an	1
复方醋酸钠	fu fang cu suan na	1
复方醋酸钠林格	fu fang cu suan na lin ge	1
复方醋酸曲安奈德	fu fang cu suan qu an nai de	1
复方达克罗宁薄荷	fu fang da ke luo ning bo he	1
复方胆氨	fu fang dan an	1
复方蛋氨酸胆碱	fu fang dan an suan dan jian	1
复方单硝酸异山梨酯	fu fang dan xiao suan yi shan li zhi	1
复方当归亚铁	fu fang dang gui ya tie	1
复方地巴唑氢氯噻嗪	fu fang di ba zuo qing lv sai qin	1
复方地蒽酚	fu fang di en fen	1
复方地芬诺酯	fu fang di fen nuo zhi	1
复方地塞米松	fu fang di sai mi song	1
复方地舍平	fu fang di she ping	1
复方地西泮	fu fang di xi pan	1
复方淀粉酶	fu fang dian fen mei	1
复方碘苷	fu fang dian gan	1
复方电解质	fu fang dian jie zhi	1
复方电解质葡萄糖	fu fang dian jie zhi pu tao tang	1
复方颠茄铋镁	fu fang dian qie bi mei	1
复方颠茄氢氧化铝	fu fang dian qie qing yang hua lv	1
复方颠茄碳酸氢钠	fu fang dian qie tan suan qing na	1
复方颠茄维	fu fang dian qie wei	1
复方碘溶液	fu fang dian rong ye	1
复方丁香罗勒	fu fang ding xiang luo le	1
复方东莨菪碱	fu fang dong lang dang jian	1
复方独活吲哚美辛	fu fang du huo yin duo mei xin	1
复方对乙酰氨基酚	fu fang dui yi xian an ji fen	1
复方对乙酰氨基酚金银花	fu fang dui yi xian an ji fen jin yin hua	1
复方多粘菌素	fu fang duo nian jun su	1
复方莪术油	fu fang e zhu you	1
复方儿茶	fu fang er cha	1
复方二甲双胍格列吡嗪	fu fang er jia shuang gua ge lie bi qin	1
复方二氯醋酸二异丙胺	fu fang er lv cu suan er yi bing an	1
复方二氧丙嗪茶碱	fu fang er yang bing qin cha jian	1
复方泛影葡胺	fu fang fan ying pu an	1
复方酚苄明	fu fang fen bian ming	1
复方酚咖伪麻	fu fang fen ka wei ma	1
复方福尔可定	fu fang fu er ke ding	1
复方氟米松	fu fang fu mi song	1
复方呋喃西林	fu fang fu nan xi lin	1
复方氟尿嘧啶	fu fang fu niao mi ding	1
复方氟轻松	fu fang fu qing song	1
复方氟轻松尿素	fu fang fu qing song niao su	1
复方呋塞米	fu fang fu sai mi	1
复方甘氨酸茶碱	fu fang gan an suan cha jian	1
复方甘铋镁	fu fang gan bi mei	1
复方甘草	fu fang gan cao	1
复方甘草氯化铵	fu fang gan cao lv hua an	1
复方甘草铝镁	fu fang gan cao lv mei	1
复方甘草麻黄碱	fu fang gan cao ma huang jian	1
复方甘草酸铵	fu fang gan cao suan an	1
复方甘草酸单铵	fu fang gan cao suan dan an	1
复方甘草酸单铵氯化钠	fu fang gan cao suan dan an lv hua na	1
复方甘草甜素复方甘草酸苷	fu fang gan cao tian su fu fang gan cao suan gan	1
复方甘草浙贝氯化铵	fu fang gan cao zhe bei lv hua an	1
复方肝浸膏	fu fang gan jin gao	1
复方甘菊利多卡因	fu fang gan ju li duo ka yin	1
复方甘露醇	fu fang gan lu chun	1
复方肝水解物	fu fang gan shui jie wu	1
复方肝素尿囊素	fu fang gan su niao nang su	1
复方甘油	fu fang gan you	1
复方葛根氢氯噻嗪	fu fang ge gen qing lv sai qin	1
复方庚酸炔诺酮	fu fang geng suan que nuo tong	1
复方谷氨酰胺	fu fang gu an xian an	1
复方骨肽	fu fang gu tai	1
复方贯众阿司匹林	fu fang guan zhong a si pi lin	1
复方胱氨酸	fu fang guang an suan	1
复方蒿甲醚	fu fang hao jia mi	1
复方虎杖氨敏	fu fang hu zhang an min	1
复方环磷酰胺	fu fang huan lin xian an	1
复方磺胺对甲氧嘧啶	fu fang huang an dui jia yang mi ding	1
复方磺胺甲噁唑	fu fang huang an jia e zuo	1
复方磺胺间甲氧嘧啶	fu fang huang an jian jia yang mi ding	1
复方磺胺脒	fu fang huang an mi	1
复方磺胺嘧啶	fu fang huang an mi ding	1
复方磺胺嘧啶锌	fu fang huang an mi ding xin	1
复方磺胺氧化锌	fu fang huang an yang hua xin	1
复方黄体酮	fu fang huang ti tong	1
复方己酸羟孕酮	fu fang ji suan qiang yun tong	1
复方甲苯咪唑	fu fang jia ben mi zuo	1
复方甲地孕酮	fu fang jia di yun tong	1
复方甲麻	fu fang jia ma	1
复方甲羟孕酮	fu fang jia qiang yun tong	1
复方甲硝唑甲硝维参	fu fang jia xiao zuo jia xiao wei can	1
复方甲氧那明	fu fang jia yang na ming	1
复方间苯二酚	fu fang jian ben er fen	1
复方间苯二酚苯酚	fu fang jian ben er fen ben fen	1
复方间苯二酚水杨酸	fu fang jian ben er fen shui yang suan	1
复方碱式硝酸铋	fu fang jian shi xiao suan bi	1
复方角菜酸酯	fu fang jiao cai suan zhi	1
复方酵母碳酸铋	fu fang jiao mu tan suan bi	1
复方桔梗氯化铵	fu fang jie geng lv hua an	1
复方桔梗麻黄碱	fu fang jie geng ma huang jian	1
复方桔梗枇杷	fu fang jie geng pi pa	1
复方桔梗远志麻黄碱	fu fang jie geng yuan zhi ma huang jian	1
复方金刚烷胺氨基比林	fu fang jin gang wan an an ji bi lin	1
复方聚维酮碘	fu fang ju wei tong dian	1
复方聚乙二醇电解质	fu fang ju yi er chun dian jie zhi	1
复方枸橼酸阿尔维林	fu fang ju yuan suan a er wei lin	1
复方枸橼酸铋钾甲硝唑	fu fang ju yuan suan bi jia jia xiao zuo	1
复方枸橼酸钠	fu fang ju yuan suan na	1
复方枸橼酸喷托维林	fu fang ju yuan suan pen tuo wei lin	1
复方枸橼酸碳酸氢钠	fu fang ju yuan suan tan suan qing na	1
复方枸橼酸铁铵	fu fang ju yuan suan tie an	1
复方卡比多巴	fu fang ka bi duo ba	1
复方咖磷	fu fang ka lin	1
复方卡托普利	fu fang ka tuo pu li	1
复方可待因	fu fang ke dai yin	1
复方克罗米通	fu fang ke luo mi tong	1
复方克霉唑	fu fang ke mei zuo	1
复方苦参水杨酸	fu fang ku shen shui yang suan	1
复方奎宁	fu fang kui ning	1
复方辣椒	fu fang la jiao	1
复方辣椒碱	fu fang la jiao jian	1
复方赖氨酸	fu fang lai an suan	1
复方蓝棕果	fu fang lan zong guo	1
复方雷尼替丁	fu fang lei ni ti ding	1
复方利多卡因	fu fang li duo ka yin	1
复方利血平	fu fang li xue ping	1
复方利血平氨苯蝶啶	fu fang li xue ping an ben die ding	1
复方利血平氢氯噻嗪	fu fang li xue ping qing lv sai qin	1
复方联苯苄唑	fu fang lian ben bian zuo	1
复方联苯双酯	fu fang lian ben shuang zhi	1
复方亮氨酸	fu fang liang an suan	1
复方磷酸可待因	fu fang lin suan ke dai yin	1
复方磷酸萘酚喹	fu fang lin suan nai fen kui	1
复方磷酸哌喹	fu fang lin suan pai kui	1
复方磷酸氢钠	fu fang lin suan qing na	1
复方柳安咖	fu fang liu an ka	1
复方硫酸氢黄连素	fu fang liu suan qing huang lian su	1
复方硫酸软骨素	fu fang liu suan ruan gu su	1
复方硫酸沙丁胺醇	fu fang liu suan sha ding an chun	1
复方硫酸锌	fu fang liu suan xin	1
复方硫酸新霉素	fu fang liu suan xin mei su	1
复方硫酸亚铁	fu fang liu suan ya tie	1
复方硫酸亚铁叶酸	fu fang liu suan ya tie ye suan	1
复方柳唑	fu fang liu zuo	1
复方龙胆碳酸氢钠	fu fang long dan tan suan qing na	1
复方龙脑樟脑油	fu fang long nao zhang nao you	1
复方芦丁	fu fang lu ding	1
复方炉甘石	fu fang lu gan shi	1
复方芦荟维	fu fang lu hui wei	1
复方罗布麻	fu fang luo bu ma	1
复方氯丙那林溴己新	fu fang lv bing na lin xiu ji xin	1
复方氯丙那林鱼腥草素钠	fu fang lv bing na lin yu xing cao su na	1
复方氯化钾	fu fang lv hua jia	1
复方氯化钠	fu fang lv hua na	1
复方氯己定	fu fang lv ji ding	1
复方氯己定达克罗宁	fu fang lv ji ding da ke luo ning	1
复方氯己定地塞米松	fu fang lv ji ding di sai mi song	1
复方氯己定甲硝唑	fu fang lv ji ding jia xiao zuo	1
复方氯解磷定	fu fang lv jie lin ding	1
复方氯雷他定	fu fang lv lei ta ding	1
复方氯霉素	fu fang lv mei su	1
复方铝酸铋	fu fang lv suan bi	1
复方氯唑沙宗	fu fang lv zuo sha zong	1
复方马勃水杨酸	fu fang ma bo shui yang suan	1
复方麻黄碱	fu fang ma huang jian	1
复方麻黄碱色甘酸钠	fu fang ma huang jian se gan suan na	1
复方毛冬青氯贝酸铝	fu fang mao dong qing lv bei suan lv	1
复方美替洛尔	fu fang mei ti luo er	1
复方门冬维甘	fu fang men dong wei gan	1
复方米非司酮	fu fang mi fei si tong	1
复方棉酚	fu fang mian fen	1
复方灭活白葡萄球菌	fu fang mie huo bai pu tao qiu jun	1
复方明矾布比卡因	fu fang ming fan bu bi ka yin	1
复方明胶纤维	fu fang ming jiao xian wei	1
复方木香铝镁	fu fang mu xiang lv mei	1
复方木香小檗碱	fu fang mu xiang xiao bo jian	1
复方萘甲唑林	fu fang nai jia zuo lin	1
复方萘普生	fu fang nai pu sheng	1
复方萘维新	fu fang nai wei xin	1
复方脑蛋白水解物	fu fang nao dan bai shui jie wu	1
复方脑肽节苷脂	fu fang nao tai jie gan zhi	1
复方尿囊素	fu fang niao nang su	1
复方尿维氨	fu fang niao wei an	1
复方牛磺酸	fu fang niu huang suan	1
复方牛胎肝提取物	fu fang niu tai gan ti qu wu	1
复方诺氟沙星	fu fang nuo fu sha xing	1
复方胚肝铁铵	fu fang pei gan tie an	1
复方硼砂	fu fang peng sha	1
复方匹可硫酸钠	fu fang pi ke liu suan na	1
复方枇杷氯化铵	fu fang pi pa lv hua an	1
复方枇杷喷托维林	fu fang pi pa pen tuo wei lin	1
复方皮维碘	fu fang pi wei dian	1
复方普鲁卡因	fu fang pu lu ka yin	1
复方普萘洛尔咖啡因	fu fang pu nai luo er ka fei yin	1
复方扑热息痛	fu fang pu re xi tong	1
复方葡萄糖酸钙	fu fang pu tao tang suan gai	1
复方七叶皂苷	fu fang qi ye zao gan	1
复方羟丙茶碱去氯羟嗪	fu fang qiang bing cha jian qu lv qiang qin	1
复方羟甲唑啉	fu fang qiang jia zuo lin	1
复方庆大霉素	fu fang qing da mei su	1
复方庆大霉素普鲁卡因	fu fang qing da mei su pu lu ka yin	1
复方青蒿安乃近	fu fang qing hao an nai jin	1
复方氢化可的松	fu fang qing hua ke di song	1
复方氢化可的松新霉素	fu fang qing hua ke di song xin mei su	1
复方氢溴酸右美沙芬	fu fang qing xiu suan you mei sha fen	1
复方氢氧化铝	fu fang qing yang hua lv	1
复方氢氧化铝镁	fu fang qing yang hua lv mei	1
复方曲安奈德	fu fang qu an nai de	1
复方曲安缩松	fu fang qu an suo song	1
复方曲马多	fu fang qu ma duo	1
复方曲尼司特	fu fang qu ni si te	1
复方曲肽	fu fang qu tai	1
复方炔雌醇	fu fang que ci chun	1
复方炔雌醇甲羟孕酮	fu fang que ci chun jia qiang yun tong	1
复方炔诺酮	fu fang que nuo tong	1
复方炔诺孕酮	fu fang que nuo yun tong	1
复方忍冬藤阿司匹林	fu fang ren dong teng a si pi lin	1
复方人参间苯二酚	fu fang ren shen jian ben er fen	1
复方乳酸	fu fang ru suan	1
复方乳酸钠葡萄糖	fu fang ru suan na pu tao tang	1
复方乳酸钠山梨醇	fu fang ru suan na shan li chun	1
复方赛克力嗪	fu fang sai ke li qin	1
复方噻吗洛尔	fu fang sai ma luo er	1
复方三氯叔丁醇	fu fang san lv shu ding chun	1
复方三嗪芦丁	fu fang san qin lu ding	1
复方三维	fu fang san wei	1
复方三维亚铁	fu fang san wei ya tie	1
复方三维亚油酸	fu fang san wei ya you suan	1
复方三维右旋泛酸钙	fu fang san wei you xuan fan suan gai	1
复方三氧化二砷	fu fang san yang hua er shen	1
复方珊瑚姜尿素咪康唑	fu fang shan hu jiang niao su mi kang zuo	1
复方山金车花	fu fang shan jin che hua	1
复方麝香草酚	fu fang she xiang cao fen	1
复方麝香雪莲柳酯	fu fang she xiang xue lian liu zhi	1
复方参芪维	fu fang shen qi wei	1
复方石菖蒲碱式碳酸铋	fu fang shi chang pu jian shi tan suan bi	1
复方石菖蒲碱式硝酸铋	fu fang shi chang pu jian shi xiao suan bi	1
复方石榴皮小檗碱	fu fang shi liu pi xiao bo jian	1
复方嗜酸乳杆菌	fu fang shi suan ru gan jun	1
复方十一烯酸锌	fu fang shi yi xi suan xin	1
复方十一烯酸锌曲安奈德	fu fang shi yi xi suan xin qu an nai de	1
复方双肼屈嗪	fu fang shuang jing qu qin	1
复方双氯芬酸	fu fang shuang lv fen suan	1
复方双嗪利血平	fu fang shuang qin li xue ping	1
复方双氢青蒿素	fu fang shuang qing qing hao su	1
复方双炔失碳酯	fu fang shuang que shi tan zhi	1
复方水杨酸	fu fang shui yang suan	1
复方水杨酸苯胺甲酯	fu fang shui yang suan ben an jia zhi	1
复方水杨酸苯甲酸	fu fang shui yang suan ben jia suan	1
复方水杨酸冰片	fu fang shui yang suan bing pian	1
复方水杨酸甲酯	fu fang shui yang suan jia zhi	1
复方水杨酸甲酯苯海拉明	fu fang shui yang suan jia zhi ben hai la ming	1
复方水杨酸甲酯薄荷醇	fu fang shui yang suan jia zhi bo he chun	1
复方水杨酸甲酯薄荷脑油	fu fang shui yang suan jia zhi bo he nao you	1
复方水杨酸樟碘	fu fang shui yang suan zhang dian	1
复方四环素	fu fang si huan su	1
复方四环素泼尼松	fu fang si huan su po ni song	1
复方四嗪利血平	fu fang si qin li xue ping	1
复方四维女贞子	fu fang si wei nv zhen zi	1
复方松醇那敏	fu fang song chun na min	1
复方碳酸钙	fu fang tan suan gai	1
复方碳酸氢钠	fu fang tan suan qing na	1
复方碳酸氢钠颠茄	fu fang tan suan qing na dian qie	1
复方天麻蜜环糖肽	fu fang tian ma mi huan tang tai	1
复方酮康唑	fu fang tong kang zuo	1
复方酮酸	fu fang tong suan	1
复方头孢克洛	fu fang tou bao ke luo	1
复方土槿皮	fu fang tu jin pi	1
复方托吡卡胺	fu fang tuo bi ka an	1
复方妥英麻黄茶碱	fu fang tuo ying ma huang cha jian	1
复方王不留行	fu fang wang bu liu xing	1
复方胃蛋白酶	fu fang wei dan bai mei	1
复方维颠茄铋铝	fu fang wei dian qie bi lv	1
复方伪麻黄碱	fu fang wei ma huang jian	1
复方胃膜素	fu fang wei mo su	1
复方维生素	fu fang wei sheng su	1
复方维生素号	fu fang wei sheng su hao	1
复方维酸	fu fang wei suan	1
复方五倍子水杨酸	fu fang wu bei zi shui yang suan	1
复方戊酸雌二醇	fu fang wu suan ci er chun	1
复方五味子	fu fang wu wei zi	1
复方西吡氯铵	fu fang xi bi lv an	1
复方西咪替丁	fu fang xi mi ti ding	1
复方喜树碱	fu fang xi shu jian	1
复方小檗碱鞣酸蛋白	fu fang xiao bo jian rou suan dan bai	1
复方消化酶	fu fang xiao hua mei	1
复方硝酸咪康唑	fu fang xiao suan mi kang zuo	1
复方硝酸戊四醇酯	fu fang xiao suan wu si chun zhi	1
复方消旋山莨菪碱	fu fang xiao xuan shan lang dang jian	1
复方锌布	fu fang xin bu	1
复方新霉素	fu fang xin mei su	1
复方新霉素多粘菌素	fu fang xin mei su duo nian jun su	1
复方新斯的明牛磺酸	fu fang xin si di ming niu huang suan	1
复方锌铁钙	fu fang xin tie gai	1
复方熊胆薄荷	fu fang xiong dan bo he	1
复方溴丙胺太林	fu fang xiu bing an tai lin	1
复方溴丙胺太林铝镁	fu fang xiu bing an tai lin lv mei	1
复方溴咖	fu fang xiu ka	1
复方亚油酸钙	fu fang ya you suan gai	1
复方亚油酸乙酯	fu fang ya you suan yi zhi	1
复方岩白菜素	fu fang yan bai cai su	1
复方延胡索氢氧化铝	fu fang yan hu suo qing yang hua lv	1
复方盐酸阿米洛利	fu fang yan suan a mi luo li	1
复方盐酸甲麻黄碱	fu fang yan suan jia ma huang jian	1
复方盐酸克仑特罗	fu fang yan suan ke lun te luo	1
复方盐酸赖氨酸	fu fang yan suan lai an suan	1
复方盐酸氯丙嗪	fu fang yan suan lv bing qin	1
复方盐酸麻黄碱	fu fang yan suan ma huang jian	1
复方盐酸羟苄利明	fu fang yan suan qiang bian li ming	1
复方盐酸伪麻黄碱	fu fang yan suan wei ma huang jian	1
复方氧化锌	fu fang yang hua xin	1
复方氧化锌水杨酸	fu fang yang hua xin shui yang suan	1
复方叶酸	fu fang ye suan	1
复方异丙托溴铵	fu fang yi bing tuo xiu an	1
复方益康唑氧化锌	fu fang yi kang zuo yang hua xin	1
复方胰酶	fu fang yi mei	1
复方吲哚美辛	fu fang yin duo mei xin	1
复方吲哚美辛达克罗宁	fu fang yin duo mei xin da ke luo ning	1
复方银耳鱼肝油	fu fang yin er yu gan you	1
复方银翘氨酚维	fu fang yin qiao an fen wei	1
复方银翘氨敏	fu fang yin qiao an min	1
复方营养剂	fu fang ying yang ji	1
复方右旋糖酐	fu fang you xuan tang gan	1
复方愈创蓝油烃	fu fang yu chuang lan you ting	1
复方愈创木酚磺酸钾	fu fang yu chuang mu fen huang suan jia	1
复方愈酚麻黄	fu fang yu fen ma huang	1
复方愈酚喷托那敏	fu fang yu fen pen tuo na min	1
复方鱼肝油氧化锌	fu fang yu gan you yang hua xin	1
复方孕二烯酮	fu fang yun er xi tong	1
复方樟柳碱	fu fang zhang liu jian	1
复方樟脑	fu fang zhang nao	1
复方紫荆皮水杨酸	fu fang zi jing pi shui yang suan	1
复方紫龙	fu fang zi long	1
复方左炔诺孕酮	fu fang zuo que nuo yun tong	1
氟芬那酸	fu fen na suan	1
氟芬那酸丁酯	fu fen na suan ding zhi	1
氟奋乃静	fu fen nai jing	1
氟伏沙明	fu fu sha ming	1
伏格列波糖	fu ge lie bo tang	1
氟桂利嗪	fu gui li qin	1
复合辅酶	fu he fu mei	1
复合磷酸氢钾	fu he lin suan qing jia	1
复合磷酸酯酶	fu he lin suan zhi mei	1
复合凝乳酶	fu he ning ru mei	1
复合乳酸菌	fu he ru suan jun	1
复合水杨酸	fu he shui yang suan	1
复合维生素	fu he wei sheng su	1
氟化钠甘油	fu hua na gan you	1
氟甲松龙	fu jia song long	1
氟康唑	fu kang zuo	1
氟康唑氯化钠	fu kang zuo lv hua na	1
氟康唑葡萄糖	fu kang zuo pu tao tang	1
呋喹替尼	fu kui ti ni	1
伏立康唑	fu li kang zuo	1
伏硫西汀	fu liu xi ting	1
氟罗沙星	fu luo sha xing	1
氟罗沙星甘露醇	fu luo sha xing gan lu chun	1
氟罗沙星葡萄糖	fu luo sha xing pu tao tang	1
氟氯西林	fu lv xi lin	1
氟氯西林阿莫西林	fu lv xi lin a mo xi lin	1
呋麻	fu ma	1
富马酸亚铁	fu ma suan ya tie	1
富马酸亚铁多库酯钠	fu ma suan ya tie duo ku zhi na	1
氟马西尼	fu ma xi ni	1
辅酶	fu mei	1
辅酶氯化钠	fu mei lv hua na	1
福美坦	fu mei tan	1
氟米龙	fu mi long	1
福莫司汀	fu mo si ting	1
福莫特罗	fu mo te luo	1
腹膜透析液	fu mo tou xi ye	1
呋喃硫胺	fu nan liu an	1
呋喃妥因	fu nan tuo yin	1
呋喃西林	fu nan xi lin	1
呋喃唑酮	fu nan zuo tong	1
呋脲苄青霉素	fu niao bian qing mei su	1
氟脲苷	fu niao gan	1
氟尿嘧啶	fu niao mi ding	1
氟尿嘧啶氯化钠	fu niao mi ding lv hua na	1
氟尿嘧啶葡萄糖	fu niao mi ding pu tao tang	1
氟哌啶	fu pai ding	1
氟哌啶醇	fu pai ding chun	1
氟哌利多	fu pai li duo	1
氟哌噻吨	fu pai sai dun	1
氟哌噻吨癸酸酯	fu pai sai dun gui suan zhi	1
氟哌噻吨美利曲辛	fu pai sai dun mei li qu xin	1
氟氢可的松	fu qing ke di song	1
氟轻松	fu qing song	1
氟轻松冰片	fu qing song bing pian	1
氟轻松维	fu qing song wei	1
氟曲马唑	fu qu ma zuo	1
呋塞米	fu sai mi	1
福氏宋内氏痢疾双价活疫苗	fu shi song nei shi li ji shuang jia huo yi miao	1
氟他胺	fu ta an	1
氟替卡松	fu ti ka song	1
氟替卡松维兰特罗	fu ti ka song wei lan te luo	1
氟脱氧葡糖	fu tuo yang pu tang	1
氟维司群	fu wei si qun	1
夫西地酸	fu xi di suan	1
氟西泮	fu xi pan	1
氟西汀	fu xi ting	1
福辛普利	fu xin pu li	1
氟氧头孢	fu yang tou bao	1
呋咱甲氢龙	fu zan jia qing long	1
扶正女贞素	fu zheng nv zhen su	1
钆贝葡胺	ga bei pu an	1
钆布醇	ga bu chun	1
钆弗塞胺	ga fu sai an	1
钆喷酸葡胺	ga pen suan pu an	1
钆塞酸二钠	ga sai suan er na	1
钆双胺	ga shuang an	1
钆特醇	ga te chun	1
钆特酸葡胺	ga te suan pu an	1
盖胃平	gai wei ping	1
甘氨双唑钠	gan an shuang zuo na	1
甘氨酸	gan an suan	1
甘氨酸碳酸钙	gan an suan tan suan gai	1
甘草麻黄碱	gan cao ma huang jian	1
甘草酸	gan cao suan	1
甘草酸铋	gan cao suan bi	1
甘草酸单铵半胱氨酸氯化钠	gan cao suan dan an ban guang an suan lv hua na	1
甘草酸二铵	gan cao suan er an	1
甘草酸二铵氯化钠	gan cao suan er an lv hua na	1
甘草酸二铵葡萄糖	gan cao suan er an pu tao tang	1
甘草酸二钠	gan cao suan er na	1
甘草甜味素	gan cao tian wei su	1
甘草锌	gan cao xin	1
干酵母	gan jiao mu	1
肝浸膏	gan jin gao	1
甘精胰岛素	gan jing yi dao su	1
柑橘黄酮	gan ju huang tong	1
甘磷酰芥	gan lin xian jie	1
甘露醇	gan lu chun	1
甘露醇烟酸酯甘露六烟酯	gan lu chun yan suan zhi gan lu liu yan zhi	1
甘露聚糖肽	gan lu ju tang tai	1
甘珀酸钠	gan po suan na	1
甘羟铝	gan qiang lv	1
肝水解肽	gan shui jie tai	1
肝素	gan su	1
肝素维	gan su wei	1
干髓糊	gan sui hu	1
甘糖酯	gan tang zhi	1
甘油	gan you	1
甘油醇	gan you chun	1
甘油果糖	gan you guo tang	1
甘油果糖氯化钠	gan you guo tang lv hua na	1
甘油磷酸钠	gan you lin suan na	1
甘油氯化钠	gan you lv hua na	1
高纯度尿促性素	gao chun du niao cu xing su	1
高锝酸钠	gao de suan na	1
高锰酸钾	gao meng suan jia	1
高三尖杉酯碱	gao san jian shan zhi jian	1
高三尖杉酯碱氯化钠	gao san jian shan zhi jian lv hua na	1
高渗枸橼酸盐嘌呤	gao shen ju yuan suan yan piao ling	1
高渗羟乙基淀粉氯化钠	gao shen qiang yi ji dian fen lv hua na	1
睾酮	gao tong	1
睾丸片	gao wan pian	1
高乌甲素	gao wu jia su	1
高乌甲素葡萄糖	gao wu jia su pu tao tang	1
高血糖素	gao xue tang su	1
羔羊胃提取物维	gao yang wei ti qu wu wei	1
葛根素	ge gen su	1
葛根素氯化钠	ge gen su lv hua na	1
葛根素葡萄糖	ge gen su pu tao tang	1
格卡瑞韦哌仑他韦	ge ka rui wei pai lun ta wei	1
格拉司琼	ge la si qiong	1
格拉司琼氯化钠	ge la si qiong lv hua na	1
格拉司琼葡萄糖	ge la si qiong pu tao tang	1
戈利木单抗	ge li mu dan kang	1
格列本脲	ge lie ben niao	1
格列吡嗪	ge lie bi qin	1
格列喹酮	ge lie kui tong	1
格列美脲	ge lie mei niao	1
格列齐特	ge lie qi te	1
格隆溴铵	ge long xiu an	1
戈那瑞林	ge na rui lin	1
咯萘啶	ge nai ding	1
戈舍瑞林	ge she rui lin	1
更昔洛韦	geng xi luo wei	1
更昔洛韦氯化钠	geng xi luo wei lv hua na	1
更昔洛韦葡萄糖	geng xi luo wei pu tao tang	1
汞溴红	gong xiu hong	1
枸地氯雷他定	gou di lv lei ta ding	1
钩端螺旋体疫苗	gou duan luo xuan ti yi miao	1
枸磺新啶	gou huang xin ding	1
谷氨酸	gu an suan	1
谷氨酸诺氟沙星	gu an suan nuo fu sha xing	1
谷氨酸诺氟沙星氯化钠	gu an suan nuo fu sha xing lv hua na	1
谷氨酰胺	gu an xian an	1
谷氨酰胺呱仑酸钠	gu an xian an gua lun suan na	1
谷氨酰胺薁磺酸钠	gu an xian an yu huang suan na	1
谷丙甘氨酸	gu bing gan an suan	1
谷固醇	gu gu chun	1
谷固醇达克罗宁	gu gu chun da ke luo ning	1
骨瓜提取物	gu gua ti qu wu	1
谷胱甘肽	gu guang gan tai	1
谷红	gu hong	1
骨化三醇	gu hua san chun	1
谷赖胰岛素	gu lai yi dao su	1
骨肽	gu tai	1
骨肽氯化钠	gu tai lv hua na	1
谷维素	gu wei su	1
谷维素双维	gu wei su shuang wei	1
胍甲环素	gua jia huan su	1
呱西替柳	gua xi ti liu	1
关附甲素	guan fu jia su	1
胱氨酸	guang an suan	1
癸氟奋乃静	gui fu fen nai jing	1
鲑降钙素	gui jiang gai su	1
鬼臼毒素	gui jiu du su	1
鬼臼根树脂	gui jiu gen shu zhi	1
桂利嗪	gui li qin	1
桂美酸	gui mei suan	1
桂美辛	gui mei xin	1
桂哌齐特	gui pai qi te	1
硅炭银	gui tan yin	1
果糖	guo tang	1
果糖二磷酸钙	guo tang er lin suan gai	1
果糖二磷酸钠	guo tang er lin suan na	1
果糖氯化钠	guo tang lv hua na	1
果味维生素	guo wei wei sheng su	1
过氧苯甲酰	guo yang ben jia xian	1
过氧化氢	guo yang hua qing	1
过氧化碳酰胺	guo yang hua tan xian an	1
过氧乙酸	guo yang yi suan	1
哈拉宗	ha la zong	1
哈西奈德	ha xi nai de	1
海姆泊芬	hai mu bo fen	1
海索那林	hai suo na lin	1
还原型谷胱甘肽	hai yuan xing gu guang gan tai	1
海藻酸铝镁	hai zao suan lv mei	1
汉防己甲素	han fang ji jia su	1
含糖胃蛋白酶	han tang wei dan bai mei	1
蒿甲醚	hao jia mi	1
合成天麻素	he cheng tian ma su	1
合成鱼腥草素	he cheng yu xing cao su	1
核黄素磷酸钠	he huang su lin suan na	1
核黄素四丁酸酯	he huang su si ding suan zhi	1
核酪	he lao	1
核糖核酸	he tang he suan	1
核糖霉素	he tang mei su	1
红古豆醇酯栓	hong gu dou chun zhi shuan	1
红霉素	hong mei su	1
红霉素醋酸锌	hong mei su cu suan xin	1
红色诺卡氏菌细胞壁骨架	hong se nuo ka shi jun xi bao bi gu jia	1
红细胞保存液	hong xi bao bao cun ye	1
后马托品	hou ma tuo pin	1
猴头菌提取物	hou tou jun ti qu wu	1
琥珀酸亚铁	hu po suan ya tie	1
琥珀酰明胶	hu po xian ming jiao	1
琥乙红霉素	hu yi hong mei su	1
华法林	hua fa lin	1
槐定碱	huai ding jian	1
环孢素	huan bao su	1
环吡酮胺	huan bi tong an	1
环扁桃酯	huan bian tao zhi	1
环丙贝特	huan bing bei te	1
环丙沙星	huan bing sha xing	1
环丙沙星氯化钠	huan bing sha xing lv hua na	1
环丙沙星葡萄糖	huan bing sha xing pu tao tang	1
环丙孕酮	huan bing yun tong	1
环磷酰胺	huan lin xian an	1
环磷腺苷	huan lin xian gan	1
环磷腺苷氯化钠	huan lin xian gan lv hua na	1
环磷腺苷葡胺	huan lin xian gan pu an	1
环磷腺苷葡胺葡萄糖	huan lin xian gan pu an pu tao tang	1
环磷腺苷葡萄糖	huan lin xian gan pu tao tang	1
环轮宁	huan lun ning	1
环仑特罗	huan lun te luo	1
环喷托酯	huan pen tuo zhi	1
环丝氨酸	huan si an suan	1
环索奈德	huan suo nai de	1
环酯红霉素	huan zhi hong mei su	1
磺胺醋酰钠	huang an cu xian na	1
磺胺对甲氧嘧啶	huang an dui jia yang mi ding	1
磺胺多辛	huang an duo xin	1
磺胺多辛乙胺嘧啶	huang an duo xin yi an mi ding	1
磺胺二甲嘧啶	huang an er jia mi ding	1
磺胺甲噁唑	huang an jia e zuo	1
磺胺间甲氧嘧啶	huang an jian jia yang mi ding	1
磺胺林	huang an lin	1
磺胺脒	huang an mi	1
磺胺嘧啶	huang an mi ding	1
磺胺嘧啶锌	huang an mi ding xin	1
磺胺嘧啶银	huang an mi ding yin	1
磺胺氧化锌	huang an yang hua xin	1
磺苄西林	huang bian xi lin	1
磺达肝癸钠	huang da gan gui na	1
磺啶冰黄	huang ding bing huang	1
磺啶新林	huang ding xin lin	1
黄豆苷元	huang dou gan yuan	1
黄麻嗪	huang ma qin	1
黄芩苷	huang qin gan	1
黄热减毒活疫苗	huang re jian du huo yi miao	1
黄藤素	huang teng su	1
黄体酮	huang ti tong	1
黄酮哌酯	huang tong pai zhi	1
黄氧化汞	huang yang hua gong	1
灰黄霉素	hui huang mei su	1
茴拉西坦	hui la xi tan	1
茴三硫	hui san liu	1
混合重组人胰岛素	hun he chong zu ren yi dao su	1
混合核苷	hun he he gan	1
混合糖电解质	hun he tang dian jie zhi	1
肌氨肽苷	ji an tai gan	1
肌醇	ji chun	1
肌醇烟酸酯	ji chun yan suan zhi	1
鸡胆	ji dan	1
吉法酯	ji fa zhi	1
吉非罗齐	ji fei luo qi	1
吉非替尼	ji fei ti ni	1
肌苷	ji gan	1
肌苷氯化钠	ji gan lv hua na	1
肌苷葡萄糖	ji gan pu tao tang	1
吉米沙星	ji mi sha xing	1
己酸羟孕酮	ji suan qiang yun tong	1
脊髓灰质炎减毒活疫苗猴肾细胞	ji sui hui zhi yan jian du huo yi miao hou shen xi bao	1
脊髓灰质炎灭活疫苗	ji sui hui zhi yan mie huo yi miao	1
吉他霉素	ji ta mei su	1
己酮可可碱	ji tong ke ke jian	1
己酮可可碱氯化钠	ji tong ke ke jian lv hua na	1
己酮可可碱葡萄糖	ji tong ke ke jian pu tao tang	1
己烯雌酚	ji xi ci fen	1
吉西他滨	ji xi ta bin	1
甲氨蝶呤	jia an die ling	1
加巴喷丁	jia ba pen ding	1
加贝酯	jia bei zhi	1
甲苯磺丁脲	jia ben huang ding niao	1
甲苯咪唑	jia ben mi zuo	1
甲橙维	jia cheng wei	1
甲地高辛	jia di gao xin	1
甲地孕酮	jia di yun tong	1
价肺炎球菌多糖结合疫苗	jia fei yan qiu jun duo tang jie he yi miao	1
甲芬那酸	jia fen na suan	1
甲酚皂	jia fen zao	1
甲砜霉素	jia feng mei su	1
甲砜霉素甘氨酸酯	jia feng mei su gan an suan zhi	1
甲睾酮	jia gao tong	1
甲钴胺	jia gu an	1
甲磺司特	jia huang si te	1
甲基斑蝥胺	jia ji ban mao an	1
甲基多巴	jia ji duo ba	1
甲基硫氧嘧啶	jia ji liu yang mi ding	1
甲基麻黄碱	jia ji ma huang jian	1
加兰他敏	jia lan ta min	1
甲硫氨酸蛋氨酸	jia liu an suan dan an suan	1
甲硫氨酸维	jia liu an suan wei	1
甲氯芬酯	jia lv fen zhi	1
甲氯噻嗪	jia lv sai qin	1
甲麻黄碱	jia ma huang jian	1
甲麻芩苷那敏	jia ma qin gan na min	1
甲萘氢醌	jia nai qing kun	1
加尼瑞克	jia ni rui ke	1
甲哌卡因	jia pai ka yin	1
甲哌卡因肾上腺素	jia pai ka yin shen shang xian su	1
甲泼尼龙	jia po ni long	1
甲羟孕酮	jia qiang yun tong	1
甲巯咪唑	jia qiu mi zuo	1
甲醛甲酚	jia quan jia fen	1
甲胂酸钠	jia shen suan na	1
甲胎蛋白放免药盒	jia tai dan bai fang mian yao he	1
甲胎蛋白放射免疫分析药盒	jia tai dan bai fang she mian yi fen xi yao he	1
加替沙星	jia ti sha xing	1
加替沙星氯化钠	jia ti sha xing lv hua na	1
加替沙星葡萄糖	jia ti sha xing pu tao tang	1
加香甲酚	jia xiang jia fen	1
甲硝唑	jia xiao zuo	1
甲硝唑芬布芬	jia xiao zuo fen bu fen	1
甲硝唑呋喃唑酮	jia xiao zuo fu nan zuo tong	1
甲硝唑氯化钠	jia xiao zuo lv hua na	1
甲硝唑氯己定	jia xiao zuo lv ji ding	1
甲硝唑葡萄糖	jia xiao zuo pu tao tang	1
甲硝唑维	jia xiao zuo wei	1
甲型肝炎纯化灭活疫苗	jia xing gan yan chun hua mie huo yi miao	1
甲型肝炎减毒活疫苗	jia xing gan yan jian du huo yi miao	1
甲型肝炎灭活疫苗	jia xing gan yan mie huo yi miao	1
甲型肝炎灭活疫苗人二倍体细胞	jia xing gan yan mie huo yi miao ren er bei ti xi bao	1
甲型流感病毒裂解疫苗	jia xing liu gan bing du lie jie yi miao	1
甲型乙型肝炎联合疫苗	jia xing yi xing gan yan lian he yi miao	1
甲溴阿托品	jia xiu a tuo pin	1
甲溴贝那替秦	jia xiu bei na ti qin	1
甲氧苄啶	jia yang bian ding	1
甲氧聚二醇重组人促红素	jia yang ju er chun chong zu ren cu hong su	1
甲氧氯普胺	jia yang lv pu an	1
甲氧明	jia yang ming	1
甲氧那明	jia yang na ming	1
甲氧沙林	jia yang sha lin	1
甲氧异腈	jia yang yi jing	1
甲异靛	jia yi dian	1
甲状腺	jia zhuang xian	1
甲状腺素碘塞罗宁	jia zhuang xian su dian sai luo ning	1
甲状腺素放免药盒	jia zhuang xian su fang mian yao he	1
甲紫	jia zi	1
间苯三酚	jian ben san fen	1
间羟胺	jian qiang an	1
碱式水杨酸铋	jian shi shui yang suan bi	1
碱式碳酸铋	jian shi tan suan bi	1
尖吻蝮蛇血凝酶	jian wen fu she xue ning mei	1
姜酚	jiang fen	1
降纤酶	jiang xian mei	1
交联玻璃酸钠	jiao lian bo li suan na	1
交沙霉素	jiao sha mei su	1
角鲨烯	jiao sha xi	1
胶体果胶铋	jiao ti guo jiao bi	1
胶体酒石酸铋	jiao ti jiu shi suan bi	1
胶体磷酸铬	jiao ti lin suan ge	1
胶原放射免疫分析药盒型	jiao yuan fang she mian yi fen xi yao he xing	1
胶原酶	jiao yuan mei	1
疖病疫苗	jie bing yi miao	1
结构脂肪乳	jie gou zhi fang ru	1
结合雌激素	jie he ci ji su	1
结合雌激素甲羟孕酮	jie he ci ji su jia qiang yun tong	1
结核菌素纯蛋白衍生物	jie he jun su chun dan bai yan sheng wu	1
解热止痛散	jie re zhi tong san	1
金感敏	jin gan min	1
金刚烷胺	jin gang wan an	1
金刚乙胺	jin gang yi an	1
金龙胆草	jin long dan cao	1
金霉素	jin mei su	1
金葡菌毒素	jin pu jun du su	1
金葡素	jin pu su	1
精氨酸	jing an suan	1
精氨酸阿司匹林	jing an suan a si pi lin	1
精氨酸布洛芬	jing an suan bu luo fen	1
精氨酸谷氨酸	jing an suan gu an suan	1
精氨酸葡萄糖	jing an suan pu tao tang	1
精蛋白重组人胰岛素	jing dan bai chong zu ren yi dao su	1
精蛋白重组人胰岛素混合	jing dan bai chong zu ren yi dao su hun he	1
精蛋白重组人胰岛素预混	jing dan bai chong zu ren yi dao su yu hun	1
精蛋白生物合成人胰岛素	jing dan bai sheng wu he cheng ren yi dao su	1
精蛋白生物合成人胰岛素预混	jing dan bai sheng wu he cheng ren yi dao su yu hun	1
精蛋白锌重组赖脯胰岛素混合	jing dan bai xin chong zu lai pu yi dao su hun he	1
精蛋白锌重组人胰岛素	jing dan bai xin chong zu ren yi dao su	1
精蛋白锌重组人胰岛素混合	jing dan bai xin chong zu ren yi dao su hun he	1
精蛋白锌胰岛素	jing dan bai xin yi dao su	1
肼屈嗪	jing qu qin	1
精制抗狂犬病血清	jing zhi kang kuang quan bing xue qing	1
精制抗蛇毒血清	jing zhi kang she du xue qing	1
精制抗炭疽血清	jing zhi kang tan ju xue qing	1
精制破伤风抗毒素	jing zhi po shang feng kang du su	1
静注人免疫球蛋白	jing zhu ren mian yi qiu dan bai	1
静注乙型肝炎人免疫球蛋白	jing zhu yi xing gan yan ren mian yi qiu dan bai	1
九合维生素	jiu he wei sheng su	1
九价人乳头瘤病毒疫苗酿酒酵母	jiu jia ren ru tou liu bing du yi miao niang jiu jiao mu	1
旧结核菌素	jiu jie he jun su	1
九维	jiu wei	1
九维鱼肝油	jiu wei yu gan you	1
聚苯乙烯磺酸钙	ju ben yi xi huang suan gai	1
聚多卡醇	ju duo ka chun	1
聚桂醇	ju gui chun	1
聚磺苯乙烯钠	ju huang ben yi xi na	1
聚肌胞	ju ji bao	1
聚甲酚磺醛	ju jia fen huang quan	1
聚卡波非钙	ju ka bo fei gai	1
聚明胶肽	ju ming jiao tai	1
聚普瑞锌	ju pu rui xin	1
聚维酮碘	ju wei tong dian	1
聚乙二醇	ju yi er chun	1
聚乙二醇重组人生长激素	ju yi er chun chong zu ren sheng zhang ji su	1
聚乙二醇电解质	ju yi er chun dian jie zhi	1
聚乙二醇干扰素	ju yi er chun gan rao su	1
聚乙二醇洛塞那肽	ju yi er chun luo sai na tai	1
聚乙二醇钠钾	ju yi er chun na jia	1
聚乙烯醇	ju yi xi chun	1
枸橼酸铋钾	ju yuan suan bi jia	1
枸橼酸铋钾替硝唑克拉霉素	ju yuan suan bi jia ti xiao zuo ke la mei su	1
枸橼酸铋雷尼替丁	ju yuan suan bi lei ni ti ding	1
枸橼酸钙	ju yuan suan gai	1
枸橼酸钾	ju yuan suan jia	1
枸橼酸钠	ju yuan suan na	1
枸橼酸苹果酸钙	ju yuan suan ping guo suan gai	1
枸橼酸氢钾钠	ju yuan suan qing jia na	1
枸橼酸铁铵	ju yuan suan tie an	1
枸橼酸铁铵维	ju yuan suan tie an wei	1
枸橼酸锌	ju yuan suan xin	1
卷曲霉素	juan qu mei su	1
决奈达隆	jue nai da long	1
卡巴胆碱	ka ba dan jian	1
卡巴拉汀	ka ba la ting	1
卡巴匹林钙	ka ba pi lin gai	1
卡贝缩宫素	ka bei suo gong su	1
卡比多巴	ka bi duo ba	1
卡比马唑	ka bi ma zuo	1
卡铂	ka bo	1
卡泊芬净	ka bo fen jing	1
卡波罗孟	ka bo luo meng	1
卡波姆	ka bo mu	1
卡泊三醇	ka bo san chun	1
卡泊三醇倍他米松	ka bo san chun bei ta mi song	1
咖啡酸	ka fei suan	1
咖啡因	ka fei yin	1
咖酚伪麻	ka fen wei ma	1
卡格列净	ka ge lie jing	1
卡介菌纯蛋白衍生物	ka jie jun chun dan bai yan sheng wu	1
卡介菌多糖核酸	ka jie jun duo tang he suan	1
卡介苗	ka jie miao	1
卡络磺钠氯化钠	ka luo huang na lv hua na	1
卡络磺钠肾上腺色腙	ka luo huang na shen shang xian se zong	1
卡马西平	ka ma xi ping	1
卡莫氟	ka mo fu	1
卡莫司汀	ka mo si ting	1
卡那霉素	ka na mei su	1
卡培他滨	ka pei ta bin	1
卡前列甲酯	ka qian lie jia zhi	1
卡前列素氨丁三醇	ka qian lie su an ding san chun	1
卡瑞利珠单抗	ka rui li zhu dan kang	1
卡替洛尔	ka ti luo er	1
卡托普利	ka tuo pu li	1
卡维地洛	ka wei di luo	1
开塞露	kai sai lu	1
开塞露甘油	kai sai lu gan you	1
开塞露山梨醇	kai sai lu shan li chun	1
坎地氢噻	kan di qing sai	1
坎地沙坦酯	kan di sha tan zhi	1
康柏西普	kang bai xi pu	1
抗敌素硫酸黏菌素	kang di su liu suan nian jun su	1
抗蝮蛇毒血清	kang fu she du xue qing	1
抗抗血型定型试剂单克隆抗体	kang kang xue xing ding xing shi ji dan ke long kang ti	1
抗抗血型定型试剂人血清	kang kang xue xing ding xing shi ji ren xue qing	1
抗狂犬病血清	kang kuang quan bing xue qing	1
抗蝰蛇毒血清	kang kui she du xue qing	1
糠馏油	kang liu you	1
抗人白介素鼠单抗	kang ren bai jie su shu dan kang	1
抗人细胞鼠单抗	kang ren xi bao shu dan kang	1
抗人细胞兔免疫球蛋白	kang ren xi bao tu mian yi qiu dan bai	1
抗人细胞猪免疫球蛋白	kang ren xi bao zhu mian yi qiu dan bai	1
糠酸莫米松	kang suan mo mi song	1
抗炭疽血清	kang tan ju xue qing	1
康胃素	kang wei su	1
抗五步蛇毒血清	kang wu bu she du xue qing	1
抗眼镜蛇毒血清	kang yan jing she du xue qing	1
抗乙肝免疫核糖核酸	kang yi gan mian yi he tang he suan	1
抗乙肝转移因子	kang yi gan zhuan yi yin zi	1
抗乙型肝炎胎盘转移因子	kang yi xing gan yan tai pan zhuan yi yin zi	1
抗乙型肝炎转移因子	kang yi xing gan yan zhuan yi yin zi	1
抗银环蛇毒血清	kang yin huan she du xue qing	1
糠甾醇	kang zai chun	1
抗肿瘤免疫核糖核酸	kang zhong liu mian yi he tang he suan	1
考来烯胺	kao lai xi an	1
科博肽	ke bo tai	1
克补	ke bu	1
可待因	ke dai yin	1
可待因桔梗	ke dai yin jie geng	1
可的松	ke di song	1
可可钙糖	ke ke gai tang	1
克拉霉素	ke la mei su	1
克拉屈滨	ke la qu bin	1
可乐定	ke le ding	1
可利霉素	ke li mei su	1
克林霉素	ke lin mei su	1
克林霉素甲硝唑	ke lin mei su jia xiao zuo	1
克林霉素磷酸酯	ke lin mei su lin suan zhi	1
克林霉素磷酸酯氯化钠	ke lin mei su lin suan zhi lv hua na	1
克林霉素磷酸酯葡萄糖	ke lin mei su lin suan zhi pu tao tang	1
克林霉素氯化钠	ke lin mei su lv hua na	1
克林霉素葡萄糖	ke lin mei su pu tao tang	1
克林霉素棕榈酸酯	ke lin mei su zong lv suan zhi	1
克仑特罗	ke lun te luo	1
克洛己新	ke luo ji xin	1
克罗米通	ke luo mi tong	1
科洛曲	ke luo qu	1
克霉庆大倍松	ke mei qing da bei song	1
克霉唑	ke mei zuo	1
克霉唑倍他米松	ke mei zuo bei ta mi song	1
克霉唑尿素	ke mei zuo niao su	1
克念菌素	ke nian jun su	1
可溶性纤维素钠	ke rong xing xian wei su na	1
可溶性止血纱布	ke rong xing zhi xue sha bu	1
可愈	ke yu	1
克唑替尼	ke zuo ti ni	1
枯草杆菌肠球菌二联活菌	ku cao gan jun chang qiu jun er lian huo jun	1
枯草杆菌肠球菌二联活菌多维	ku cao gan jun chang qiu jun er lian huo jun duo wei	1
枯草杆菌二联活菌	ku cao gan jun er lian huo jun	1
枯草杆菌活菌	ku cao gan jun huo jun	1
枯草芽孢杆菌	ku cao ya bao gan jun	1
苦参碱	ku shen jian	1
苦参碱氯化钠	ku shen jian lv hua na	1
苦参碱葡萄糖	ku shen jian pu tao tang	1
苦参素	ku shen su	1
苦参素氯化钠	ku shen su lv hua na	1
苦参素葡萄糖	ku shen su pu tao tang	1
喹硫平	kui liu ping	1
喹那普利	kui na pu li	1
奎尼丁	kui ni ding	1
奎宁	kui ning	1
拉贝洛尔	la bei luo er	1
拉布立海	la bu li hai	1
拉呋替丁	la fu ti ding	1
辣椒颠茄	la jiao dian qie	1
辣椒碱	la jiao jian	1
拉考沙胺	la kao sha an	1
拉克替醇	la ke ti chun	1
拉米夫定	la mi fu ding	1
拉米夫定替诺福韦	la mi fu ding ti nuo fu wei	1
拉莫三嗪	la mo san qin	1
拉帕替尼	la pa ti ni	1
拉坦前列素	la tan qian lie su	1
拉坦噻吗	la tan sai ma	1
拉替拉韦	la ti la wei	1
拉西地平	la xi di ping	1
拉氧头孢	la yang tou bao	1
蜡样芽胞杆菌	la yang ya bao gan jun	1
蜡样芽孢杆菌活菌	la yang ya bao gan jun huo jun	1
赖氨肌醇维	lai an ji chun wei	1
赖氨匹林	lai an pi lin	1
赖氨葡锌	lai an pu xin	1
赖氨酸	lai an suan	1
赖氨酸磷酸氢钙	lai an suan lin suan qing gai	1
赖氨酸氯化钠	lai an suan lv hua na	1
赖氨酸葡萄糖	lai an suan pu tao tang	1
赖氨酸维	lai an suan wei	1
来迪派韦索磷布韦	lai di pai wei suo lin bu wei	1
来氟米特	lai fu mi te	1
来那度胺	lai na du an	1
赖诺普利	lai nuo pu li	1
赖诺普利氢氯噻嗪	lai nuo pu li qing lv sai qin	1
赖脯胰岛素	lai pu yi dao su	1
来曲唑	lai qu zuo	1
来昔决南钐	lai xi jue nan shan	1
兰瑞肽	lan rui tai	1
兰索拉唑	lan suo la zuo	1
榄香烯	lan xiang xi	1
莨菪	lang dang	1
劳拉西泮	lao la xi pan	1
酪酸梭菌肠球菌三联活菌	lao suan suo jun chang qiu jun san lian huo jun	1
酪酸梭菌二联活菌	lao suan suo jun er lian huo jun	1
酪酸梭菌活菌	lao suan suo jun huo jun	1
乐卡地平	le ka di ping	1
雷贝拉唑	lei bei la zuo	1
雷公藤内酯	lei gong teng nei zhi	1
雷洛昔芬	lei luo xi fen	1
雷米普利	lei mi pu li	1
雷莫司琼	lei mo si qiong	1
雷奈酸锶	lei nai suan si	1
雷尼替丁	lei ni ti ding	1
雷尼替丁氯化钠	lei ni ti ding lv hua na	1
雷沙吉兰	lei sha ji lan	1
雷替曲塞	lei ti qu sai	1
雷珠单抗	lei zhu dan kang	1
利奥西呱	li ao xi gua	1
利巴韦林	li ba wei lin	1
利巴韦林氯化钠	li ba wei lin lv hua na	1
利巴韦林葡萄糖	li ba wei lin pu tao tang	1
利丙双卡因	li bing shuang ka yin	1
利多布比卡因	li duo bu bi ka yin	1
利多卡因	li duo ka yin	1
利多卡因氯化钠	li duo ka yin lv hua na	1
利多卡因氯己定	li duo ka yin lv ji ding	1
利多卡因葡萄糖	li duo ka yin pu tao tang	1
利伐沙班	li fa sha ban	1
利凡诺	li fan nuo	1
利福布汀	li fu bu ting	1
利福定	li fu ding	1
利福霉素	li fu mei su	1
利福霉素氯化钠	li fu mei su lv hua na	1
利福喷丁	li fu pen ding	1
利福平	li fu ping	1
利福昔明	li fu xi ming	1
利格列汀	li ge lie ting	1
利格列汀二甲双胍	li ge lie ting er jia shuang gua	1
利可君	li ke jun	1
利拉鲁肽	li la lu tai	1
利拉萘酯	li la nai zhi	1
利鲁唑	li lu zuo	1
利那洛肽	li na luo tai	1
利奈唑胺	li nai zuo an	1
利奈唑胺葡萄糖	li nai zuo an pu tao tang	1
利培酮	li pei tong	1
利匹韦林	li pi wei lin	1
利塞膦酸钠	li sai lin suan na	1
利斯的明	li si de ming	1
利司那肽	li si na tai	1
利托君	li tuo jun	1
利托那韦	li tuo na wei	1
利妥昔单抗	li tuo xi dan kang	1
利血平	li xue ping	1
利扎曲普坦	li zha qu pu tan	1
联苯苄唑	lian ben bian zuo	1
联苯苄唑尿素	lian ben bian zuo niao su	1
联苯双酯	lian ben shuang zhi	1
联苯乙酸	lian ben yi suan	1
联磺甲氧苄啶	lian huang jia yang bian ding	1
联克利甘	lian ke li gan	1
链霉蛋白酶	lian mei dan bai mei	1
链霉素	lian mei su	1
亮丙瑞林	liang bing rui lin	1
亮菌	liang jun	1
亮菌甲素	liang jun jia su	1
亮菌甲素氯化钠	liang jun jia su lv hua na	1
亮菌甲素葡萄糖	liang jun jia su pu tao tang	1
两性霉素	liang xing mei su	1
林旦	lin dan	1
邻碘马尿酸钠	lin dian ma niao suan na	1
膦甲酸钠	lin jia suan na	1
膦甲酸钠氯化钠	lin jia suan na lv hua na	1
膦甲酸钠葡萄糖	lin jia suan na pu tao tang	1
林可霉素	lin ke mei su	1
林可霉素利多卡因	lin ke mei su li duo ka yin	1
林可霉素氯化钠	lin ke mei su lv hua na	1
林可霉素葡萄糖	lin ke mei su pu tao tang	1
林可霉素维	lin ke mei su wei	1
磷霉素	lin mei su	1
磷霉素氨丁三醇	lin mei su an ding san chun	1
磷霉素钙甲氧苄啶	lin mei su gai jia yang bian ding	1
磷酸肌酸钠	lin suan ji suan na	1
磷酸铝	lin suan lv	1
磷酸钠	lin suan na	1
磷酸钠盐	lin suan na yan	1
磷酸氢钙	lin suan qing gai	1
磷酸盐	lin suan yan	1
灵孢多糖	ling bao duo tang	1
灵杆菌多糖	ling gan jun duo tang	1
羚黄氨咖敏	ling huang an ka min	1
灵芝二维甲硫氨酸	ling zhi er wei jia liu an suan	1
柳胺酚	liu an fen	1
硫必利	liu bi li	1
硫必利氯化钠	liu bi li lv hua na	1
柳薄樟敏	liu bo zhang min	1
硫代硫酸钠	liu dai liu suan na	1
柳氮磺吡啶	liu dan huang bi ding	1
柳酚咖敏	liu fen ka min	1
六氟化硫微泡	liu fu hua liu wei pao	1
流感病毒裂解疫苗	liu gan bing du lie jie yi miao	1
流感病毒亚单位疫苗	liu gan bing du ya dan wei yi miao	1
流感全病毒灭活疫苗	liu gan quan bing du mie huo yi miao	1
硫化钠薄荷脑	liu hua na bo he nao	1
硫磺硫	liu huang liu	1
硫磺硼砂	liu huang peng sha	1
六甲蜜胺	liu jia mi an	1
硫康唑	liu kang zuo	1
硫利达嗪	liu li da qin	1
柳栎浸膏	liu li jin gao	1
硫氯酚	liu lv fen	1
硫鸟嘌呤	liu niao piao ling	1
硫培非格司亭	liu pei fei ge si ting	1
硫喷妥钠	liu pen tuo na	1
硫普罗宁	liu pu luo ning	1
硫酸钡	liu suan bei	1
硫酸钡型	liu suan bei xing	1
硫酸铝钾鞣酸	liu suan lv jia rou suan	1
硫酸镁	liu suan mei	1
硫酸镁葡萄糖	liu suan mei pu tao tang	1
硫酸软骨素	liu suan ruan gu su	1
硫酸软骨素钠	liu suan ruan gu su na	1
硫酸锌	liu suan xin	1
硫酸锌尿囊素	liu suan xin niao nang su	1
硫酸亚铁	liu suan ya tie	1
硫糖铝	liu tang lv	1
硫糖铝小檗碱	liu tang lv xiao bo jian	1
六维	liu wei	1
六维磷脂	liu wei lin zhi	1
柳烯酸	liu xi suan	1
硫辛酸	liu xin suan	1
硫唑嘌呤	liu zuo piao ling	1
龙胆苏打	long dan su da	1
龙胆碳酸氢钠	long dan tan suan qing na	1
芦丁	lu ding	1
芦氟沙星	lu fu sha xing	1
炉甘石	lu gan shi	1
鹿瓜多肽	lu gua duo tai	1
六合氨基酸	lu he an ji suan	1
六合维生素	lu he wei sheng su	1
芦可替尼	lu ke ti ni	1
鲁拉西酮	lu la xi tong	1
卢立康唑	lu li kang zuo	1
卤米松	lu mi song	1
卤米松三氯生	lu mi song san lv sheng	1
卢帕他定	lu pa ta ding	1
芦笋菠萝蛋白酶	lu sun bo luo dan bai mei	1
卵磷脂	luan lin zhi	1
卵磷脂络合碘	luan lin zhi luo he dian	1
仑氨西林	lun an xi lin	1
仑伐替尼	lun fa ti ni	1
轮状病毒活疫苗	lun zhuang bing du huo yi miao	1
洛贝林	luo bei lin	1
洛铂	luo bo	1
洛度沙胺	luo du sha an	1
洛度沙胺氨丁三醇	luo du sha an an ding san chun	1
洛伐他汀	luo fa ta ting	1
洛非西定	luo fei xi ding	1
洛芬待因	luo fen dai yin	1
洛芬葡锌那敏	luo fen pu xin na min	1
萝芙木	luo fu mu	1
罗格列酮	luo ge lie tong	1
罗红霉素	luo hong mei su	1
罗红霉素氨溴索	luo hong mei su an xiu suo	1
罗库溴铵	luo ku xiu an	1
洛美利嗪	luo mei li qin	1
洛美沙星	luo mei sha xing	1
洛美沙星氯化钠	luo mei sha xing lv hua na	1
洛美沙星葡萄糖	luo mei sha xing pu tao tang	1
洛莫司汀	luo mo si ting	1
螺内酯	luo nei zhi	1
洛哌丁胺	luo pai ding an	1
罗哌卡因	luo pai ka yin	1
罗哌卡因氯化钠	luo pai ka yin lv hua na	1
洛匹那韦利托那韦	luo pi na wei li tuo na wei	1
罗匹尼罗	luo pi ni luo	1
洛沙平	luo sha ping	1
罗沙司他	luo sha si ta	1
罗沙替丁醋酸酯	luo sha ti ding cu suan zhi	1
洛索洛芬	luo suo luo fen	1
罗替高汀	luo ti gao ting	1
罗通定	luo tong ding	1
罗西维林	luo xi wei lin	1
螺旋霉素	luo xuan mei su	1
氯胺酮	lv an tong	1
氯贝酸铝	lv bei suan lv	1
氯倍他松	lv bei ta song	1
氯苯那敏	lv ben na min	1
氯吡格雷	lv bi ge lei	1
氯丙那林	lv bing na lin	1
氯丙嗪	lv bing qin	1
氯丙嗪异丙嗪	lv bing qin yi bing qin	1
氯波必利	lv bo bi li	1
氯氮平	lv dan ping	1
氯氮卓	lv dan zhuo	1
氯碘羟喹	lv dian qiang kui	1
氯法齐明	lv fa qi ming	1
氯芬待因	lv fen dai yin	1
氯芬黄敏	lv fen huang min	1
氯芬那酸	lv fen na suan	1
氯化铵	lv hua an	1
氯化氨基汞	lv hua an ji gong	1
氯化钙	lv hua gai	1
氯化钙溴化钠	lv hua gai xiu hua na	1
氯化琥珀胆碱	lv hua hu po dan jian	1
氯化钾	lv hua jia	1
氯化钾环戊噻嗪	lv hua jia huan wu sai qin	1
氯化钾氯化钠	lv hua jia lv hua na	1
氯化钾葡萄糖	lv hua jia pu tao tang	1
氯化钠	lv hua na	1
氯化锶	lv hua si	1
氯化亚铊	lv hua ya ta	1
氯环利嗪	lv huan li qin	1
氯磺丙脲	lv huang bing niao	1
氯己定	lv ji ding	1
氯己定苯佐卡因	lv ji ding ben zuo ka yin	1
氯己定甲硝唑	lv ji ding jia xiao zuo	1
氯解磷定	lv jie lin ding	1
氯喹	lv kui	1
氯喹那多普罗雌烯	lv kui na duo pu luo ci xi	1
氯雷氨酚伪麻	lv lei an fen wei ma	1
氯雷他定	lv lei ta ding	1
氯雷伪麻	lv lei wei ma	1
氯膦酸二钠	lv lin suan er na	1
氯马斯汀	lv ma si ting	1
铝镁	lv mei	1
铝镁颠茄	lv mei dian qie	1
铝镁二甲硅油	lv mei er jia gui you	1
铝镁加	lv mei jia	1
铝镁匹林	lv mei pi lin	1
铝镁司	lv mei si	1
氯霉素	lv mei su	1
氯霉素甘油	lv mei su gan you	1
氯霉素氢化可的松	lv mei su qing hua ke di song	1
氯米芬	lv mi fen	1
氯米帕明	lv mi pa ming	1
铝钠颠茄	lv na dian qie	1
氯诺昔康	lv nuo xi kang	1
氯哌丁	lv pai ding	1
氯哌噻吨	lv pai sai dun	1
氯普鲁卡因	lv pu lu ka yin	1
氯普噻吨	lv pu sai dun	1
氯噻酮	lv sai tong	1
氯沙坦	lv sha tan	1
氯沙坦氢氯噻嗪	lv sha tan qing lv sai qin	1
铝碳酸镁	lv tan suan mei	1
氯替泼诺	lv ti po nuo	1
氯替泼诺妥布霉素	lv ti po nuo tuo bu mei su	1
氯烯雌醚	lv xi ci mi	1
氯硝柳胺	lv xiao liu an	1
氯硝西泮	lv xiao xi pan	1
氯氧喹	lv yang kui	1
氯唑沙宗	lv zuo sha zong	1
氯唑西林	lv zuo xi lin	1
吗多明	ma duo ming	1
吗啡	ma fei	1
吗啡阿托品	ma fei a tuo pin	1
麻黄碱	ma huang jian	1
麻黄碱苯海拉明	ma huang jian ben hai la ming	1
马拉韦罗	ma la wei luo	1
吗啉胍	ma lin gua	1
吗啉硝唑氯化钠	ma lin xiao zuo lv hua na	1
马蔺子素	ma lin zi su	1
马洛替酯	ma luo ti zhi	1
吗氯贝胺	ma lv bei an	1
麻敏维	ma min wei	1
马尼地平	ma ni di ping	1
马破伤风免疫球蛋白	ma po shang feng mian yi qiu dan bai	1
马普替林	ma pu ti lin	1
麻腮风联合减毒活疫苗	ma sai feng lian he jian du huo yi miao	1
吗替麦考酚酯	ma ti mai kao fen zhi	1
马昔腾坦	ma xi teng tan	1
马吲哚	ma yin duo	1
麻疹风疹联合减毒活疫苗	ma zhen feng zhen lian he jian du huo yi miao	1
麻疹减毒活疫苗	ma zhen jian du huo yi miao	1
麻疹腮腺炎风疹联合减毒活疫苗	ma zhen sai xian yan feng zhen lian he jian du huo yi miao	1
麻疹腮腺炎联合减毒活疫苗	ma zhen sai xian yan lian he jian du huo yi miao	1
麦白霉素	mai bai mei su	1
麦迪霉素	mai di mei su	1
麦格司他	mai ge si ta	1
麦角胺咖啡因	mai jiao an ka fei yin	1
麦角新碱	mai jiao xin jian	1
麦角隐亭咖啡因	mai jiao yin ting ka fei yin	1
麦精鱼肝油	mai jing yu gan you	1
麦考酚钠	mai kao fen na	1
螨变应原	man bian ying yuan	1
螨变应原皮肤点刺试剂盒	man bian ying yuan pi fu dian ci shi ji he	1
毛果芸香碱	mao guo yun xiang jian	1
毛花苷丙	mao hua gan bing	1
矛头蝮蛇血凝酶	mao tou fu she xue ning mei	1
美贝维林	mei bei wei lin	1
梅毒快速血浆反应素诊断试剂	mei du kuai su xue jiang fan ying su zhen duan shi ji	1
美尔伪麻	mei er wei ma	1
美法仑	mei fa lun	1
美芬那敏铵	mei fen na min an	1
美芬伪麻	mei fen wei ma	1
美酚伪麻	mei fen wei ma	1
镁钙维	mei gai wei	1
镁加铝	mei jia lv	1
煤焦油	mei jiao you	1
美金刚	mei jin gang	1
美罗培南	mei luo pei nan	1
美洛昔康	mei luo xi kang	1
美洛西林	mei luo xi lin	1
美洛西林舒巴坦	mei luo xi lin shu ba tan	1
美敏伪麻	mei min wei ma	1
美扑伪麻	mei pu wei ma	1
美曲伪麻	mei qu wei ma	1
美沙拉秦美沙拉嗪	mei sha la qin mei sha la qin	1
美沙酮	mei sha tong	1
美司钠美司那	mei si na mei si na	1
美司坦	mei si tan	1
美索巴莫	mei suo ba mo	1
美羧伪麻	mei suo wei ma	1
美他多辛	mei ta duo xin	1
美他环素	mei ta huan su	1
美托洛尔	mei tuo luo er	1
美西律	mei xi lv	1
美息伪麻	mei xi wei ma	1
美辛唑酮	mei xin zuo tong	1
美辛唑酮红古豆醇酯	mei xin zuo tong hong gu dou chun zhi	1
美愈伪麻	mei yu wei ma	1
门冬氨酸氨氯地平	men dong an suan an lv di ping	1
门冬氨酸钙	men dong an suan gai	1
门冬氨酸钾	men dong an suan jia	1
门冬氨酸钾镁	men dong an suan jia mei	1
门冬氨酸钾镁木糖醇	men dong an suan jia mei mu tang chun	1
门冬氨酸钾镁葡萄糖	men dong an suan jia mei pu tao tang	1
门冬氨酸鸟氨酸	men dong an suan niao an suan	1
门冬酰胺	men dong xian an	1
门冬酰胺酶	men dong xian an mei	1
门冬胰岛素	men dong yi dao su	1
孟鲁司特	meng lu si te	1
蒙脱石	meng tuo shi	1
米安色林	mi an se lin	1
咪达普利	mi da pu li	1
咪达唑仑	mi da zuo lun	1
糜蛋白酶	mi dan bai mei	1
米氮平	mi dan ping	1
米多君	mi duo jun	1
米非司酮	mi fei si tong	1
米格来宁	mi ge lai ning	1
米格列醇	mi ge lie chun	1
米格列奈钙	mi ge lie nai gai	1
米卡芬净	mi ka fen jing	1
咪康唑	mi kang zuo	1
咪康唑氯倍他索	mi kang zuo lv bei ta suo	1
米库氯铵	mi ku lv an	1
咪喹莫特	mi kui mo te	1
米拉贝隆	mi la bei long	1
米力农	mi li nong	1
米力农氯化钠	mi li nong lv hua na	1
米力农葡萄糖	mi li nong pu tao tang	1
米那普仑	mi na pu lun	1
米诺地尔	mi nuo di er	1
米诺环素	mi nuo huan su	1
米曲菌胰酶	mi qu jun yi mei	1
米索前列醇	mi suo qian lie chun	1
米托蒽醌	mi tuo en kun	1
米托蒽醌氯化钠	mi tuo en kun lv hua na	1
米托蒽醌葡萄糖	mi tuo en kun pu tao tang	1
咪唑立宾	mi zuo li bin	1
咪唑斯汀	mi zuo si ting	1
咪唑酸乙酯	mi zuo suan yi zhi	1
棉酚氯化钾维	mian fen lv hua jia wei	1
灭活埃希的松	mie huo ai xi de song	1
灭菌结晶磺胺	mie jun jie jing huang an	1
灭菌前列腺素	mie jun qian lie xian su	1
灭菌注射用水	mie jun zhu she yong shui	1
莫达非尼	mo da fei ni	1
莫海林	mo hai lin	1
莫雷西嗪	mo lei xi qin	1
莫匹罗星	mo pi luo xing	1
莫沙必利	mo sha bi li	1
莫索尼定	mo suo ni ding	1
莫西沙星	mo xi sha xing	1
莫西沙星氯化钠	mo xi sha xing lv hua na	1
木瓜酶	mu gua mei	1
牡蛎钙	mu li gai	1
牡蛎碳酸钙	mu li tan suan gai	1
母牛分枝杆菌	mu niu fen zhi gan jun	1
木糖醇	mu tang chun	1
木糖醇氯化钠	mu tang chun lv hua na	1
纳布啡	na bu fei	1
那氟沙星	na fu sha xing	1
那格列奈	na ge lie nai	1
钠钾镁钙葡萄糖	na jia mei gai pu tao tang	1
钠钾葡萄糖	na jia pu tao tang	1
那可丁	na ke ding	1
纳洛酮	na luo tong	1
纳美芬	na mei fen	1
纳米炭	na mi tan	1
那屈肝素钙那曲肝素钙	na qu gan su gai na qu gan su gai	1
纳曲酮	na qu tong	1
钠石灰	na shi hui	1
那他霉素	na ta mei su	1
纳武利尤单抗	na wu li you dan kang	1
奈达铂	nai da bo	1
萘丁美酮	nai ding mei tong	1
萘啶酸	nai ding suan	1
萘非	nai fei	1
萘酚喹	nai fen kui	1
奈福泮	nai fu pan	1
奈福泮氯化钠	nai fu pan lv hua na	1
奈福泮葡萄糖	nai fu pan pu tao tang	1
萘夫西林	nai fu xi lin	1
萘甲唑林	nai jia zuo lin	1
萘林那敏溴铵	nai lin na min xiu an	1
萘敏维	nai min wei	1
奈诺沙星	nai nuo sha xing	1
萘哌地尔	nai pai di er	1
萘普待因	nai pu dai yin	1
萘普生	nai pu sheng	1
萘普生氯化钠	nai pu sheng lv hua na	1
萘普生伪麻黄碱	nai pu sheng wei ma huang jian	1
萘替芬	nai ti fen	1
萘替芬酮康唑	nai ti fen tong kang zuo	1
奈替米星	nai ti mi xing	1
奈替米星氯化钠	nai ti mi xing lv hua na	1
奈替米星葡萄糖	nai ti mi xing pu tao tang	1
奈韦拉平	nai wei la ping	1
奈韦拉平齐多拉米双夫定	nai wei la ping qi duo la mi shuang fu ding	1
奈韦拉平司他拉米双夫定	nai wei la ping si ta la mi shuang fu ding	1
脑蛋白水解物	nao dan bai shui jie wu	1
脑蛋白水解物氯化钠	nao dan bai shui jie wu lv hua na	1
脑苷肌肽	nao gan ji tai	1
脑膜炎球菌多糖疫苗稀释液	nao mo yan qiu jun duo tang yi miao xi shi ye	1
内皮素放射免疫分析药盒	nei pi su fang she mian yi fen xi yao he	1
尼达尼布	ni da ni bu	1
尼尔雌醇	ni er ci chun	1
尼非卡兰	ni fei ka lan	1
尼古丁	ni gu ding	1
尼卡地平	ni ka di ping	1
尼卡地平氯化钠	ni ka di ping lv hua na	1
尼卡地平葡萄糖	ni ka di ping pu tao tang	1
尼可地尔	ni ke di er	1
尼可刹米	ni ke sha mi	1
尼洛替尼	ni luo ti ni	1
尼麦角林	ni mai jiao lin	1
尼美舒利	ni mei shu li	1
尼莫地平	ni mo di ping	1
尼莫司汀	ni mo si ting	1
尼群地平	ni qun di ping	1
尼群洛尔	ni qun luo er	1
尼索地平	ni suo di ping	1
尼妥珠单抗	ni tuo zhu dan kang	1
尼扎替丁	ni zha ti ding	1
粘菌素	nian jun su	1
黏菌素	nian jun su	1
尿促卵泡素	niao cu luan pao su	1
尿促性素	niao cu xing su	1
尿多酸肽	niao duo suan tai	1
尿激酶	niao ji mei	1
尿嘧啶替加氟	niao mi ding ti jia fu	1
尿囊素铝	niao nang su lv	1
尿素	niao su	1
尿素呼气试验药盒	niao su hu qi shi yan yao he	1
尿素呼气试验诊断试剂盒	niao su hu qi shi yan zhen duan shi ji he	1
尿素胶囊呼气试验药盒	niao su jiao nang hu qi shi yan yao he	1
尿素片呼气试验药盒	niao su pian hu qi shi yan yao he	1
尿素散剂呼气试验药盒	niao su san ji hu qi shi yan yao he	1
尿素维	niao su wei	1
凝结芽孢杆菌活菌	ning jie ya bao gan jun huo jun	1
柠檬烯	ning meng xi	1
凝血酶	ning xue mei	1
牛肺表面活性剂	niu fei biao mian huo xing ji	1
牛磺酸	niu huang suan	1
牛磺熊去氧胆酸	niu huang xiong qu yang dan suan	1
浓维磷	nong wei lin	1
浓戊二醛	nong wu er quan	1
诺氟沙星	nuo fu sha xing	1
诺氟沙星葡萄糖	nuo fu sha xing pu tao tang	1
诺西那生	nuo xi na sheng	1
帕博利珠单抗	pa bo li zhu dan kang	1
帕拉米韦氯化钠	pa la mi wei lv hua na	1
帕立骨化醇	pa li gu hua chun	1
帕利哌酮	pa li pai tong	1
帕洛诺司琼	pa luo nuo si qiong	1
帕罗西汀	pa luo xi ting	1
帕米膦酸二钠	pa mi lin suan er na	1
帕米膦酸二钠葡萄糖	pa mi lin suan er na pu tao tang	1
帕尼培南倍他米隆	pa ni pei nan bei ta mi long	1
帕瑞肽	pa rui tai	1
帕瑞昔布	pa rui xi bu	1
帕司烟肼对氨基水杨酸异烟肼	pa si yan jing dui an ji shui yang suan yi yan jing	1
帕妥珠单抗	pa tuo zhu dan kang	1
帕珠沙星	pa zhu sha xing	1
帕珠沙星氯化钠	pa zhu sha xing lv hua na	1
哌柏西利	pai bai xi li	1
哌泊塞嗪	pai bo sai qin	1
哌甲酯	pai jia zhi	1
哌克昔林	pai ke xi lin	1
哌库溴铵	pai ku xiu an	1
哌喹	pai kui	1
哌拉西林	pai la xi lin	1
哌拉西林舒巴坦	pai la xi lin shu ba tan	1
哌拉西林他唑巴坦	pai la xi lin ta zuo ba tan	1
哌仑西平	pai lun xi ping	1
哌罗匹隆	pai luo pi long	1
哌嗪	pai qin	1
哌替啶	pai ti ding	1
哌唑嗪	pai zuo qin	1
泮库溴铵	pan ku xiu an	1
泮托拉唑	pan tuo la zuo	1
培哚普利	pei duo pu li	1
培哚普利氨氯地平	pei duo pu li an lv di ping	1
培哚普利吲达帕胺	pei duo pu li yin da pa an	1
培氟沙星	pei fu sha xing	1
培氟沙星葡萄糖	pei fu sha xing pu tao tang	1
培集成干扰素	pei ji cheng gan rao su	1
培美曲塞	pei mei qu sai	1
培门冬酶	pei men dong mei	1
培唑帕尼	pei zuo pa ni	1
喷他脒	pen ta mi	1
喷他佐辛	pen ta zuo xin	1
喷替酸钙钠	pen ti suan gai na	1
喷托维林	pen tuo wei lin	1
喷托维林氯化铵	pen tuo wei lin lv hua an	1
喷昔洛韦	pen xi luo wei	1
硼砂甘油钾	peng sha gan you jia	1
硼酸	peng suan	1
硼酸冰片	peng suan bing pian	1
硼酸氧化锌	peng suan yang hua xin	1
硼酸氧化锌冰片	peng suan yang hua xin bing pian	1
硼替佐米	peng ti zuo mi	1
脾氨肽	pi an tai	1
匹多莫德	pi duo mo de	1
脾多肽	pi duo tai	1
匹伐他汀	pi fa ta ting	1
脾粉	pi fen	1
匹林咖敏	pi lin ka min	1
皮上划痕用鼠疫活疫苗	pi shang hua hen yong shu yi huo yi miao	1
匹维溴铵	pi wei xiu an	1
皮炎诊断贴剂	pi yan zhen duan tie ji	1
平衡盐	ping heng yan	1
平阳霉素	ping yang mei su	1
泼尼松	po ni song	1
泼尼松龙	po ni song long	1
泼尼松龙氢化泼尼松	po ni song long qing hua po ni song	1
破伤风抗毒素	po shang feng kang du su	1
破伤风人免疫球蛋白	po shang feng ren mian yi qiu dan bai	1
扑尔伪麻	pu er wei ma	1
普伐他汀	pu fa ta ting	1
葡钙维	pu gai wei	1
葡甘聚糖	pu gan ju tang	1
普拉睾酮	pu la gao tong	1
普拉克索	pu la ke suo	1
普拉洛芬	pu la luo fen	1
普芦卡必利	pu lu ka bi li	1
普鲁卡因	pu lu ka yin	1
普鲁卡因胺	pu lu ka yin an	1
普鲁卡因泛酸钙	pu lu ka yin fan suan gai	1
普鲁卡因氯化钠	pu lu ka yin lv hua na	1
普鲁卡因青霉素	pu lu ka yin qing mei su	1
普鲁卡因肾上腺素	pu lu ka yin shen shang xian su	1
普卢利沙星	pu lu li sha xing	1
普仑司特	pu lun si te	1
普罗布考	pu luo bu kao	1
普罗雌烯	pu luo ci xi	1
普罗碘铵	pu luo dian an	1
普洛萘尔	pu luo nai er	1
普罗帕酮	pu luo pa tong	1
普罗瑞林	pu luo rui lin	1
扑米酮	pu mi tong	1
普萘洛尔	pu nai luo er	1
葡醛内酯	pu quan nei zhi	1
葡醛酸钠	pu quan suan na	1
葡醛酸钠氯化钠	pu quan suan na lv hua na	1
普瑞巴林	pu rui ba lin	1
普适泰	pu shi tai	1
葡萄糖	pu tao tang	1
葡萄糖电解质	pu tao tang dian jie zhi	1
葡萄糖氯化钙	pu tao tang lv hua gai	1
葡萄糖氯化钠	pu tao tang lv hua na	1
葡萄糖氯化钠钾	pu tao tang lv hua na jia	1
葡萄糖酸钙	pu tao tang suan gai	1
葡萄糖酸钙氯化钠	pu tao tang suan gai lv hua na	1
葡萄糖酸钙维	pu tao tang suan gai wei	1
葡萄糖酸钙锌	pu tao tang suan gai xin	1
葡萄糖酸镁	pu tao tang suan mei	1
葡萄糖酸锑钠	pu tao tang suan ti na	1
葡萄糖酸锌	pu tao tang suan xin	1
葡萄糖酸亚铁	pu tao tang suan ya tie	1
葡萄糖鱼肝油	pu tao tang yu gan you	1
普乐沙福	pu yue sha fu	1
齐墩果酸	qi dun guo suan	1
齐多夫定	qi duo fu ding	1
齐多拉米双夫定	qi duo la mi shuang fu ding	1
七氟烷	qi fu wan	1
气管炎疫苗	qi guan yan yi miao	1
齐拉西酮	qi la xi tong	1
蕲蛇酶	qi she mei	1
七维牛磺酸	qi wei niu huang suan	1
七叶洋地黄双苷	qi ye yang di huang shuang gan	1
七叶皂苷	qi ye zao gan	1
茜草双酯	qian cao shuang zhi	1
千金藤啶碱	qian jin teng ding jian	1
前列地尔	qian lie di er	1
前列腺素	qian lie xian su	1
羟苯磺酸	qiang ben huang suan	1
羟苄唑	qiang bian zuo	1
羟丙甲纤维素	qiang bing jia xian wei su	1
羟布宗	qiang bu zong	1
羟丁酸钠	qiang ding suan na	1
羟钴胺	qiang gu an	1
羟基脲	qiang ji niao	1
羟基喜树碱氯化钠	qiang ji xi shu jian lv hua na	1
羟甲香豆素	qiang jia xiang dou su	1
羟甲烟胺	qiang jia yan an	1
羟甲唑啉	qiang jia zuo lin	1
羟考酮	qiang kao tong	1
强力碘	qiang li dian	1
羟氯喹	qiang lv kui	1
羟嗪	qiang qin	1
羟糖甘	qiang tang gan	1
羟喜树碱	qiang xi shu jian	1
羟乙基淀粉	qiang yi ji dian fen	1
羟乙基淀粉电解质	qiang yi ji dian fen dian jie zhi	1
羟乙基淀粉氯化钠	qiang yi ji dian fen lv hua na	1
羟乙膦酸钠	qiang yi lin suan na	1
庆大霉素	qing da mei su	1
庆大霉素氟米龙	qing da mei su fu mi long	1
庆大霉素甲氧苄啶	qing da mei su jia yang bian ding	1
庆大霉素氯化钠	qing da mei su lv hua na	1
庆大霉素普鲁卡因	qing da mei su pu lu ka yin	1
庆大霉素普鲁卡因维	qing da mei su pu lu ka yin wei	1
庆大霉素双氯芬酸	qing da mei su shuang lv fen suan	1
庆大霉素碳酸铋	qing da mei su tan suan bi	1
青蒿琥酯	qing hao hu zhi	1
青蒿琥酯阿莫地喹	qing hao hu zhi a mo di kui	1
青蒿素	qing hao su	1
青蒿素哌喹	qing hao su pai kui	1
氢化可的松	qing hua ke di song	1
氢化可的松新霉素	qing hua ke di song xin mei su	1
氢醌	qing kun	1
氢氯噻嗪	qing lv sai qin	1
氢氯噻嗪可乐定	qing lv sai qin ke le ding	1
氢吗啡酮	qing ma fei tong	1
青霉胺	qing mei an	1
青霉素	qing mei su	1
青霉素皮试剂	qing mei su pi shi ji	1
青藤碱	qing teng jian	1
氢氧化钙	qing yang hua gai	1
氢氧化铝	qing yang hua lv	1
青叶胆提取物	qing ye dan ti qu wu	1
巯嘌呤	qiu piao ling	1
秋水仙碱	qiu shui xian jian	1
巯乙胺	qiu yi an	1
去氨加压素	qu an jia ya su	1
曲安奈德	qu an nai de	1
曲安奈德氯霉素	qu an nai de lv mei su	1
曲安奈德尿素	qu an nai de niao su	1
曲安奈德新霉素	qu an nai de xin mei su	1
曲安奈德益康唑	qu an nai de yi kang zuo	1
曲安缩松尿素	qu an suo song niao su	1
曲安西龙	qu an xi long	1
曲安西龙尿素	qu an xi long niao su	1
曲吡那敏	qu bi na min	1
曲伏前列素	qu fu qian lie su	1
曲伏噻吗	qu fu sai ma	1
去甲斑蝥素	qu jia ban mao su	1
去甲斑蝥酸	qu jia ban mao suan	1
去甲斑蝥酸氯化钠	qu jia ban mao suan lv hua na	1
去甲肾上腺素	qu jia shen shang xian su	1
去甲万古霉素	qu jia wan gu mei su	1
曲克芦丁	qu ke lu ding	1
曲克芦丁氯化钠	qu ke lu ding lv hua na	1
曲克芦丁脑蛋白水解物	qu ke lu ding nao dan bai shui jie wu	1
曲克芦丁葡萄糖	qu ke lu ding pu tao tang	1
曲克芦丁羟丙茶碱	qu ke lu ding qiang bing cha jian	1
曲克芦丁香豆素	qu ke lu ding xiang dou su	1
屈螺酮炔雌醇	qu luo tong que ci chun	1
去氯羟嗪	qu lv qiang qin	1
曲马多	qu ma duo	1
曲马多氯化钠	qu ma duo lv hua na	1
曲马多葡萄糖	qu ma duo pu tao tang	1
曲美布汀	qu mei bu ting	1
曲美他嗪	qu mei ta qin	1
曲咪新	qu mi xin	1
曲尼司特	qu ni si te	1
曲匹布通	qu pi bu tong	1
曲匹地尔	qu pi di er	1
曲普利啶	qu pu li ding	1
曲普瑞林	qu pu rui lin	1
曲前列尼尔	qu qian lie ni er	1
去羟肌苷	qu qiang ji gan	1
去氢胆酸	qu qing dan suan	1
去水卫矛醇	qu shui wei mao chun	1
曲司氯铵	qu si lv an	1
屈他维林	qu ta wei lin	1
去铁胺	qu tie an	1
去铁酮	qu tie tong	1
去痛片	qu tong pian	1
曲妥珠单抗	qu tuo zhu dan kang	1
屈昔多巴	qu xi duo ba	1
曲昔派特	qu xi pai te	1
曲昔匹特	qu xi pi te	1
去氧氟尿苷	qu yang fu niao gan	1
去氧肾上腺素	qu yang shen shang xian su	1
去氧孕烯炔雌醇	qu yang yun xi que ci chun	1
去乙酰毛花苷	qu yi xian mao hua gan	1
曲唑酮	qu zuo tong	1
全氟丙烷人血白蛋白微球	quan fu bing wan ren xue bai dan bai wei qiu	1
全氟丁烷	quan fu ding wan	1
炔雌醇	que ci chun	1
炔雌醇环丙孕酮	que ci chun huan bing yun tong	1
炔诺酮	que nuo tong	1
炔诺孕酮	que nuo yun tong	1
炔诺孕酮炔雌醚	que nuo yun tong que ci mi	1
炔孕酮	que yun tong	1
群链球菌	qun lian qiu jun	1
群脑膜炎球菌多糖结合疫苗	qun nao mo yan qiu jun duo tang jie he yi miao	1
群脑膜炎球菌多糖疫苗	qun nao mo yan qiu jun duo tang yi miao	1
群脑膜炎球菌多糖疫苗稀释液	qun nao mo yan qiu jun duo tang yi miao xi shi ye	1
群群脑膜炎球菌多糖疫苗	qun qun nao mo yan qiu jun duo tang yi miao	1
热敷袋	re fu dai	1
壬苯醇醚	ren ben chun mi	1
壬二酸	ren er suan	1
人工牛黄甲硝唑	ren gong niu huang jia xiao zuo	1
人狂犬病免疫球蛋白	ren kuang quan bing mian yi qiu dan bai	1
人免疫球蛋白	ren mian yi qiu dan bai	1
人凝血酶	ren ning xue mei	1
人凝血酶原复合物	ren ning xue mei yuan fu he wu	1
人凝血因子	ren ning xue yin zi	1
人参多糖	ren shen duo tang	1
人胎盘	ren tai pan	1
人胎盘脂多糖	ren tai pan zhi duo tang	1
人胎盘组织液	ren tai pan zu zhi ye	1
人纤维蛋白	ren xian wei dan bai	1
人纤维蛋白原	ren xian wei dan bai yuan	1
人血白蛋白	ren xue bai dan bai	1
人血清肽放射免疫诊断试剂盒	ren xue qing tai fang she mian yi zhen duan shi ji he	1
人用狂犬病疫苗地鼠肾细胞	ren yong kuang quan bing yi miao di shu shen xi bao	1
人用狂犬病疫苗鸡胚细胞	ren yong kuang quan bing yi miao ji pei xi bao	1
人用狂犬病疫苗人二倍体细胞	ren yong kuang quan bing yi miao ren er bei ti xi bao	1
人用狂犬病疫苗细胞	ren yong kuang quan bing yi miao xi bao	1
绒促性素	rong cu xing su	1
溶菌酶	rong jun mei	1
绒毛膜促性腺激素放免药盒	rong mao mo cu xing xian ji su fang mian yao he	1
榕敏	rong min	1
肉毒抗毒素	rou du kang du su	1
柔红霉素	rou hong mei su	1
鞣柳硼三酸	rou liu peng san suan	1
鞣酸蛋白	rou suan dan bai	1
鞣酸蛋白酵母	rou suan dan bai jiao mu	1
鞣酸加压素	rou suan jia ya su	1
乳杆菌	ru gan jun	1
乳杆菌活菌	ru gan jun huo jun	1
乳果糖	ru guo tang	1
乳酶生	ru mei sheng	1
乳酸钙	ru suan gai	1
乳酸菌	ru suan jun	1
乳酸菌素	ru suan jun su	1
乳酸钠	ru suan na	1
乳酸钠林格	ru suan na lin ge	1
乳酸亚铁	ru suan ya tie	1
软皂	ruan zao	1
瑞巴派特	rui ba pai te	1
瑞波西汀	rui bo xi ting	1
瑞芬太尼	rui fen tai ni	1
瑞戈非尼	rui ge fei ni	1
瑞格列奈	rui ge lie nai	1
瑞格列奈二甲双胍	rui ge lie nai er jia shuang gua	1
瑞舒伐他汀	rui shu fa ta ting	1
瑞替普酶	rui ti pu mei	1
瑞香素	rui xiang su	1
赛庚啶	sai geng ding	1
赛克力嗪	sai ke li qin	1
塞克硝唑	sai ke xiao zuo	1
塞来昔布	sai lai xi bu	1
塞利洛尔	sai li luo er	1
赛洛多辛	sai luo duo xin	1
赛洛唑啉	sai luo zuo lin	1
噻氯匹定	sai lv pi ding	1
噻吗洛尔	sai ma luo er	1
噻奈普汀	sai nai pu ting	1
塞曲司特	sai qu si te	1
塞瑞替尼	sai rui ti ni	1
塞替派	sai ti pai	1
噻托溴铵	sai tuo xiu an	1
噻托溴铵奥达特罗	sai tuo xiu an ao da te luo	1
腮腺炎减毒活疫苗	sai xian yan jian du huo yi miao	1
三苯双脒	san ben shuang mi	1
三碘甲腺原氨酸放免药盒	san dian jia xian yuan an suan fang mian yao he	1
三氟拉嗪	san fu la qin	1
三氟哌多	san fu pai duo	1
三硅酸镁	san gui suan mei	1
三合钙	san he gai	1
三合激素	san he ji su	1
三甲氧苄嗪	san jia yang bian qin	1
三尖杉酯碱	san jian shan zhi jian	1
三磷酸胞苷二钠	san lin suan bao gan er na	1
三磷酸腺苷	san lin suan xian gan	1
三磷酸腺苷辅酶胰岛素	san lin suan xian gan fu mei yi dao su	1
三磷酸腺苷氯化镁	san lin suan xian gan lv hua mei	1
三水杨酸胆碱镁	san shui yang suan dan jian mei	1
三维	san wei	1
三维钙	san wei gai	1
三维肌醇	san wei ji chun	1
三维葡磷钙	san wei pu lin gai	1
三维亚铁	san wei ya tie	1
三维鱼肝油	san wei yu gan you	1
三维樟柳碱	san wei zhang liu jian	1
三维制霉素	san wei zhi mei su	1
三溴	san xiu	1
三乙醇胺	san yi chun an	1
三唑仑	san zuo lun	1
色甘那敏	se gan na min	1
色甘萘甲那敏	se gan nai jia na min	1
色甘酸钠	se gan suan na	1
色羟丙钠	se qiang bing na	1
森林脑炎灭活疫苗	sen lin nao yan mie huo yi miao	1
沙丙蝶呤	sha bing die ling	1
沙丁胺醇	sha ding an chun	1
鲨肝醇	sha gan chun	1
沙格雷酯	sha ge lei zhi	1
沙格列汀	sha ge lie ting	1
沙格列汀二甲双胍	sha ge lie ting er jia shuang gua	1
沙库巴曲缬沙坦	sha ku ba qu xie sha tan	1
沙奎那韦	sha kui na wei	1
沙利度胺	sha li du an	1
沙美特罗	sha mei te luo	1
沙美特罗替卡松	sha mei te luo ti ka song	1
山莨菪碱	shan lang dang jian	1
山梨醇	shan li chun	1
山梨醇铁	shan li chun tie	1
伤寒多糖疫苗	shang han duo tang yi miao	1
伤寒副伤寒甲联合疫苗	shang han fu shang han jia lian he yi miao	1
伤寒副伤寒甲乙联合疫苗	shang han fu shang han jia yi lian he yi miao	1
伤寒疫苗	shang han yi miao	1
蛇毒血凝酶	she du xue ning mei	1
舍雷肽酶	she lei tai mei	1
舍曲林	she qu lin	1
舍他康唑	she ta kang zuo	1
神黄钠铝	shen huang na lv	1
参芪鱼肝油	shen qi yu gan you	1
肾上腺素	shen shang xian su	1
肾综合征出血热灭活疫苗型	shen zong he zheng chu xue re mie huo yi miao xing	1
升华硫	sheng hua liu	1
升华硫氯化氨基汞	sheng hua liu lv hua an ji gong	1
生理氯化钠	sheng li lv hua na	1
生理盐水	sheng li yan shui	1
生物合成高血糖素	sheng wu he cheng gao xue tang su	1
生物合成人胰岛素	sheng wu he cheng ren yi dao su	1
生长抑素	sheng zhang yi su	1
食母生	shi mu sheng	1
石杉碱甲	shi shan jian jia	1
十维	shi wei	1
十维铁	shi wei tie	1
十一酸睾酮	shi yi suan gao tong	1
十一烯酸	shi yi xi suan	1
舒巴坦	shu ba tan	1
舒必利	shu bi li	1
鼠表皮生长因子	shu biao pi sheng zhang yin zi	1
舒芬太尼	shu fen tai ni	1
舒更葡糖	shu geng pu tang	1
鼠李铋镁	shu li bi mei	1
舒林酸	shu lin suan	1
舒洛地特	shu luo di te	1
舒马普坦	shu ma pu tan	1
舒尼替尼	shu ni ti ni	1
鼠神经生长因子	shu shen jing sheng zhang yin zi	1
舒他西林	shu ta xi lin	1
舒托必利	shu tuo bi li	1
输血用号抗凝液	shu xue yong hao kang ning ye	1
输血用氯化钠	shu xue yong lv hua na	1
双半胱氨酸	shuang ban guang an suan	1
双半胱乙酯	shuang ban guang yi zhi	1
双重造影产气	shuang chong zao ying chan qi	1
双醋瑞因	shuang cu rui yin	1
双碘喹啉	shuang dian kui lin	1
双分伪麻	shuang fen wei ma	1
双复磷	shuang fu lin	1
双环醇	shuang huan chun	1
双磺沙棘桉青	shuang huang sha ji an qing	1
双价人乳头瘤病毒吸附疫苗	shuang jia ren ru tou liu bing du xi fu yi miao	1
双价肾综合征出血热纯化疫苗	shuang jia shen zong he zheng chu xue re chun hua yi miao	1
双肼屈嗪利血平	shuang jing qu qin li xue ping	1
双氯非那胺	shuang lv fei na an	1
双氯芬酸	shuang lv fen suan	1
双氯芬酸二乙胺	shuang lv fen suan er yi an	1
双氯芬酸利多卡因	shuang lv fen suan li duo ka yin	1
双氯芬酸钠	shuang lv fen suan na	1
双氯青霉素	shuang lv qing mei su	1
双嘧达莫	shuang mi da mo	1
双嘧啶	shuang mi ding	1
双扑伪麻	shuang pu wei ma	1
双歧杆菌活菌	shuang qi gan jun huo jun	1
双歧杆菌乳杆菌三联活菌	shuang qi gan jun ru gan jun san lian huo jun	1
双歧杆菌三联活菌	shuang qi gan jun san lian huo jun	1
双歧杆菌四联活菌	shuang qi gan jun si lian huo jun	1
双羟萘酸噻嘧啶	shuang qiang nai suan sai mi ding	1
双氢可待因	shuang qing ke dai yin	1
双氢麦角胺	shuang qing mai jiao an	1
双氢麦角毒碱	shuang qing mai jiao du jian	1
双氢青蒿素	shuang qing qing hao su	1
双氢青蒿素哌喹	shuang qing qing hao su pai kui	1
双水杨酯	shuang shui yang zhi	1
双香豆素	shuang xiang dou su	1
双氧异丙嗪	shuang yang yi bing qin	1
双唑泰	shuang zuo tai	1
水痘减毒活疫苗	shui dou jian du huo yi miao	1
水飞蓟宾	shui fei ji bin	1
水飞蓟宾葡甲胺	shui fei ji bin pu jia an	1
水飞蓟素	shui fei ji su	1
水解蛋白	shui jie dan bai	1
水溶性维生素	shui rong xing wei sheng su	1
水杨酸	shui yang suan	1
水杨酸苯酚	shui yang suan ben fen	1
水杨酸苯甲酸松油	shui yang suan ben jia suan song you	1
水杨酸苯佐卡因	shui yang suan ben zuo ka yin	1
水杨酸冰醋酸	shui yang suan bing cu suan	1
水杨酸毒扁豆碱	shui yang suan du bian dou jian	1
水杨酸甲酯	shui yang suan jia zhi	1
水杨酸镁	shui yang suan mei	1
水杨酸咪唑	shui yang suan mi zuo	1
水杨酸钠	shui yang suan na	1
水杨酸钠碘化钠	shui yang suan na dian hua na	1
水杨酸氧化锌	shui yang suan yang hua xin	1
顺铂	shun bo	1
顺铂氯化钠	shun bo lv hua na	1
四环素	si huan su	1
四环素醋酸可的松	si huan su cu suan ke di song	1
四环素可的松	si huan su ke di song	1
四价流感病毒裂解疫苗	si jia liu gan bing du lie jie yi miao	1
四价人乳头瘤病毒疫苗酿酒酵母	si jia ren ru tou liu bing du yi miao niang jiu jiao mu	1
司可巴比妥	si ke ba bi tuo	1
司库奇尤单抗	si ku qi you dan kang	1
司来吉兰	si lai ji lan	1
司来帕格	si lai pa ge	1
丝裂霉素	si lie mei su	1
司莫司汀	si mo si ting	1
司帕沙星	si pa sha xing	1
四氢帕马丁	si qing pa ma ding	1
司他夫定	si ta fu ding	1
司他斯汀	si ta si ting	1
司坦唑醇	si tan zuo chun	1
四维钙	si wei gai	1
司维拉姆	si wei la mu	1
四维葡萄糖	si wei pu tao tang	1
四维葡锌	si wei pu xin	1
四维他	si wei ta	1
四维王浆葡萄糖	si wei wang jiang pu tao tang	1
四烯甲萘醌	si xi jia nai kun	1
松节油	song jie you	1
羧苄西林	suo bian xi lin	1
索法酮	suo fa tong	1
缩宫素	suo gong su	1
缩合葡萄糖氯化钠	suo he pu tao tang lv hua na	1
羧甲淀粉	suo jia dian fen	1
羧甲基纤维素	suo jia ji xian wei su	1
羧甲司坦	suo jia si tan	1
羧甲纤维素	suo jia xian wei su	1
索拉非尼	suo la fei ni	1
索利那新	suo li na xin	1
索磷布韦	suo lin bu wei	1
索磷布韦维帕他韦	suo lin bu wei wei pa ta wei	1
索他洛尔	suo ta luo er	1
他达拉非	ta da la fei	1
他氟前列素	ta fu qian lie su	1
他卡西醇	ta ka xi chun	1
他克莫司	ta ke mo si	1
他莫昔芬	ta mo xi fen	1
他扎罗汀	ta zha luo ting	1
他扎罗汀倍他米松	ta zha luo ting bei ta mi song	1
酞丁安	tai ding an	1
肽放射免疫诊断试剂	tai fang she mian yi zhen duan shi ji	1
胎盘多肽	tai pan duo tai	1
坦度螺酮	tan du luo tong	1
炭疽活疫苗	tan ju huo yi miao	1
坦洛新坦索罗辛	tan luo xin tan suo luo xin	1
碳尿素呼气试验诊断试剂	tan niao su hu qi shi yan zhen duan shi ji	1
碳酸钙	tan suan gai	1
碳酸钙二甲硅油	tan suan gai er jia gui you	1
碳酸钙甘氨酸	tan suan gai gan an suan	1
碳酸钙维	tan suan gai wei	1
碳酸钙维元素	tan suan gai wei yuan su	1
碳酸镧	tan suan lan	1
碳酸锂	tan suan li	1
碳酸氢钠	tan suan qing na	1
碳酸氢钠林格	tan suan qing na lin ge	1
弹性火棉胶	tan xing huo mian jiao	1
弹性酶	tan xing mei	1
糖类抗原放射免疫诊断试剂盒	tang lei kang yuan fang she mian yi zhen duan shi ji he	1
糖类抗原免疫放射分析药盒	tang lei kang yuan mian yi fang she fen xi yao he	1
特比萘芬	te bi nai fen	1
特布他林	te bu ta lin	1
特布他林氯化钠	te bu ta lin lv hua na	1
特地唑胺	te di zuo an	1
特非那定	te fei na ding	1
特酚伪麻	te fen wei ma	1
特康唑	te kang zuo	1
特拉唑嗪	te la zuo qin	1
特立氟胺	te li fu an	1
特利加压素	te li jia ya su	1
特立帕肽	te li pa tai	1
特洛伪麻	te luo wei ma	1
特瑞普利单抗	te rui pu li dan kang	1
替比夫定	ti bi fu ding	1
替勃龙	ti bo long	1
替格瑞洛	ti ge rui luo	1
替吉奥	ti ji ao	1
蹄甲多肽	ti jia duo tai	1
替加氟	ti jia fu	1
替加氟氯化钠	ti jia fu lv hua na	1
替加环素	ti jia huan su	1
替卡西林克拉维酸	ti ka xi lin ke la wei suan	1
替考拉宁	ti kao la ning	1
替利定	ti li ding	1
替罗非班	ti luo fei ban	1
替罗非班氯化钠	ti luo fei ban lv hua na	1
替米沙坦	ti mi sha tan	1
替米沙坦氨氯地平	ti mi sha tan an lv di ping	1
替米沙坦氢氯噻嗪	ti mi sha tan qing lv sai qin	1
替莫唑胺	ti mo zuo an	1
替尼泊苷	ti ni bo gan	1
替诺福韦二吡呋酯	ti nuo fu wei er bi fu zhi	1
替普瑞酮	ti pu rui tong	1
蹄鞘	ti qiao	1
替硝唑	ti xiao zuo	1
替硝唑氯化钠	ti xiao zuo lv hua na	1
替硝唑葡萄糖	ti xiao zuo pu tao tang	1
替扎尼定	ti zha ni ding	1
田参氨基酸	tian can an ji suan	1
天花粉蛋白	tian hua fen dan bai	1
天麻素	tian ma su	1
铁铵锌铜维	tie an xin tong wei	1
铁蛋白放免药盒	tie dan bai fang mian yao he	1
铁蛋白放射免疫分析试剂盒	tie dan bai fang she mian yi fen xi shi ji he	1
铁羧葡胺	tie suo pu an	1
酮咯酸氨丁三醇	tong ge suan an ding san chun	1
酮康他索	tong kang ta suo	1
酮康唑	tong kang zuo	1
酮洛芬	tong luo fen	1
铜绿假单胞菌	tong lv jia dan bao jun	1
酮替芬	tong ti fen	1
头孢氨苄	tou bao an bian	1
头孢氨苄甲氧苄啶	tou bao an bian jia yang bian ding	1
头孢吡肟	tou bao bi wo	1
头孢丙烯	tou bao bing xi	1
头孢泊肟酯	tou bao bo wo zhi	1
头孢地尼	tou bao di ni	1
头孢地嗪	tou bao di qin	1
头孢地嗪氯化钠	tou bao di qin lv hua na	1
头孢地嗪葡萄糖	tou bao di qin pu tao tang	1
头孢呋辛	tou bao fu xin	1
头孢呋辛氯化钠	tou bao fu xin lv hua na	1
头孢呋辛酯	tou bao fu xin zhi	1
头孢甲肟	tou bao jia wo	1
头孢卡品	tou bao ka pin	1
头孢克洛	tou bao ke luo	1
头孢克肟	tou bao ke wo	1
头孢拉定	tou bao la ding	1
头孢硫脒	tou bao liu mi	1
头孢美唑	tou bao mei zuo	1
头孢孟多酯	tou bao meng duo zhi	1
头孢米诺	tou bao mi nuo	1
头孢尼西	tou bao ni xi	1
头孢哌酮	tou bao pai tong	1
头孢哌酮舒巴坦	tou bao pai tong shu ba tan	1
头孢哌酮他唑巴坦	tou bao pai tong ta zuo ba tan	1
头孢匹胺	tou bao pi an	1
头孢匹罗	tou bao pi luo	1
头孢羟氨苄	tou bao qiang an bian	1
头孢羟氨苄甲氧苄啶	tou bao qiang an bian jia yang bian ding	1
头孢曲松	tou bao qu song	1
头孢曲松舒巴坦	tou bao qu song shu ba tan	1
头孢曲松他唑巴坦	tou bao qu song ta zuo ba tan	1
头孢噻吩	tou bao sai fen	1
头孢噻利	tou bao sai li	1
头孢噻肟	tou bao sai wo	1
头孢噻肟舒巴坦	tou bao sai wo shu ba tan	1
头孢他啶	tou bao ta ding	1
头孢他啶阿维巴坦	tou bao ta ding a wei ba tan	1
头孢他啶氯化钠	tou bao ta ding lv hua na	1
头孢他啶他唑巴坦	tou bao ta ding ta zuo ba tan	1
头孢他美酯	tou bao ta mei zhi	1
头孢特仑新戊酯	tou bao te lun xin wu zhi	1
头孢替安	tou bao ti an	1
头孢替唑	tou bao ti zuo	1
头孢妥仑匹酯	tou bao tuo lun pi zhi	1
头孢西丁	tou bao xi ding	1
头孢西酮	tou bao xi tong	1
头孢唑林	tou bao zuo lin	1
头孢唑林氯化钠	tou bao zuo lin lv hua na	1
头孢唑肟	tou bao zuo wo	1
透明质酸放免药盒	tou ming zhi suan fang mian yao he	1
透明质酸放射免疫分析药盒	tou ming zhi suan fang she mian yi fen xi yao he	1
吐根	tu gen	1
兔抗人胸腺细胞免疫球蛋白	tu kang ren xiong xian xi bao mian yi qiu dan bai	1
土霉素	tu mei su	1
托吡卡胺	tuo bi ka an	1
托吡酯	tuo bi zhi	1
托泊替康	tuo bo ti kang	1
妥布霉素	tuo bu mei su	1
妥布霉素地塞米松	tuo bu mei su di sai mi song	1
妥布霉素氯化钠	tuo bu mei su lv hua na	1
托伐普坦	tuo fa pu tan	1
托法替布	tuo fa ti bu	1
托芬那酸	tuo fen na suan	1
托氟沙星	tuo fu sha xing	1
妥卡尼	tuo ka ni	1
托卡朋	tuo ka peng	1
托拉塞米	tuo la sai mi	1
妥拉唑啉	tuo la zuo lin	1
妥洛特罗	tuo luo te luo	1
托美丁	tuo mei ding	1
托莫西汀	tuo mo xi ting	1
托尼萘酸	tuo ni nai suan	1
托哌酮	tuo pai tong	1
托瑞米芬	tuo rui mi fen	1
妥舒沙星	tuo shu sha xing	1
托特罗定	tuo te luo ding	1
托烷司琼	tuo wan si qiong	1
托烷司琼氯化钠	tuo wan si qiong lv hua na	1
托烷司琼葡萄糖	tuo wan si qiong pu tao tang	1
托西溴苄铵	tuo xi xiu bian an	1
脱氧核苷酸	tuo yang he gan suan	1
托珠单抗	tuo zhu dan kang	1
万古霉素	wan gu mei su	1
维胺	wei an	1
维胺酯	wei an zhi	1
维胺酯维	wei an zhi wei	1
胃铋镁	wei bi mei	1
维丙胺	wei bing an	1
维参锌	wei can xin	1
维橙皮苷	wei cheng pi gan	1
胃蛋白酶	wei dan bai mei	1
维颠茄铝	wei dian qie lv	1
维颠茄铝镁	wei dian qie lv mei	1
维钙	wei gai	1
维格列汀	wei ge lie ting	1
维果糖酸钙	wei guo tang suan gai	1
维库溴铵	wei ku xiu an	1
维拉帕米	wei la pa mi	1
维磷	wei lin	1
维磷葡钙	wei lin pu gai	1
维磷酸氢钙	wei lin suan qing gai	1
维铝镁	wei lv mei	1
伪麻非索	wei ma fei suo	1
伪麻黄碱	wei ma huang jian	1
伪麻那敏	wei ma na min	1
维酶素	wei mei su	1
维莫非尼	wei mo fei ni	1
胃膜素	wei mo su	1
维葡萄糖	wei pu tao tang	1
微球蛋白放免药盒	wei qiu dan bai fang mian yao he	1
微球蛋白放射免疫分析药盒	wei qiu dan bai fang she mian yi fen xi yao he	1
维乳酸钙	wei ru suan gai	1
维三油	wei san you	1
维生素	wei sheng su	1
维生素二维芦丁	wei sheng su er wei lu ding	1
维生素钙	wei sheng su gai	1
维生素氯化钠	wei sheng su lv hua na	1
维生素钠	wei sheng su na	1
维生素葡萄糖	wei sheng su pu tao tang	1
维生素腺嘌呤	wei sheng su xian piao ling	1
维生素烟酸酯	wei sheng su yan suan zhi	1
维生素棕榈酸酯	wei sheng su zong lv suan zhi	1
维酸	wei suan	1
维他葡萄糖	wei ta pu tao tang	1
维替泊芬	wei ti bo fen	1
维铁	wei tie	1
文拉法辛	wen la fa xin	1
乌苯美司	wu ben mei si	1
屋尘螨变应原	wu chen man bian ying yuan	1
屋尘螨皮肤点刺诊断试剂盒	wu chen man pi fu dian ci zhen duan shi ji he	1
五氟利多	wu fu li duo	1
乌拉地尔	wu la di er	1
乌拉地尔氯化钠	wu la di er lv hua na	1
乌拉地尔葡萄糖	wu la di er pu tao tang	1
乌洛托品	wu luo tuo pin	1
乌美溴铵维兰特罗	wu mei xiu an wei lan te luo	1
无水硫酸钠	wu shui liu suan na	1
五水头孢唑林	wu shui tou bao zuo lin	1
乌司奴单抗	wu si nu dan kang	1
乌司他丁	wu si ta ding	1
戊四硝酯戊四醇酯	wu si xiao zhi wu si chun zhi	1
戊酸雌二醇	wu suan ci er chun	1
戊酸雌二醇雌二醇环丙孕酮	wu suan ci er chun ci er chun huan bing yun tong	1
五肽胃泌素	wu tai wei mi su	1
五维	wu wei	1
五维甘草那敏	wu wei gan cao na min	1
五维赖氨酸	wu wei lai an suan	1
五维赖氨酸葡萄糖	wu wei lai an suan pu tao tang	1
五维牛磺酸	wu wei niu huang suan	1
五维葡钙	wu wei pu gai	1
五维葡萄糖	wu wei pu tao tang	1
五维他	wu wei ta	1
戊乙奎醚	wu yi kui mi	1
细胞色素	xi bao se su	1
西吡氯铵	xi bi lv an	1
烯丙雌醇	xi bing ci chun	1
烯丙吗啡	xi bing ma fei	1
西达本胺	xi da ben an	1
西地吡罗昔康	xi di bi luo xi kang	1
西地碘	xi di dian	1
西地那非	xi di na fei	1
吸附百白破联合疫苗	xi fu bai bai po lian he yi miao	1
吸附白喉破伤风联合疫苗	xi fu bai hou po shang feng lian he yi miao	1
吸附白喉疫苗	xi fu bai hou yi miao	1
吸附百日咳白喉联合疫苗	xi fu bai ri ke bai hou lian he yi miao	1
吸附破伤风疫苗	xi fu po shang feng yi miao	1
吸附无细胞百白破联合疫苗	xi fu wu xi bao bai bai po lian he yi miao	1
吸附无细胞百日咳疫苗	xi fu wu xi bao bai ri ke yi miao	1
稀甘油	xi gan you	1
西格列汀	xi ge lie ting	1
西格列汀二甲双胍	xi ge lie ting er jia shuang gua	1
西甲硅油	xi jia gui you	1
硒酵母	xi jiao mu	1
细菌溶解产物	xi jun rong jie chan wu	1
细菌溶解物	xi jun rong jie wu	1
锡克试验毒素	xi ke shi yan du su	1
西拉普利	xi la pu li	1
西罗莫司	xi luo mo si	1
西洛他唑	xi luo ta zuo	1
西咪替丁	xi mi ti ding	1
西咪替丁氯化钠	xi mi ti ding lv hua na	1
西那卡塞	xi na ka sai	1
西尼必利	xi ni bi li	1
西尼地平	xi ni di ping	1
西曲瑞克	xi qu rui ke	1
西沙必利	xi sha bi li	1
吸收性明胶	xi shou xing ming jiao	1
吸收性氧化纤维素	xi shou xing yang hua xian wei su	1
喜树碱	xi shu jian	1
西索米星	xi suo mi xing	1
西索米星氯化钠	xi suo mi xing lv hua na	1
西他沙星	xi ta sha xing	1
西酞普兰	xi tai pu lan	1
西替利嗪	xi ti li qin	1
西替伪麻	xi ti wei ma	1
西妥昔单抗	xi tuo xi dan kang	1
稀戊二醛	xi wu er quan	1
细辛脑	xi xin nao	1
细辛脑氯化钠	xi xin nao lv hua na	1
腺苷	xian gan	1
腺苷蛋氨酸	xian gan dan an suan	1
腺苷钴胺	xian gan gu an	1
纤溶酶	xian rong mei	1
香草醛	xiang cao quan	1
香菇多糖	xiang gu duo tang	1
香菇菌多糖	xiang gu jun duo tang	1
硝苯地平	xiao ben di ping	1
小檗胺	xiao bo an	1
小檗碱	xiao bo jian	1
小檗碱甲氧苄啶	xiao bo jian jia yang bian ding	1
消毒弹性创可贴	xiao du tan xing chuang ke tie	1
小儿氨酚黄那敏	xiao er an fen huang na min	1
小儿氨酚那敏	xiao er an fen na min	1
小儿氨酚匹林	xiao er an fen pi lin	1
小儿氨酚匹林咖啡因	xiao er an fen pi lin ka fei yin	1
小儿氨酚烷胺	xiao er an fen wan an	1
小儿氨酚伪麻	xiao er an fen wei ma	1
小儿氨咖黄敏	xiao er an ka huang min	1
小儿安乃近	xiao er an nai jin	1
小儿贝诺酯	xiao er bei nuo zhi	1
小儿贝诺酯维	xiao er bei nuo zhi wei	1
小儿布洛芬	xiao er bu luo fen	1
小儿布洛伪麻	xiao er bu luo wei ma	1
小儿大黄碳酸氢钠	xiao er da huang tan suan qing na	1
小儿电解质补给	xiao er dian jie zhi bu gei	1
小儿对乙酰氨基酚	xiao er dui yi xian an ji fen	1
小儿对乙酰氨基酚异丙嗪	xiao er dui yi xian an ji fen yi bing qin	1
小儿多维生素	xiao er duo wei sheng su	1
小儿多种维生素	xiao er duo zhong wei sheng su	1
小儿法罗培南	xiao er fa luo pei nan	1
小儿酚氨咖敏	xiao er fen an ka min	1
小儿复方阿司匹林	xiao er fu fang a si pi lin	1
小儿复方氨酚烷胺	xiao er fu fang an fen wan an	1
小儿复方氨基酸	xiao er fu fang an ji suan	1
小儿复方磺胺二甲嘧啶	xiao er fu fang huang an er jia mi ding	1
小儿复方磺胺甲噁唑	xiao er fu fang huang an jia e zuo	1
小儿复方磺胺嘧啶	xiao er fu fang huang an mi ding	1
小儿复方赖氨酸	xiao er fu fang lai an suan	1
小儿复方麻黄碱桔梗	xiao er fu fang ma huang jian jie geng	1
小儿复方麝香草酚	xiao er fu fang she xiang cao fen	1
小儿复方四维亚铁散	xiao er fu fang si wei ya tie san	1
小儿复方盐酸妥洛特罗	xiao er fu fang yan suan tuo luo te luo	1
小儿枸磺新啶	xiao er gou huang xin ding	1
小儿九维	xiao er jiu wei	1
小儿赖氨酸	xiao er lai an suan	1
小儿硫酸亚铁	xiao er liu suan ya tie	1
小儿美敏伪麻	xiao er mei min wei ma	1
小儿葡磷泛三钙	xiao er pu lin fan san gai	1
小儿庆大霉素	xiao er qing da mei su	1
小儿乳酸菌素	xiao er ru suan jun su	1
小儿善存	xiao er shan cun	1
小儿十维	xiao er shi wei	1
小儿双磺甲氧苄啶	xiao er shuang huang jia yang bian ding	1
小儿双嘧啶	xiao er shuang mi ding	1
小儿四维钙	xiao er si wei gai	1
小儿四维葡钙	xiao er si wei pu gai	1
小儿碳酸钙	xiao er tan suan gai	1
小儿伪麻	xiao er wei ma	1
小儿维生素	xiao er wei sheng su	1
小儿五维赖氨酸	xiao er wu wei lai an suan	1
小儿小檗碱	xiao er xiao bo jian	1
小儿异丙嗪	xiao er yi bing qin	1
小儿愈美那敏	xiao er yu mei na min	1
硝呋太尔	xiao fu tai er	1
硝呋太尔制霉菌素	xiao fu tai er zhi mei jun su	1
硝呋太尔制霉素	xiao fu tai er zhi mei su	1
消化酶	xiao hua mei	1
硝卡芥	xiao ka jie	1
小麦纤维素	xiao mai xian wei su	1
小牛脾提取物	xiao niu pi ti qu wu	1
小牛血清去蛋白	xiao niu xue qing qu dan bai	1
小牛血去蛋白提取物	xiao niu xue qu dan bai ti qu wu	1
小牛血去蛋白提取物氯化钠	xiao niu xue qu dan bai ti qu wu lv hua na	1
小诺霉素	xiao nuo mei su	1
小诺霉素氯化钠	xiao nuo mei su lv hua na	1
硝普钠	xiao pu na	1
硝酸甘油	xiao suan gan you	1
硝酸甘油氯化钠	xiao suan gan you lv hua na	1
硝酸硫胺	xiao suan liu an	1
硝酸士的宁	xiao suan shi de ning	1
硝酸异山梨酯	xiao suan yi shan li zhi	1
硝酸异山梨酯氯化钠	xiao suan yi shan li zhi lv hua na	1
硝酸异山梨酯葡萄糖	xiao suan yi shan li zhi pu tao tang	1
硝酸一叶萩碱	xiao suan yi ye qiu jian	1
硝酸银	xiao suan yin	1
硝西泮	xiao xi pan	1
消旋卡多曲	xiao xuan ka duo qu	1
消旋山莨菪碱	xiao xuan shan lang dang jian	1
消旋山莨菪碱氯化钠	xiao xuan shan lang dang jian lv hua na	1
蝎毒	xie du	1
缬更昔洛韦	xie geng xi luo wei	1
缬沙坦	xie sha tan	1
缬沙坦氨氯地平	xie sha tan an lv di ping	1
缬沙坦氢氯噻嗪	xie sha tan qing lv sai qin	1
信迪利单抗	xin di li dan kang	1
新地松	xin di song	1
辛伐他汀	xin fa ta ting	1
新福菌素	xin fu jun su	1
心肌肽	xin ji tai	1
心可定	xin ke ding	1
新霉素	xin mei su	1
新霉素氟轻松	xin mei su fu qing song	1
新氢松	xin qing song	1
新斯的明	xin si di ming	1
新鱼腥草素	xin yu xing cao su	1
型流感嗜血杆菌结合疫苗	xing liu gan shi xue gan jun jie he yi miao	1
杏仁腈	xing ren jing	1
型肉毒毒素	xing rou du du su	1
型肉毒抗毒素	xing rou du kang du su	1
杏芎氯化钠	xing xiong lv hua na	1
熊去氧胆酸	xiong qu yang dan suan	1
胸腺蛋白	xiong xian dan bai	1
胸腺法新	xiong xian fa xin	1
胸腺肽	xiong xian tai	1
胸腺肽氯化钠	xiong xian tai lv hua na	1
胸腺五肽	xiong xian wu tai	1
溴吡斯的明	xiu bi si de ming	1
溴丙胺太林	xiu bing an tai lin	1
溴芬酸钠	xiu fen suan na	1
溴夫定	xiu fu ding	1
溴化钙	xiu hua gai	1
溴己新	xiu ji xin	1
溴己新葡萄糖	xiu ji xin pu tao tang	1
溴甲贝那替秦	xiu jia bei na ti qin	1
溴甲东莨菪碱	xiu jia dong lang dang jian	1
溴米那普鲁卡因	xiu mi na pu lu ka yin	1
溴莫尼定	xiu mo ni ding	1
溴莫尼定噻吗洛尔	xiu mo ni ding sai ma luo er	1
溴替唑仑	xiu ti zuo lun	1
溴新斯的明	xiu xin si di ming	1
溴隐亭	xiu yin ting	1
血卟啉	xue bu lin	1
血液保存液	xue ye bao cun ye	1
血液滤过置换基础液	xue ye lv guo zhi huan ji chu ye	1
血液滤过置换液	xue ye lv guo zhi huan ye	1
亚胺培南西司他丁	ya an pei nan xi si ta ding	1
亚甲蓝	ya jia lan	1
亚硫酸氢钠	ya liu suan qing na	1
亚硫酸氢钠甲萘醌	ya liu suan qing na jia nai kun	1
亚砷酸氯化钠	ya shen suan lv hua na	1
亚砷酸三氧化二砷	ya shen suan san yang hua er shen	1
亚锡二巯丁二钠	ya xi er qiu ding er na	1
亚锡甲氧异腈	ya xi jia yang yi jing	1
亚锡焦磷酸钠	ya xi jiao lin suan na	1
亚锡聚合白蛋白	ya xi ju he bai dan bai	1
亚锡喷替酸	ya xi pen ti suan	1
亚锡葡庚糖酸钠	ya xi pu geng tang suan na	1
亚锡双半胱氨酸	ya xi shuang ban guang an suan	1
亚锡双半胱乙酯	ya xi shuang ban guang yi zhi	1
亚硒酸钠	ya xi suan na	1
亚锡替曲膦	ya xi ti qu lin	1
亚锡亚甲基二膦酸盐	ya xi ya jia ji er lin suan yan	1
亚锡依替菲宁	ya xi yi ti fei ning	1
亚锡植酸钠	ya xi zhi suan na	1
亚硝酸钠	ya xiao suan na	1
亚硝酸异戊酯	ya xiao suan yi wu zhi	1
亚叶酸钙	ya ye suan gai	1
亚叶酸钙氯化钠	ya ye suan gai lv hua na	1
亚叶酸钠	ya ye suan na	1
亚油酸	ya you suan	1
眼氨肽	yan an tai	1
炎琥宁	yan hu ning	1
炎琥宁氯化钠	yan hu ning lv hua na	1
延胡索乙素	yan hu suo yi su	1
烟肼丁醇	yan jing ding chun	1
烟酸	yan suan	1
烟酸肌醇酯	yan suan ji chun zhi	1
烟酸占替诺	yan suan zhan ti nuo	1
烟酸占替诺氯化钠	yan suan zhan ti nuo lv hua na	1
烟酸占替诺葡萄糖	yan suan zhan ti nuo pu tao tang	1
烟酰胺	yan xian an	1
烟酰胺葡萄糖	yan xian an pu tao tang	1
洋地黄毒苷	yang di huang du gan	1
氧氟沙星	yang fu sha xing	1
氧氟沙星甘露醇	yang fu sha xing gan lu chun	1
氧氟沙星氯化钠	yang fu sha xing lv hua na	1
氧氟沙星葡萄糖	yang fu sha xing pu tao tang	1
氧氟沙星山梨醇	yang fu sha xing shan li chun	1
氧化淀粉	yang hua dian fen	1
氧化锌	yang hua xin	1
氧化锌硫	yang hua xin liu	1
氧化锌升华硫	yang hua xin sheng hua liu	1
氧化亚氮	yang hua ya dan	1
氧化樟脑	yang hua zhang nao	1
氧烯洛尔	yang xi luo er	1
药用炭	yao yong tan	1
叶绿素铜	ye lv su tong	1
叶酸	ye suan	1
叶酸维	ye suan wei	1
液状石蜡	ye zhuang shi la	1
乙胺吡嗪利福异烟	yi an bi qin li fu yi yan	1
乙胺丁醇	yi an ding chun	1
乙胺利福异烟	yi an li fu yi yan	1
乙胺硫脲	yi an liu niao	1
乙胺嘧啶	yi an mi ding	1
乙胺嗪	yi an qin	1
依巴斯汀	yi ba si ting	1
伊班膦酸	yi ban lin suan	1
异丙吡仑	yi bing bi lun	1
异丙嗪	yi bing qin	1
异丙嗪胆汁	yi bing qin dan zhi	1
异丙肾上腺素	yi bing shen shang xian su	1
异丙托溴铵	yi bing tuo xiu an	1
伊布利特	yi bu li te	1
伊布替尼	yi bu ti ni	1
伊达比星	yi da bi xing	1
依达拉奉	yi da la feng	1
依达赛珠单抗	yi da sai zhu dan kang	1
胰蛋白酶	yi dan bai mei	1
胰岛素	yi dao su	1
胰岛素放射免疫诊断试剂	yi dao su fang she mian yi zhen duan shi ji	1
依地酸钙钠	yi di suan gai na	1
异丁司特	yi ding si te	1
益多酯	yi duo zhi	1
伊伐布雷定	yi fa bu lei ding	1
依非韦伦	yi fei wei lun	1
依酚氯铵	yi fen lv an	1
异福利福平异烟肼	yi fu li fu ping yi yan jing	1
异氟烷	yi fu wan	1
异福酰胺	yi fu xian an	1
异甘草酸镁	yi gan cao suan mei	1
乙琥胺	yi hu an	1
异环磷酰胺	yi huan lin xian an	1
胰激肽原酶	yi ji tai yuan mei	1
依降钙素	yi jiang gai su	1
依卡倍特	yi ka bei te	1
益康倍松	yi kang bei song	1
异康唑	yi kang zuo	1
益康唑	yi kang zuo	1
异康唑二氟可龙	yi kang zuo er fu ke long	1
异可利定	yi ke li ding	1
依库珠单抗	yi ku zhu dan kang	1
伊来西胺	yi lai xi an	1
伊立替康	yi li ti kang	1
依洛硫酸酯酶	yi luo liu suan zhi mei	1
伊洛前列素	yi luo qian lie su	1
依洛尤单抗	yi luo you dan kang	1
伊马替尼	yi ma ti ni	1
胰酶	yi mei	1
依美斯汀	yi mei si ting	1
依米丁	yi mi ding	1
伊米苷酶	yi mi gan mei	1
胰糜酶	yi mi mei	1
依那普利	yi na pu li	1
依那普利拉	yi na pu li la	1
依那普利氢氯噻嗪	yi na pu li qing lv sai qin	1
依那普利叶酸	yi na pu li ye suan	1
依那西普	yi na xi pu	1
依诺肝素钠	yi nuo gan su na	1
依诺沙星	yi nuo sha xing	1
依诺沙星葡萄糖	yi nuo sha xing pu tao tang	1
异帕米星	yi pa mi xing	1
依帕司他	yi pa si ta	1
乙哌立松	yi pai li song	1
依匹斯汀	yi pi si ting	1
依普黄酮	yi pu huang tong	1
依普拉酮	yi pu la tong	1
依普沙坦	yi pu sha tan	1
伊曲康唑	yi qu kang zuo	1
依曲韦林	yi qu wei lin	1
依沙吖啶	yi sha a ding	1
依沙吖啶利凡诺	yi sha a ding li fan nuo	1
伊沙佐米	yi sha zuo mi	1
异山梨醇	yi shan li chun	1
乙水杨胺	yi shui yang an	1
伊索拉定	yi suo la ding	1
依他尼酸	yi ta ni suan	1
依他佐辛	yi ta zuo xin	1
抑肽酶	yi tai mei	1
抑肽酶氯化钠	yi tai mei lv hua na	1
依替巴肽	yi ti ba tai	1
依替膦酸	yi ti lin suan	1
依替米星	yi ti mi xing	1
依替米星氯化钠	yi ti mi xing lv hua na	1
伊托必利	yi tuo bi li	1
依托泊苷	yi tuo bo gan	1
依托度酸	yi tuo du suan	1
依托芬那酯	yi tuo fen na zhi	1
依托红霉素	yi tuo hong mei su	1
依托考昔	yi tuo kao xi	1
依托咪酯	yi tuo mi zhi	1
依托孕烯	yi tuo yun xi	1
依托孕烯炔雌醇	yi tuo yun xi que ci chun	1
伊维菌素	yi wei jun su	1
依维莫司	yi wei mo si	1
异维酸	yi wei suan	1
异维酸红霉素	yi wei suan hong mei su	1
异戊巴比妥	yi wu ba bi tuo	1
依西美坦	yi xi mei tan	1
乙酰胺	yi xian an	1
乙酰半胱氨酸	yi xian ban guang an suan	1
乙酰谷酰胺	yi xian gu xian an	1
乙酰谷酰胺氯化钠	yi xian gu xian an lv hua na	1
乙酰谷酰胺葡萄糖	yi xian gu xian an pu tao tang	1
乙酰吉他霉素	yi xian ji ta mei su	1
乙酰螺旋霉素	yi xian luo xuan mei su	1
乙酰麦迪霉素	yi xian mai di mei su	1
乙酰水杨酸孕烯诺龙	yi xian shui yang suan yun xi nuo long	1
乙酰天麻素	yi xian tian ma su	1
乙酰乌头碱	yi xian wu tou jian	1
乙酰唑胺	yi xian zuo an	1
乙酰左卡尼汀	yi xian zuo ka ni ting	1
乙型肝炎人免疫球蛋白	yi xing gan yan ren mian yi qiu dan bai	1
乙型脑炎纯化疫苗	yi xing nao yan chun hua yi miao	1
乙型脑炎纯化疫苗地鼠肾细胞	yi xing nao yan chun hua yi miao di shu shen xi bao	1
乙型脑炎减毒活疫苗	yi xing nao yan jian du huo yi miao	1
乙型脑炎灭活疫苗	yi xing nao yan mie huo yi miao	1
乙型脑炎灭活疫苗地鼠肾细胞	yi xing nao yan mie huo yi miao di shu shen xi bao	1
乙型脑炎灭活疫苗细胞	yi xing nao yan mie huo yi miao xi bao	1
异烟肼	yi yan jing	1
异烟肼氯化钠	yi yan jing lv hua na	1
异烟肼维	yi yan jing wei	1
异烟腙	yi yan zong	1
乙氧苯柳胺	yi yang ben liu an	1
乙氧黄酮	yi yang huang tong	1
依折麦布	yi zhe mai bu	1
依折麦布辛伐他汀	yi zhe mai bu xin fa ta ting	1
吲达帕胺	yin da pa an	1
茚达特罗	yin da te luo	1
茚达特罗格隆溴铵	yin da te luo ge long xiu an	1
茚地那韦	yin di na wei	1
吲哚布芬	yin duo bu fen	1
吲哚菁绿	yin duo jing lv	1
吲哚拉辛	yin duo la xin	1
吲哚洛尔	yin duo luo er	1
吲哚美辛	yin duo mei xin	1
吲哚美辛呋喃唑酮	yin duo mei xin fu nan zuo tong	1
吲哚美辛三七冰片	yin duo mei xin san qi bing pian	1
吲哚美辛沙丁胺醇	yin duo mei xin sha ding an chun	1
银耳孢糖	yin er bao tang	1
蚓激酶	yin ji mei	1
因卡膦酸二钠英卡膦酸二钠	yin ka lin suan er na ying ka lin suan er na	1
英夫利西单抗	ying fu li xi dan kang	1
荧光素钠	ying guang su na	1
英卡膦酸二钠	ying ka lin suan er na	1
罂粟碱	ying su jian	1
罂粟碱氯化钠	ying su jian lv hua na	1
罂粟乙碘油	ying su yi dian you	1
蛹油亚麻酸乙酯	yong you ya ma suan yi zhi	1
右丙亚胺右雷佐生	you bing ya an you lei zuo sheng	1
游离甲状腺素放射免疫分析药盒	you li jia zhuang xian su fang she mian yi fen xi yao he	1
右美沙芬	you mei sha fen	1
右美沙芬愈创甘油醚	you mei sha fen yu chuang gan you mi	1
右美托咪定	you mei tuo mi ding	1
尤瑞克林	you rui ke lin	1
右酮洛芬	you tong luo fen	1
右旋布洛芬	you xuan bu luo fen	1
右旋噻吗洛尔	you xuan sai ma luo er	1
右旋糖酐	you xuan tang gan	1
右旋糖酐氨基酸	you xuan tang gan an ji suan	1
右旋糖酐甘油	you xuan tang gan gan you	1
右旋糖酐氯化钠	you xuan tang gan lv hua na	1
右旋糖酐葡萄糖	you xuan tang gan pu tao tang	1
右旋糖酐羟丙甲纤维素	you xuan tang gan qiang bing jia xian wei su	1
右旋糖酐铁	you xuan tang gan tie	1
右旋酮洛芬氨丁三醇	you xuan tong luo fen an ding san chun	1
右佐匹克隆	you zuo pi ke long	1
愈创甘油醚	yu chuang gan you mi	1
愈创蓝油烃	yu chuang lan you ting	1
愈创维林那敏	yu chuang wei lin na min	1
愈创罂粟待因	yu chuang ying su dai yin	1
愈酚待因	yu fen dai yin	1
愈酚甲麻那敏	yu fen jia ma na min	1
愈酚喷托异丙嗪	yu fen pen tuo yi bing qin	1
愈酚维林	yu fen wei lin	1
愈酚伪麻	yu fen wei ma	1
愈酚伪麻待因	yu fen wei ma dai yin	1
愈酚溴新	yu fen xiu xin	1
鱼肝油	yu gan you	1
鱼肝油酸钠	yu gan you suan na	1
鱼精蛋白	yu jing dan bai	1
愈美	yu mei	1
愈美甲麻敏	yu mei jia ma min	1
鱼石脂	yu shi zhi	1
鱼石脂颠茄	yu shi zhi dian qie	1
鱼石脂氧化锌	yu shi zhi yang hua xin	1
鱼腥草素	yu xing cao su	1
鱼油脂肪乳	yu you zhi fang ru	1
鱼油中长链脂肪乳	yu you zhong chang lian zhi fang ru	1
月见草油	yue jian cao you	1
孕三烯酮	yun san xi tong	1
云芝胞内糖肽	yun zhi bao nei tang tai	1
藻酸双酯钠	zao suan shuang zhi na	1
藻酸双酯钠氯化钠	zao suan shuang zhi na lv hua na	1
扎来普隆	zha lai pu long	1
扎鲁司特	zha lu si te	1
扎那米韦	zha na mi wei	1
樟柳碱	zhang liu jian	1
樟脑	zhang nao	1
樟脑苯酚	zhang nao ben fen	1
樟脑薄荷柳酯	zhang nao bo he liu zhi	1
樟脑磺酸钠	zhang nao huang suan na	1
樟脑水合氯醛	zhang nao shui he lv quan	1
蔗糖铁	zhe tang tie	1
整蛋白型肠内营养剂	zheng dan bai xing chang nei ying yang ji	1
脂肪乳	zhi fang ru	1
脂肪乳氨基酸	zhi fang ru an ji suan	1
脂肪乳氨基酸葡萄糖	zhi fang ru an ji suan pu tao tang	1
治疗用布氏菌制剂	zhi liao yong bu shi jun zhi ji	1
至灵菌丝	zhi ling jun si	1
制霉菌素	zhi mei jun su	1
制霉素	zhi mei su	1
脂溶性维生素	zhi rong xing wei sheng su	1
脂溶性维生素水溶性维生素	zhi rong xing wei sheng su shui rong xing wei sheng su	1
止血纤维	zhi xue xian wei	1
种氨基酸	zhong an ji suan	1
中长链脂肪乳	zhong chang lian zhi fang ru	1
中长链脂肪乳氨基酸葡萄糖	zhong chang lian zhi fang ru an ji suan pu tao tang	1
中性蛋白酶	zhong xing dan bai mei	1
猪胆粉薄荷脑	zhu dan fen bo he nao	1
猪肺磷脂	zhu fei lin zhi	1
株脊髓灰质炎灭活疫苗细胞	zhu ji sui hui zhi yan mie huo yi miao xi bao	1
珠氯噻醇	zhu lv sai chun	1
珠氯噻醇醋酸酯	zhu lv sai chun cu suan zhi	1
珠氯噻醇癸酸酯	zhu lv sai chun gui suan zhi	1
猪免疫球蛋白	zhu mian yi qiu dan bai	1
猪脱氧胆酸	zhu tuo yang dan suan	1
猪源纤维蛋白	zhu yuan xian wei dan bai	1
转化糖	zhuan hua tang	1
转化糖电解质	zhuan hua tang dian jie zhi	1
转移因子	zhuan yi yin zi	1
紫杉醇	zi shan chun	1
紫杉醇白蛋白结合型	zi shan chun bai dan bai jie he xing	1
棕榈氯霉素	zong lv lv mei su	1
棕榈氯霉素型	zong lv lv mei su xing	1
棕榈帕利哌酮酯	zong lv pa li pai tong zhi	1
组织胺人免疫球蛋白	zu zhi an ren mian yi qiu dan bai	1
左氨氯地平左旋氨氯地平	zuo an lv di ping zuo xuan an lv di ping	1
左奥硝唑	zuo ao xiao zuo	1
左奥硝唑氯化钠	zuo ao xiao zuo lv hua na	1
唑吡坦	zuo bi tan	1
左布比卡因	zuo bu bi ka yin	1
左布诺洛尔	zuo bu nuo luo er	1
左甲状腺素	zuo jia zhuang xian su	1
左卡巴斯汀	zuo ka ba si ting	1
左卡尼汀	zuo ka ni ting	1
唑来膦酸	zuo lai lin suan	1
佐米曲普坦	zuo mi qu pu tan	1
唑尼沙胺	zuo ni sha an	1
佐匹克隆	zuo pi ke long	1
左羟丙哌嗪	zuo qiang bing pai qin	1
左炔诺孕酮	zuo que nuo yun tong	1
左炔诺孕酮炔雌醇	zuo que nuo yun tong que ci chun	1
左炔诺孕酮炔雌醚	zuo que nuo yun tong que ci mi	1
左西孟旦	zuo xi meng dan	1
左西替利嗪	zuo xi ti li qin	1
左旋多巴	zuo xuan duo ba	1
左旋多巴卡比多巴	zuo xuan duo ba ka bi duo ba	1
左旋多巴卡比多巴卡左双多巴	zuo xuan duo ba ka bi duo ba ka zuo shuang duo ba	1
左旋咪唑	zuo xuan mi zuo	1
左亚叶酸钙	zuo ya ye suan gai	1
左氧氟沙星	zuo yang fu sha xing	1
左氧氟沙星氯化钠	zuo yang fu sha xing lv hua na	1
左氧氟沙星葡萄糖	zuo yang fu sha xing pu tao tang	1
左乙拉西坦	zuo yi la xi tan	1
