阿尔泰狗哇花	a er tai gou wa hua	1
阿佛霉菌素	a fo mei jun su	1
阿罗津	a luo jin	1
阿普隆	a pu long	1
阿锐生	a rui sheng	1
阿苏妙	a su miao	1
阿特拉津	a te la jin	1
阿维菌素	a wei jun su	1
阿月浑子	a yue hun zi	1
艾白粉病	ai bai fen bing	1
爱比菌素	ai bi jun su	1
艾锄	ai chu	1
矮刀豆	ai dao dou	1
皑粉蚧	ai fen jie	1
爱福丁	ai fu ding	1
矮秆	ai gan	1
矮秆作物	ai gan zuo wu	1
艾割	ai ge	1
矮化	ai hua	1
矮花叶病	ai hua ye bing	1
矮花叶病毒病	ai hua ye bing du bing	1
矮化栽培	ai hua zai pei	1
矮化砧	ai hua zhen	1
矮健素	ai jian su	1
矮脚蕉	ai jiao jiao	1
爱卡士	ai ka shi	1
爱诺明星	ai nuo ming xing	1
爱诺瑞丁	ai nuo rui ding	1
艾氏剂	ai shi ji	1
矮缩病	ai suo bing	1
矮腥黑穗病	ai xing hei sui bing	1
矮雪轮	ai xue lun	1
爱乐散	ai yue san	1
癌肿病	ai zhong bing	1
矮壮素	ai zhuang su	1
胺苯磺隆	an ben huang long	1
胺丙畏	an bing wei	1
胺草唑	an cao zuo	1
安底斯	an di si	1
氨苷霉素	an gan mei su	1
暗管	an guan	1
暗管塑孔犁	an guan su kong li	1
氨化	an hua	1
氨化泥炭	an hua ni tan	1
安磺灵	an huang ling	1
胺磺铜	an huang tong	1
氨基寡糖素	an ji gua tang su	1
按件记工	an jian ji gong	1
胺菊酯	an ju zhi	1
安克力	an ke li	1
安克锰锌	an ke meng xin	1
安乐椅	an le yi	1
安绿宝	an lv bao	1
安灭灵	an mie ling	1
安全饮水	an quan yin shui	1
安杀丹	an sha dan	1
桉树	an shu	1
氨水	an shui	1
铵态氮	an tai dan	1
铵态氮肥	an tai dan fei	1
胺硝草	an xiao cao	1
桉叶素	an ye su	1
安种宁	an zhong ning	1
螯合剂	ao he ji	1
凹缘菱纹叶蝉	ao yuan ling wen ye chan	1
澳洲坚果	ao zhou jian guo	1
疤斑	ba ban	1
巴楚菜蝽	ba chu cai chun	1
巴旦杏	ba dan xing	1
耙地	ba di	1
耙点病	ba dian bing	1
八点广翅蜡蝉	ba dian guang chi la chan	1
八点灰灯蛾	ba dian hui deng e	1
巴毒磷	ba du lin	1
八甲磷	ba jia lin	1
芭蕉芋	ba jiao yu	1
拔节肥	ba jie fei	1
拔节期	ba jie qi	1
芭蕾舞星	ba lei wu xing	1
霸螨灵	ba man ling	1
耙平	ba ping	1
耙碎	ba sui	1
耙田	ba tian	1
八位位组	ba wei wei zu	1
八位字节	ba wei zi jie	1
巴西木	ba xi mu	1
巴西橡胶树	ba xi xiang jiao shu	1
八仙花	ba xian hua	1
白斑病	bai ban bing	1
白背飞虱	bai bei fei shi	1
白边地老虎	bai bian di lao hu	1
白扁豆	bai bian dou	1
白菜	bai cai	1
白菜类蔬菜	bai cai lei shu cai	1
白菜型油菜	bai cai xing you cai	1
白草	bai cao	1
稗草	bai cao	1
稗草胺	bai cao an	1
百草克	bai cao ke	1
百草枯	bai cao ku	1
稗草畏	bai cao wei	1
白昌灯峨	bai chang deng e	1
白翅叶蝉	bai chi ye chan	1
百敌灭	bai di mie	1
白蛾蜡蝉	bai e la chan	1
白粉病	bai fen bing	1
白秆病	bai gan bing	1
白喉	bai hou	1
白喉雀	bai hou que	1
白蝴蝶	bai hu die	1
白化	bai hua	1
白花草木樨	bai hua cao mu xi	1
白花菖蒲莲	bai hua chang pu lian	1
百华花楸	bai hua hua qiu	1
白花曼陀罗	bai hua man tuo luo	1
白化苗	bai hua miao	1
白僵菌	bai jiang jun	1
白鸠	bai jiu	1
白绢病	bai juan bing	1
百菌清	bai jun qing	1
白壳	bai ke	1
白兰花	bai lan hua	1
白梨	bai li	1
百里通	bai li tong	1
百里香	bai li xiang	1
百粒重	bai li zhong	1
稗蓼灵	bai liao ling	1
白脉粘虫	bai mai nian chong	1
白霉病	bai mei bing	1
白米分级	bai mi fen ji	1
白螟	bai ming	1
百亩	bai mu	1
白囊蓑蛾	bai nang suo e	1
白皮豆	bai pi dou	1
白皮松	bai pi song	1
白曲霉病	bai qu mei bing	1
百日草	bai ri cao	1
百日菊	bai ri ju	1
白色双孢蘑菇	bai se shuang bao mo gu	1
稗莎清	bai sha qing	1
白虱	bai shi	1
柏树	bai shu	1
百树得	bai shu de	1
百树菊酯	bai shu ju zhi	1
白穗	bai sui	1
拜太斯	bai tai si	1
百坦	bai tan	1
白头翁	bai tou weng	1
白纹羽网病	bai wen yu wang bing	1
稗无踪	bai wu zong	1
白星花金龟	bai xing hua jin gui	1
白锈病	bai xiu bing	1
摆芽	bai ya	1
摆秧	bai yang	1
白叶病	bai ye bing	1
白叶枯病	bai ye ku bing	1
白蚁	bai yi	1
白羽蛾	bai yu e	1
百治磷	bai zhi lin	1
百治屠	bai zhi tu	1
摆种	bai zhong	1
百株	bai zhu	1
摆籽	bai zi	1
斑背安缘蝽	ban bei an yuan chun	1
斑病	ban bing	1
斑驳病毒病	ban bo bing du bing	1
斑点	ban dian	1
斑点病	ban dian bing	1
半冬性	ban dong xing	1
半干旱气候	ban gan han qi hou	1
拌和	ban huo	1
半寄生物	ban ji sheng wu	1
半开放式棚	ban kai fang shi peng	1
斑枯病	ban ku bing	1
板栗树	ban li shu	1
板栗园	ban li yuan	1
斑林狸	ban lin li	1
斑螟	ban ming	1
半耐寒蔬菜	ban nai han shu cai	1
斑潜蝇	ban qian ying	1
半日工作	ban ri gong zuo	1
半山区	ban shan qu	1
半湿润气候	ban shi run qi hou	1
半数耐受极限	ban shu nai shou ji xian	1
半数致死量	ban shu zhi si liang	1
半同胞交配	ban tong bao jiao pei	1
半喂入	ban wei ru	1
半喂入水稻联合收割机	ban wei ru shui dao lian he shou ge ji	1
拌细土	ban xi tu	1
半夏	ban xia	1
斑须蝽	ban xu chun	1
半悬挂式农具	ban xuan gua shi nong ju	1
半叶素	ban ye su	1
板栽	ban zai	1
斑疹伤寒	ban zhen shang han	1
半知菌	ban zhi jun	1
半支莲	ban zhi lian	1
拌种	ban zhong	1
拌种胺	ban zhong an	1
拌种咯	ban zhong ge	1
拌种机	ban zhong ji	1
拌种磷	ban zhong lin	1
拌种灵	ban zhong ling	1
拌种双	ban zhong shuang	1
拌种唑	ban zhong zuo	1
绑蔓	bang man	1
保持系	bao chi xi	1
报春花	bao chun hua	1
保肥	bao fei	1
报费	bao fei	1
保丰	bao feng	1
保根	bao gen	1
包谷秆	bao gu gan	1
雹害	bao hai	1
保好鸿	bao hao hong	1
饱和湿度	bao he shi du	1
保护地	bao hu di	1
保护地栽培	bao hu di zai pei	1
保护剂	bao hu ji	1
爆花	bao hua	1
保健护士	bao jian hu shi	1
宝丽安	bao li an	1
保利霉素	bao li mei su	1
爆粒玉米	bao li yu mi	1
爆裂型	bao lie xing	1
保绿素	bao lv su	1
饱满度	bao man du	1
保米磷	bao mi lin	1
保棉丹	bao mian dan	1
保棉丰	bao mian feng	1
保棉磷	bao mian lin	1
保苗灵	bao miao ling	1
包膜肥料	bao mo fei liao	1
胞囊线虫病	bao nang xian chong bing	1
保蘖	bao nie	1
苞片	bao pian	1
曝气池	bao qi chi	1
宝收	bao shou	1
苞数	bao shu	1
包数	bao shu	1
保水	bao shui	1
保水剂	bao shui ji	1
保水能力	bao shui neng li	1
保松噻	bao song sai	1
保穗	bao sui	1
保卫反应	bao wei fan ying	1
豹纹病	bao wen bing	1
保鲜酯	bao xian zhi	1
保鲜贮运蔬菜	bao xian zhu yun shu cai	1
苞兴	bao xing	1
苞叶	bao ye	1
保叶	bao ye	1
包衣	bao yi	1
包衣肥料	bao yi fei liao	1
包衣种	bao yi zhong	1
保优	bao you	1
保幼炔	bao you que	1
报纸代售处	bao zhi dai shou chu	1
胞质杂种	bao zhi za zhong	1
包装胶带	bao zhuang jiao dai	1
抱子甘蓝	bao zi gan lan	1
孢子体	bao zi ti	1
孢子体自交不亲和系统	bao zi ti zi jiao bu qin he xi tong	1
北叉	bei cha	1
北方炭疽病	bei fang tan ju bing	1
被害率	bei hai lv	1
倍加净	bei jia jing	1
倍腈松	bei jing song	1
北京油葫芦	bei jing you hu lu	1
倍乐霸	bei le ba	1
倍硫磷	bei liu lin	1
贝螺杀	bei luo sha	1
倍液	bei ye	1
北玉	bei yu	1
背子谷	bei zi gu	1
背子谷型	bei zi gu xing	1
苯胺灵	ben an ling	1
苯并咪唑号	ben bing mi zuo hao	1
苯草醚	ben cao mi	1
苯草灭	ben cao mie	1
苯达松	ben da song	1
本底计数	ben di ji shu	1
苯丁锡	ben ding xi	1
苯丁烯	ben ding xi	1
本国货币	ben guo huo bi	1
苯黄隆	ben huang long	1
苯磺隆	ben huang long	1
苯甲酰脲	ben jia xian niao	1
苯菌灵	ben jun ling	1
苯硫灵	ben liu ling	1
苯硫威	ben liu wei	1
苯螨醚	ben man mi	1
苯螨特	ben man te	1
苯醚甲环唑	ben mi jia huan zuo	1
苯醚菊酯	ben mi ju zhi	1
苯醚菌酯	ben mi jun zhi	1
苯噻草胺	ben sai cao an	1
苯噻菌清	ben sai jun qing	1
苯噻隆	ben sai long	1
苯噻氰	ben sai qing	1
苯噻清	ben sai qing	1
本生灯	ben sheng deng	1
苯霜灵	ben shuang ling	1
苯酰菌胺	ben xian jun an	1
苯线磷	ben xian lin	1
苯锈啶	ben xiu ding	1
苯氧菌酯	ben yang jun zhi	1
苯氧威	ben yang wei	1
苯扎溴胺	ben zha xiu an	1
甭锄	beng chu	1
避病性	bi bing xing	1
吡草胺	bi cao an	1
吡草酮	bi cao tong	1
吡虫啉	bi chong lin	1
吡弗咯菌素	bi fu ge jun su	1
吡氟禾草灵	bi fu he cao ling	1
吡氟乙草灵	bi fu yi cao ling	1
壁脚板	bi jiao ban	1
比久	bi jiu	1
秕粒	bi li	1
蓖麻	bi ma	1
吡螨胺	bi man an	1
吡满胺	bi man an	1
吡螨利克	bi man li ke	1
吡螨脲	bi man niao	1
吡嘧磺隆	bi mi huang long	1
吡嘧磷	bi mi lin	1
毕摩	bi mo	1
必扑尔	bi pu er	1
必速灭	bi su mie	1
碧桃	bi tao	1
避蚊酮	bi wen tong	1
必需元素	bi xu yuan su	1
吡蚜酮	bi ya tong	1
吡呀酮	bi ya tong	1
避蚜雾	bi ya wu	1
比艳	bi yan	1
彼氧磷	bi yang lin	1
避役	bi yi	1
比重分选	bi zhong fen xuan	1
吡唑醚菊酯	bi zuo mi ju zhi	1
吡唑特	bi zuo te	1
苄草胺	bian cao an	1
苄草丹	bian cao dan	1
苄草唑	bian cao zuo	1
扁刺蛾	bian ci e	1
苄呋菊酯	bian fu ju zhi	1
扁秆草	bian gan cao	1
边沟	bian gou	1
边际效应	bian ji xiao ying	1
扁角飞虱	bian jiao fei shi	1
变绿	bian lv	1
编码员	bian ma yuan	1
苄螨醚	bian man mi	1
苄嘧磺隆	bian mi huang long	1
苄酞醚	bian tai mi	1
扁桃	bian tao	1
变性	bian xing	1
变叶病	bian ye bing	1
扁叶葱	bian ye cong	1
变异穗	bian yi sui	1
变异系数	bian yi xi shu	1
变异性	bian yi xing	1
变异中心	bian yi zhong xin	1
扁枝槲寄生	bian zhi hu ji sheng	1
标记化合物	biao ji hua he wu	1
标记技术	biao ji ji shu	1
标记昆虫	biao ji kun chong	1
骠马	biao ma	1
表明动机	biao ming dong ji	1
骠农	biao nong	1
表土	biao tu	1
骠星	biao xing	1
标识率	biao zhi lv	1
标准差	biao zhun cha	1
标准化生产	biao zhun hua sheng chan	1
标准水	biao zhun shui	1
标准误差	biao zhun wu cha	1
丙胺磷	bing an lin	1
冰雹灾	bing bao zai	1
病残株	bing can zhu	1
丙草胺	bing cao an	1
丙抄胺	bing chao an	1
病程	bing cheng	1
病虫	bing chong	1
病虫草	bing chong cao	1
病虫草害	bing chong cao hai	1
病虫草鼠	bing chong cao shu	1
病虫草鼠害	bing chong cao shu hai	1
病虫害	bing chong hai	1
病虫害防治	bing chong hai fang zhi	1
病虫害监测	bing chong hai jian ce	1
病虫净	bing chong jing	1
病虫卵	bing chong luan	1
病虫源	bing chong yuan	1
病虫株	bing chong zhu	1
兵豆	bing dou	1
病毒病	bing du bing	1
病毒粒体	bing du li ti	1
病毒星	bing du xing	1
饼肥	bing fei	1
病害	bing hai	1
病害监测	bing hai jian ce	1
病害循环	bing hai xun huan	1
病花灵	bing hua ling	1
丙环唑	bing huan zuo	1
丙净	bing jing	1
丙硫多菌灵	bing liu duo jun ling	1
丙硫克百威	bing liu ke bai wei	1
丙硫磷	bing liu lin	1
丙氯	bing lv	1
丙螨氰	bing man qing	1
病氰硝	bing qing xiao	1
并炔螨特	bing que man te	1
丙森锌	bing sen xin	1
丙烷脒	bing wan mi	1
丙线磷	bing xian lin	1
丙溴磷	bing xiu lin	1
病原学	bing yuan xue	1
病征	bing zheng	1
病株	bing zhu	1
菠菜	bo cai	1
薄翅野螟	bo chi ye ming	1
波段	bo duan	1
波尔多液	bo er duo ye	1
播幅	bo fu	1
薄荷	bo he	1
播后	bo hou	1
玻璃翠	bo li cui	1
玻璃工匠	bo li gong jiang	1
播量	bo liang	1
菠萝	bo luo	1
菠萝蜜	bo luo mi	1
波美	bo mei	1
播娘篙	bo niang gao	1
播期	bo qi	1
播前处理	bo qian chu li	1
薄壳	bo qiao	1
薄壳山核桃	bo qiao shan he tao	1
薄水	bo shui	1
薄水分蘖	bo shui fen nie	1
波丝菊	bo si ju	1
波斯菊	bo si ju	1
钵体	bo ti	1
剥叶	bo ye	1
播栽	bo zai	1
播种沟	bo zhong gou	1
播种机	bo zhong ji	1
播种量	bo zhong liang	1
播种期	bo zhong qi	1
波状钢	bo zhuang gang	1
波状热	bo zhuang re	1
补播	bu bo	1
捕草净	bu cao jing	1
捕虫	bu chong	1
捕虫网	bu chong wang	1
布尔阿斯	bu er a si	1
部分不育性	bu fen bu yu xing	1
布告牌	bu gao pai	1
不合理竞争	bu he li jing zheng	1
簿记师	bu ji shi	1
步甲	bu jia	1
不讲价钱	bu jiang jia qian	1
不敬神	bu jing shen	1
布景师	bu jing shi	1
捕阔	bu kuo	1
捕捞强度	bu lao qiang du	1
部门帮扶	bu men bang fu	1
补苗	bu miao	1
捕灭鼠	bu mie shu	1
不耐贮藏	bu nai zhu cang	1
不亲和	bu qin he	1
不亲和性	bu qin he xing	1
补施	bu shi	1
捕食螨	bu shi man	1
捕食性	bu shi xing	1
捕食性螨	bu shi xing man	1
捕食性天敌	bu shi xing tian di	1
补贴品目	bu tie pin mu	1
补贴资金	bu tie zi jin	1
不图虚名	bu tu xu ming	1
不稳定结构	bu wen ding jie gou	1
不选择性	bu xuan ze xing	1
不育特	bu yu te	1
不育系	bu yu xi	1
不育性	bu yu xing	1
补植补造	bu zhi bu zao	1
补助金	bu zhu jin	1
擦米	ca mi	1
擦鞋童	ca xie tong	1
擦鞋棕垫	ca xie zong dian	1
菜斑潜蝇	cai ban qian ying	1
菜草通	cai cao tong	1
菜蝽	cai chun	1
菜豆	cai dou	1
菜娥	cai e	1
采访记者	cai fang ji zhe	1
菜粉蝶	cai fen die	1
菜丰宁	cai feng ning	1
菜瓜	cai gua	1
彩红外负片	cai hong wai fu pian	1
菜磺隆	cai huang long	1
采集经济	cai ji jing ji	1
菜辣	cai la	1
菜苗	cai miao	1
菜螟	cai ming	1
采葡萄	cai pu tao	1
彩潜蝇	cai qian ying	1
菜青虫	cai qing chong	1
彩色合成仪	cai se he cheng yi	1
菜薹	cai tai	1
菜喜	cai xi	1
菜心	cai xin	1
菜叶蜂	cai ye feng	1
菜瘿蚊	cai ying wen	1
菜用甜菜	cai yong tian cai	1
菜园	cai yuan	1
采摘期	cai zhai qi	1
财政增长	cai zheng zeng zhang	1
菜籽油	cai zi you	1
蚕豆米	can dou mi	1
蚕豆象	can dou xiang	1
残毒	can du	1
蚕蛾	can e	1
残留	can liu	1
残留量	can liu liang	1
残留物	can liu wu	1
残杀威	can sha wei	1
参数	can shu	1
蚕台	can tai	1
蚕台育	can tai yu	1
残效	can xiao	1
残枝	can zhi	1
残株	can zhu	1
苍耳	cang er	1
苍头燕雀	cang tou yan que	1
草案初稿	cao an chu gao	1
草胺膦	cao an lin	1
草崩	cao beng	1
草必斯	cao bi si	1
草不闹	cao bu nao	1
草愁	cao chou	1
草除灵	cao chu ling	1
草地螟	cao di ming	1
草地农业	cao di nong ye	1
草甸	cao dian	1
草甸土	cao dian tu	1
草尔	cao er	1
草伐	cao fa	1
草服它	cao fu ta	1
草甘膦	cao gan lin	1
草甘磷	cao gan lin	1
草害	cao hai	1
草忌	cao ji	1
曹建方	cao jian fang	1
草惧	cao ju	1
草克死	cao ke si	1
草克星	cao ke xing	1
草枯特	cao ku te	1
草立净	cao li jing	1
草蛉	cao ling	1
草灵	cao ling	1
草硫磷	cao liu lin	1
草莓	cao mei	1
糙米	cao mi	1
糙米率	cao mi lv	1
草棉	cao mian	1
草灭平	cao mie ping	1
草灭星	cao mie xing	1
草茉莉	cao mo li	1
草木灰	cao mu hui	1
草木樨	cao mu xi	1
草萘胺	cao nai an	1
草坪栽植	cao ping zai zhi	1
草全净	cao quan jing	1
草杀安	cao sha an	1
草山饲料处	cao shan si liao chu	1
草蛇	cao she	1
草斯净	cao si jing	1
草酸青霉病	cao suan qing mei bing	1
草塘泥	cao tang ni	1
草田轮作	cao tian lun zuo	1
草通灵	cao tong ling	1
草威甲胺磷	cao wei jia an lin	1
草畏斯	cao wei si	1
草威特	cao wei te	1
草乌	cao wu	1
草悠	cao you	1
草原建设	cao yuan jian she	1
草原气候	cao yuan qi hou	1
草原生产能力	cao yuan sheng chan neng li	1
草葬	cao zang	1
操纵子	cao zong zi	1
侧柏	ce bai	1
侧多食跗线螨	ce duo shi fu xian man	1
测交	ce jiao	1
测距器	ce ju qi	1
测土	ce tu	1
测土配方	ce tu pei fang	1
测土配方施肥	ce tu pei fang shi fei	1
测验	ce yan	1
层积处理	ceng ji chu li	1
茶白星病	cha bai xing bing	1
茶斑蛾	cha ban e	1
茶饼病	cha bing bing	1
茶材小囊	cha cai xiao nang	1
茶蚕	cha can	1
杈杈房	cha cha fang	1
茶长卷叶蛾	cha chang juan ye e	1
茶橙瘿螨	cha cheng ying man	1
茶尺蠖	cha chi huo	1
茶赤叶斑病	cha chi ye ban bing	1
茶胴枯病	cha dong ku bing	1
茶毒蛾	cha du e	1
茶短须螨	cha duan xu man	1
茶蛾蜡蝉	cha e la chan	1
茶二叉蚜	cha er cha ya	1
茶棍蓟马	cha gun ji ma	1
茶褐色叶斑病	cha he se ye ban bing	1
茶褐蓑蛾	cha he suo e	1
茶黑毒蛾	cha hei du e	1
茶红根腐病	cha hong gen fu bing	1
茶红螨	cha hong man	1
茶红锈藻病	cha hong xiu zao bing	1
茶黄硬蓟马	cha huang ying ji ma	1
茶角蜡蚧	cha jiao la jie	1
茶角胸叶甲	cha jiao xiong ye jia	1
插接	cha jie	1
茶卷叶蛾	cha juan ye e	1
茬口	cha kou	1
茬口紧	cha kou jin	1
茶丽绞象甲	cha li jiao xiang jia	1
茶梨蚧	cha li jie	1
茶轮斑病	cha lun ban bing	1
茶毛虫	cha mao chong	1
茶煤病	cha mei bing	1
插苗	cha miao	1
查苗	cha miao	1
茶木蛾	cha mu e	1
茶牡蛎蚧	cha mu li jie	1
查票员	cha piao yuan	1
茶桑果站	cha sang guo zhan	1
茶桑站	cha sang zhan	1
茶梢蛀蛾	cha shao zhu e	1
茶树冻害	cha shu dong hai	1
茶蓑蛾	cha suo e	1
茶天牛	cha tian niu	1
茶网饼病	cha wang bing bing	1
茶网蝽	cha wang chun	1
茶细蛾	cha xi e	1
茶小卷叶蛾	cha xiao juan ye e	1
茶小绿叶蝉	cha xiao lv ye chan	1
茶薪菇	cha xin gu	1
插芽	cha ya	1
茶芽瘿蚊	cha ya ying wen	1
插秧机	cha yang ji	1
茶叶白毒娥	cha ye bai du e	1
茶叶瘿螨	cha ye ying man	1
茶奕刺蛾	cha yi ci e	1
差异显著平准	cha yi xian zhu ping zhun	1
茶园	cha yuan	1
茶云纹叶枯病	cha yun wen ye ku bing	1
茶藻斑病	cha zao ban bing	1
茶皂素	cha zao su	1
茶枝黑痣病	cha zhi hei zhi bing	1
茶枝镰蛾	cha zhi lian e	1
茶籽饼	cha zi bing	1
茶籽油	cha zi you	1
柴藤	chai teng	1
铲除剂	chan chu ji	1
产蛋室	chan dan shi	1
产量低	chan liang di	1
产量高	chan liang gao	1
产量模式	chan liang mo shi	1
产量收益	chan liang shou yi	1
蝉虾	chan xia	1
产业办	chan ye ban	1
长白盾蚧	chang bai dun jie	1
长柄锤	chang bing chui	1
长川霉素	chang chuan mei su	1
长蝽	chang chun	1
长春花	chang chun hua	1
常春藤	chang chun teng	1
长蝽象	chang chun xiang	1
长杆话筒	chang gan hua tong	1
常规稻	chang gui dao	1
偿还日	chang huan ri	1
长肩棘缘蝽	chang jian ji yuan chun	1
长豇豆	chang jiang dou	1
长江中上游	chang jiang zhong shang you	1
长江中下游	chang jiang zhong xia you	1
长粒黑稿病	chang li hei gao bing	1
长绿飞虱	chang lv fei shi	1
常绿果树	chang lv guo shu	1
长命菊	chang ming ju	1
常年包工	chang nian bao gong	1
菖蒲莲	chang pu lian	1
长青号	chang qing hao	1
长日照	chang ri zhao	1
长日照型	chang ri zhao xing	1
长日照作物	chang ri zhao zuo wu	1
长山核桃	chang shan he tao	1
长腿水叶甲	chang tui shui ye jia	1
长椭圆形	chang tuo yuan xing	1
长尾鹦鹉	chang wei ying wu	1
长效	chang xiao	1
长须卷蛾	chang xu juan e	1
长圆形	chang yuan xing	1
偿债基金	chang zhai ji jin	1
耖地	chao di	1
超低量喷雾机	chao di liang pen wu ji	1
超低容量	chao di rong liang	1
超低容量喷雾	chao di rong liang pen wu	1
超低温	chao di wen	1
超低温保存	chao di wen bao cun	1
超高温加工	chao gao wen jia gong	1
超级稻	chao ji dao	1
超滤	chao lv	1
超亲遗传	chao qin yi chuan	1
超亲优势	chao qin you shi	1
炒青	chao qing	1
潮湿气候	chao shi qi hou	1
潮土	chao tu	1
超畏	chao wei	1
朝鲜蓟	chao xian ji	1
车号牌	che hao pai	1
车辆失控	che liang shi kong	1
车掌	che zhang	1
晨版	chen ban	1
沉积物	chen ji wu	1
臣苦参素	chen ku shen su	1
成对床	cheng dui chuang	1
成对杂交	cheng dui za jiao	1
成果率	cheng guo lv	1
柽麻	cheng ma	1
成苗	cheng miao	1
成批处理	cheng pi chu li	1
城市警察	cheng shi jing cha	1
城市设计师	cheng shi she ji shi	1
成熟期	cheng shu qi	1
成霜洼地	cheng shuang wa di	1
成穗	cheng sui	1
成穗率	cheng sui lv	1
成穗数	cheng sui shu	1
城乡劳动力	cheng xiang lao dong li	1
程序编制	cheng xu bian zhi	1
程序设计员	cheng xu she ji yuan	1
成盐元素	cheng yan yuan su	1
承玉	cheng yu	1
成株期	cheng zhu qi	1
齿矮病	chi ai bing	1
赤斑病	chi ban bing	1
迟茬	chi cha	1
赤道气候	chi dao qi hou	1
吃得过多	chi de guo duo	1
赤腐病	chi fu bing	1
尺蠖	chi huo	1
池窖	chi jiao	1
持久性病毒	chi jiu xing bing du	1
赤枯病	chi ku bing	1
赤霉病	chi mei bing	1
赤霉清	chi mei qing	1
赤霉素	chi mei su	1
赤拟谷盗	chi ni gu dao	1
齿耙	chi pa	1
池杉	chi shan	1
迟施	chi shi	1
迟熟	chi shu	1
持水量	chi shui liang	1
赤星病	chi xing bing	1
赤须盲蝽	chi xu mang chun	1
持续农业	chi xu nong ye	1
赤眼蜂	chi yan feng	1
迟眼蕈蚊	chi yan xun wen	1
迟栽	chi zai	1
重茬	chong cha	1
重叠	chong die	1
舂碓	chong dui	1
重发生	chong fa sheng	1
重复	chong fu	1
冲积扇	chong ji shan	1
重寄生	chong ji sheng	1
冲积土	chong ji tu	1
虫口	chong kou	1
虫口夺粮	chong kou duo liang	1
虫螨腈	chong man jing	1
虫螨克	chong man ke	1
虫螨磷	chong man lin	1
虫螨灵	chong man ling	1
虫螨畏	chong man wei	1
虫情	chong qing	1
虫情调查	chong qing diao cha	1
虫杀手	chong sha shou	1
重施	chong shi	1
虫死净	chong si jing	1
冲天辣	chong tian la	1
虫酰肼	chong xian jing	1
虫线磷	chong xian lin	1
虫瘿	chong ying	1
虫源	chong yuan	1
重组子	chong zu zi	1
抽生	chou sheng	1
抽穗期	chou sui qi	1
抽苔	chou tai	1
抽薹	chou tai	1
抽苔期	chou tai qi	1
抽薹期	chou tai qi	1
抽样	chou yang	1
畜安磷	chu an lin	1
储备粮基金	chu bei liang ji jin	1
樗蚕蛾	chu can e	1
除草耙	chu cao ba	1
除草叉	chu cao cha	1
除草锄	chu cao chu	1
除草丹	chu cao dan	1
除草剂	chu cao ji	1
除草醚	chu cao mi	1
除草通	chu cao tong	1
除虫菊素	chu chong ju su	1
除虫脲	chu chong niao	1
除虫威	chu chong wei	1
畜虫威	chu chong wei	1
锄地	chu di	1
除豆莠	chu dou you	1
初耕	chu geng	1
出菇	chu gu	1
除害磷	chu hai lin	1
除禾能	chu he neng	1
出和收入	chu he shou ru	1
初花	chu hua	1
初花期	chu hua qi	1
雏鸡	chu ji	1
初级产品	chu ji chan pin	1
初级成分	chu ji cheng fen	1
楚粳	chu jing	1
楚粳香	chu jing xiang	1
楚粳优	chu jing you	1
雏菊	chu ju	1
畜栏	chu lan	1
处理	chu li	1
处理部件	chu li bu jian	1
楚麦	chu mai	1
出苗	chu miao	1
出苗率	chu miao lv	1
畜蜱磷	chu pi lin	1
初侵染	chu qin ran	1
初侵染源	chu qin ran yuan	1
初清	chu qing	1
畜群结构	chu qun jie gou	1
畜群周转计划	chu qun zhou zhuan ji hua	1
初任记者	chu ren ji zhe	1
除三菜	chu san cai	1
除三棱	chu san leng	1
触杀剂	chu sha ji	1
处暑	chu shu	1
初霜	chu shuang	1
除田莠	chu tian you	1
除线威	chu xian wei	1
楚雄报	chu xiong bao	1
楚雄电视台	chu xiong dian shi tai	1
楚雄分会场	chu xiong fen hui chang	1
出芽	chu ya	1
除芽通	chu ya tong	1
除蝇威	chu ying wei	1
储运	chu yun	1
储装	chu zhuang	1
传播	chuan bo	1
传播介体	chuan bo jie ti	1
传达文件精神	chuan da wen jian jing shen	1
穿孔	chuan kong	1
穿孔纸带	chuan kong zhi dai	1
川楝素	chuan lian su	1
传能线密度	chuan neng xian mi du	1
船上交货价	chuan shang jiao huo jia	1
穿梭育种	chuan suo yu zhong	1
传统农业	chuan tong nong ye	1
穿透深度	chuan tou shen du	1
穿心莲	chuan xin lian	1
川油	chuan you	1
创办资本	chuang ban zi ben	1
创汇农业	chuang hui nong ye	1
疮痂病	chuang jia bing	1
床土	chuang tu	1
吹绵蚧	chui mian jie	1
锤式粉碎机	chui shi fen sui ji	1
垂直抗性	chui zhi kang xing	1
春播	chun bo	1
春播作物	chun bo zuo wu	1
莼菜	chun cai	1
春尺蠖	chun chi huo	1
春大豆	chun da dou	1
纯氮	chun dan	1
纯度测定	chun du ce ding	1
春多多	chun duo duo	1
春化	chun hua	1
纯钾	chun jia	1
春兰	chun lan	1
春雷霉素	chun lei mei su	1
春雷氧氯铜	chun lei yang lv tong	1
纯磷	chun lin	1
纯氯	chun lv	1
春日霉素	chun ri mei su	1
纯收益	chun shou yi	1
纯系育种	chun xi yu zhong	1
椿象	chun xiang	1
春小麦	chun xiao mai	1
春性	chun xing	1
春油菜	chun you cai	1
纯育	chun yu	1
春玉米	chun yu mi	1
春种	chun zhong	1
纯种马	chun zhong ma	1
纯作	chun zuo	1
刺菜蓟	ci cai ji	1
磁存储器	ci cun chu qi	1
雌鹅	ci e	1
刺儿菜	ci er cai	1
慈菇	ci gu	1
慈姑	ci gu	1
茨菰灵	ci gu ling	1
刺果番荔枝	ci guo fan li zhi	1
刺花莲子草	ci hua lian zi cao	1
次级起源中心	ci ji qi yuan zhong xin	1
刺梨	ci li	1
雌驴	ci lv	1
雌马	ci ma	1
雌马驹	ci ma ju	1
雌绵羊	ci mian yang	1
雌牛	ci niu	1
雌蕊	ci rui	1
慈善餐会	ci shan can hui	1
刺山柑	ci shan gan	1
雌山羊	ci shan yang	1
次生污染物	ci sheng wu ran wu	1
雌穗	ci sui	1
磁头臂	ci tou bi	1
刺吸	ci xi	1
刺吸式	ci xi shi	1
刺吸式口器	ci xi shi kou qi	1
磁心存储器	ci xin cun chu qi	1
雌性不育	ci xing bu yu	1
雌雄花期	ci xiong hua qi	1
磁选	ci xuan	1
雌猪	ci zhu	1
丛矮病	cong ai bing	1
葱蓟马	cong ji ma	1
葱莲	cong lian	1
丛生型花生	cong sheng xing hua sheng	1
丛数	cong shu	1
葱蒜类蔬菜	cong suan lei shu cai	1
葱头	cong tou	1
丛枝病	cong zhi bing	1
凑响	cou xiang	1
猝倒病	cu dao bing	1
促丁威	cu ding wei	1
粗放耕作	cu fang geng zuo	1
粗放农业	cu fang nong ye	1
醋栗	cu li	1
促苗	cu miao	1
粗磨谷粉	cu mo gu fen	1
簇生	cu sheng	1
促生酯	cu sheng zhi	1
醋粟	cu su	1
醋酸盐	cu suan yan	1
粗缩病	cu suo bing	1
粗纤维	cu xian wei	1
催花	cui hua	1
催化剂	cui hua ji	1
催缴资本	cui jiao zi ben	1
翠菊	cui ju	1
催芽	cui ya	1
存活率	cun huo lv	1
存活曲线	cun huo qu xian	1
村貌	cun mao	1
村民委员会	cun min wei yuan hui	1
村民小组	cun min xiao zu	1
存熔	cun rong	1
村容	cun rong	1
村容村貌	cun rong cun mao	1
村容整洁	cun rong zheng jie	1
村社	cun she	1
寸水	cun shui	1
寸水活棵	cun shui huo ke	1
存衣处	cun yi chu	1
措施不得力	cuo shi bu de li	1
大螯虾	da ao xia	1
大白菜	da bai cai	1
大白豆	da bai dou	1
大白谷	da bai gu	1
大白谷型	da bai gu xing	1
大白花洋芋	da bai hua yang yu	1
大斑病	da ban bing	1
答辩考试	da bian kao shi	1
大波斯菊	da bo si ju	1
大菜粉蝶	da cai fen die	1
大菜螟	da cai ming	1
大蚕	da can	1
哒草特	da cao te	1
大春作物	da chun zuo wu	1
大刺儿菜	da ci er cai	1
大葱	da cong	1
大村	da cun	1
大稻缘蝽	da dao yuan chun	1
大地老虎	da di lao hu	1
大地毯	da di tan	1
打顶	da ding	1
大豆粉	da dou fen	1
大豆食心虫	da dou shi xin chong	1
大豆蚜	da dou ya	1
大豆疫病	da dou yi bing	1
大豆油	da dou you	1
大对虾	da dui xia	1
大分蘖	da fen nie	1
大风雷	da feng lei	1
大风雪	da feng xue	1
打麸	da fu	1
大干草垛	da gan cao duo	1
大沟	da gou	1
打谷场	da gu chang	1
大谷盗	da gu dao	1
大海鲢	da hai lian	1
大寒	da han	1
大花美人蕉	da hua mei ren jiao	1
大花牵牛	da hua qian niu	1
大惠利	da hui li	1
大灰象甲	da hui xiang jia	1
大蕉	da jiao	1
大脚盖菇	da jiao gai gu	1
哒净硫磷	da jing liu lin	1
哒净松	da jing song	1
哒菌清	da jun qing	1
大克灵	da ke ling	1
大葵花鹦鹉	da kui hua ying wu	1
大喇叭花	da la ba hua	1
大喇叭口期	da la ba kou qi	1
大莱豆	da lai dou	1
大丽花	da li hua	1
大丽菊	da li ju	1
大粒型	da li xing	1
大粒种	da li zhong	1
大菱鲆	da ling ping	1
大隆粉剂	da long fen ji	1
大陆性气候	da lu xing qi hou	1
大绿蝽	da lv chun	1
大马士革李	da ma shi ge li	1
大麦	da mai	1
打麦	da mai	1
达螨尽	da man jin	1
哒螨酮	da man tong	1
大米草	da mi cao	1
大灭虫	da mie chong	1
大螟	da ming	1
大农场主	da nong chang zhu	1
大气	da qi	1
大气窗	da qi chuang	1
大气候	da qi hou	1
大气监测	da qi jian ce	1
大气污染	da qi wu ran	1
大气质量	da qi zhi liang	1
哒嗪硫磷	da qin liu lin	1
大青叶蝉	da qing ye chan	1
大青枣	da qing zao	1
大青枣树	da qing zao shu	1
大钐刀	da shan dao	1
大牲畜	da sheng chu	1
大薯	da shu	1
大暑	da shu	1
大粟鳃金龟	da su sai jin gui	1
大穗	da sui	1
大穗利	da sui li	1
大穗型	da sui xing	1
大蓑蛾	da suo e	1
大蓑娥	da suo e	1
打塘	da tang	1
大田	da tian	1
大田隆	da tian long	1
大田作物	da tian zuo wu	1
大王椰子	da wang ye zi	1
大西洋鼠海豚	da xi yang shu hai tun	1
大小年	da xiao nian	1
大羞病	da xiu bing	1
打穴	da xue	1
大岩桐	da yan tong	1
大羊驼	da yang tuo	1
大叶黄杨	da ye huang yang	1
哒幼酮	da you tong	1
大雨	da yu	1
大猿叶虫	da yuan ye chong	1
大众报纸	da zhong bao zhi	1
大中小并举	da zhong xiao bing ju	1
大中型拖拉机	da zhong xing tuo la ji	1
大竺葵	da zhu kui	1
带播机	dai bo ji	1
代代花	dai dai hua	1
带动能力	dai dong neng li	1
带毒者	dai du zhe	1
带化	dai hua	1
代换	dai huan	1
代换系	dai huan xi	1
袋口	dai kou	1
贷款贴息资金	dai kuan tie xi zi jin	1
代灵	dai ling	1
代垅磷	dai long lin	1
带蘖	dai nie	1
带蘖数	dai nie shu	1
带蘖壮秧	dai nie zhuang yang	1
代森铵	dai sen an	1
代森联	dai sen lian	1
代森锰	dai sen meng	1
代森锰锌	dai sen meng xin	1
代森锌	dai sen xin	1
带条田	dai tiao tian	1
带土	dai tu	1
待业人口	dai ye ren kou	1
袋栽	dai zai	1
带职	dai zhi	1
带状疮疹	dai zhuang chuang zhen	1
单倍体育种	dan bei ti yu zhong	1
丹毒	dan du	1
氮肥	dan fei	1
单峰驼	dan feng tuo	1
氮固持	dan gu chi	1
淡褐色眼睛	dan he se yan jing	1
氮回收	dan hui shou	1
单季	dan ji	1
单季稻	dan ji dao	1
蛋鸡舍	dan ji she	1
单甲脒	dan jia mi	1
单交	dan jiao	1
单交种	dan jiao zhong	1
单克隆抗体	dan ke long kang ti	1
氮矿化	dan kuang hua	1
单粒传法	dan li chuan fa	1
氮磷钾	dan lin jia	1
单人房间	dan ren fang jian	1
单身户	dan shen hu	1
单式簿记	dan shi bu ji	1
氮释放	dan shi fang	1
单食性	dan shi xing	1
淡水养殖	dan shui yang zhi	1
单穗	dan sui	1
单穗粒重	dan sui li zhong	1
氮损失	dan sun shi	1
氮同化	dan tong hua	1
氮循环	dan xun huan	1
单一经营	dan yi jing ying	1
丹玉	dan yu	1
氮源	dan yuan	1
氮周转	dan zhou zhuan	1
单株	dan zhu	1
单株选择	dan zhu xuan ze	1
氮状况	dan zhuang kuang	1
担子菌	dan zi jun	1
淡紫拟青霉	dan zi ni qing mei	1
单子叶	dan zi ye	1
单子叶植物	dan zi ye zhi wu	1
单作	dan zuo	1
当季	dang ji	1
稻白粉虱	dao bai fen shi	1
稻稗清	dao bai qing	1
稻白叶枯病	dao bai ye ku bing	1
稻草龙	dao cao long	1
稻草灭	dao cao mie	1
稻草完	dao cao wan	1
稻巢螟	dao chao ming	1
倒车档	dao che dang	1
稻赤斑沫蝉	dao chi ban mo chan	1
稻虫菊酯	dao chong ju zhi	1
刀锄	dao chu	1
倒春寒	dao chun han	1
稻丛	dao cong	1
到村	dao cun	1
刀豆	dao dou	1
稻恶苗病	dao e miao bing	1
倒二叶	dao er ye	1
稻飞虱	dao fei shi	1
稻丰灵	dao feng ling	1
稻丰散	dao feng san	1
稻丰收	dao feng shou	1
倒伏	dao fu	1
稻负泥甲	dao fu ni jia	1
稻干尖线虫病	dao gan jian xian chong bing	1
稻秆潜蝇	dao gan qian ying	1
稻谷青	dao gu qing	1
稻谷三等品	dao gu san deng pin	1
稻谷收购点	dao gu shou gou dian	1
倒挂金钟	dao gua jin zhong	1
稻褐飞虱	dao he fei shi	1
稻禾净	dao he jing	1
稻黑蝽	dao hei chun	1
稻蝗	dao huang	1
稻棘缘蝽	dao ji yuan chun	1
稻简管蓟马	dao jian guan ji ma	1
稻脚青	dao jiao qing	1
稻金翅夜蛾	dao jin chi ye e	1
稻金丹	dao jin dan	1
稻壳	dao ke	1
稻乐思	dao le si	1
稻粒黑粉病	dao li hei fen bing	1
道路标志信号	dao lu biao zhi xin hao	1
道路工程师	dao lu gong cheng shi	1
道路使用者	dao lu shi yong zhe	1
稻绿蝽	dao lv chun	1
稻苗疫病	dao miao yi bing	1
倒捻子	dao nian zi	1
稻蘖欢	dao nie huan	1
稻潜叶蝇	dao qian ye ying	1
稻区	dao qu	1
稻曲病	dao qu bing	1
导热率	dao re lv	1
稻食根叶甲	dao shi gen ye jia	1
稻虱净	dao shi jing	1
稻水螟	dao shui ming	1
稻水象甲	dao shui xiang jia	1
稻思它	dao si ta	1
到田	dao tian	1
稻田棉铃虫	dao tian mian ling chong	1
稻田粘虫	dao tian nian chong	1
稻田养鱼	dao tian yang yu	1
稻铁甲虫	dao tie jia chong	1
稻筒水螟	dao tong shui ming	1
倒位	dao wei	1
稻瘟病	dao wen bing	1
稻瘟醇	dao wen chun	1
稻瘟光	dao wen guang	1
稻瘟净	dao wen jing	1
稻瘟灵	dao wen ling	1
稻瘟清	dao wen qing	1
稻瘟素	dao wen su	1
稻瘟酰胺	dao wen xian an	1
稻瘟酯	dao wen zhi	1
稻无草	dao wu cao	1
稻象甲	dao xiang jia	1
盗眼蝶	dao yan die	1
稻眼蝶	dao yan die	1
稻瘿蚊	dao ying wen	1
稻直鬃蓟马	dao zhi zong ji ma	1
稻纵卷叶螟	dao zong juan ye ming	1
稻作	dao zuo	1
稻作区	dao zuo qu	1
等地温线	deng di wen xian	1
登海	deng hai	1
等剂量曲线	deng ji liang qu xian	1
登记器	deng ji qi	1
等解冻线	deng jie dong xian	1
灯笼花	deng long hua	1
等温线	deng wen xian	1
等物候线	deng wu hou xian	1
邓先培	deng xian pei	1
灯芯草	deng xin cao	1
灯心草	deng xin cao	1
等雨量线	deng yu liang xian	1
等蒸发量线	deng zheng fa liang xian	1
敌胺灵	di an ling	1
敌稗	di bai	1
敌百虫	di bai chong	1
敌宝	di bao	1
低残留	di can liu	1
敌草胺	di cao an	1
敌草隆	di cao long	1
敌草死	di cao si	1
敌虫菊酯	di chong ju zhi	1
地虫磷	di chong lin	1
地虫硫磷	di chong liu lin	1
敌敌钙	di di gai	1
敌敌磷	di di lin	1
敌敌畏	di di wei	1
地丁	di ding	1
滴定管	di ding guan	1
滴丁酯	di ding zhi	1
低毒	di du	1
低毒高效	di du gao xiao	1
低毒硫磷	di du liu lin	1
敌恶磷	di e lin	1
地方财政扶持	di fang cai zheng fu chi	1
地方品种	di fang pin zhong	1
地方气候	di fang qi hou	1
低肥	di fei	1
低肥力	di fei li	1
低酚棉	di fen mian	1
滴灌	di guan	1
低海拔	di hai ba	1
敌害鼠	di hai shu	1
敌磺钠	di huang na	1
地籍簿	di ji bu	1
敌甲	di jia	1
地价税	di jia shui	1
低芥酸	di jie suan	1
低聚糖素	di ju tang su	1
敌菌丹	di jun dan	1
敌菌灵	di jun ling	1
敌菌威	di jun wei	1
敌抗磷	di kang lin	1
敌抗一号	di kang yi hao	1
敌克草	di ke cao	1
地克松	di ke song	1
敌克松	di ke song	1
敌枯双	di ku shuang	1
地老虎	di lao hu	1
地老虎类	di lao hu lei	1
地乐胺	di le an	1
敌力脱	di li tuo	1
地理信息系统	di li xin xi xi tong	1
地理政治论	di li zheng zhi lun	1
低量喷雾机	di liang pen wu ji	1
低硫甙	di liu dai	1
敌马	di ma	1
敌马合剂	di ma he ji	1
敌螨丹	di man dan	1
敌螨死	di man si	1
地面灌溉	di mian guan gai	1
地面逆温	di mian ni wen	1
地面气温	di mian qi wen	1
地面蒸发	di mian zheng fa	1
敌灭灵	di mie ling	1
敌灭生	di mie sheng	1
敌螟强	di ming qiang	1
地名学	di ming xue	1
地膜覆盖	di mo fu gai	1
迪庆	di qing	1
敌氰	di qing	1
低热河谷	di re he gu	1
地热能	di re neng	1
第三方保险	di san fang bao xian	1
敌杀死	di sha si	1
敌鼠	di shu	1
敌鼠钠	di shu na	1
敌鼠钠盐	di shu na yan	1
地爽	di shuang	1
低水箱	di shui xiang	1
低俗新闻	di su xin wen	1
低头黑病	di tou hei bing	1
地图测绘	di tu ce hui	1
地温	di wen	1
低温保藏	di wen bao cang	1
低温干燥	di wen gan zao	1
低温冷害	di wen leng hai	1
敌瘟磷	di wen lin	1
地温梯度	di wen ti du	1
低温障碍	di wen zhang ai	1
地下灌溉	di xia guan gai	1
地下害虫	di xia hai chong	1
地下排水	di xia pai shui	1
敌线酯	di xian zhi	1
地形气候	di xing qi hou	1
地形图	di xing tu	1
地形小气候	di xing xiao qi hou	1
地形雨	di xing yu	1
敌锈钠	di xiu na	1
敌锈酸	di xiu suan	1
敌蚜螨	di ya man	1
地亚农	di ya nong	1
地衣	di yi	1
地域分析	di yu fen xi	1
地中热流	di zhong re liu	1
滇北	dian bei	1
电传打字机	dian chuan da zi ji	1
垫低	dian di	1
滇东南	dian dong nan	1
典范相关	dian fan xiang guan	1
淀粉	dian fen	1
滇丰	dian feng	1
点蜂缘蝽	dian feng yuan chun	1
电工胶带	dian gong jiao dai	1
电光叶蝉	dian guang ye chan	1
颠换	dian huan	1
淀积丰富	dian ji feng fu	1
滇粳	dian jing	1
电离辐射	dian li fu she	1
电离径迹	dian li jing ji	1
电离密度	dian li mi du	1
电离室	dian li shi	1
碘硫磷	dian liu lin	1
电脑操作员	dian nao cao zuo yuan	1
电脑程序员	dian nao cheng xu yuan	1
电视摄像机	dian shi she xiang ji	1
碘水剂	dian shui ji	1
电围栏	dian wei lan	1
滇西南	dian xi nan	1
电影摄影机	dian ying she ying ji	1
电影摄制	dian ying she zhi	1
电育雏伞	dian yu chu san	1
电晕种子清选机	dian yun zhong zi qing xuan ji	1
滇中北	dian zhong bei	1
点字版	dian zi ban	1
电子工程学	dian zi gong cheng xue	1
电子束辐照	dian zi shu fu zhao	1
电阻加热	dian zu jia re	1
调换证券	diao huan zheng quan	1
吊兰	diao lan	1
吊销驾驶执照	diao xiao jia shi zhi zhao	1
钓鱼会	diao yu hui	1
吊竹兰	diao zhu lan	1
吊竹梅	diao zhu mei	1
叠氮净	die dan jing	1
跌脚舞	die jiao wu	1
叠椅	die yi	1
啶斑肟	ding ban wo	1
丁苯硫磷	ding ben liu lin	1
丁吡吗啉	ding bi ma lin	1
碇泊处	ding bo chu	1
丁草胺	ding cao an	1
丁草特	ding cao te	1
定虫隆	ding chong long	1
啶虫脒	ding chong mi	1
啶虫咪	ding chong mi	1
订单农业	ding dan nong ye	1
顶腐病	ding fu bing	1
丁氟螨酯	ding fu man zhi	1
定根	ding gen	1
定根水	ding gen shui	1
顶花	ding hua	1
顶交	ding jiao	1
顶交种	ding jiao zhong	1
啶菌噁唑	ding jun e zuo	1
定菌情	ding jun qing	1
顶枯病	ding ku bing	1
丁硫克百威	ding liu ke bai wei	1
啶嘧磺隆	ding mi huang long	1
丁醚脲	ding mi niao	1
定苗	ding miao	1
丁噻隆	ding sai long	1
丁酮威	ding tong wei	1
丁烯氟虫腈	ding xi fu chong jing	1
丁香菌酯	ding xiang jun zhi	1
定向率	ding xiang lv	1
定向密植	ding xiang mi zhi	1
定向选择	ding xiang xuan ze	1
啶氧菌酯	ding yang jun zhi	1
定植	ding zhi	1
冻拔	dong ba	1
东北通	dong bei tong	1
东奔西忙	dong ben xi mang	1
冬播	dong bo	1
冬播隆	dong bo long	1
冻藏	dong cang	1
东方粉蝶	dong fang fen die	1
东方蝼蛄	dong fang lou gu	1
东方行军蚁	dong fang xing jun yi	1
东方叶甲	dong fang ye jia	1
冬干寒冷气候	dong gan han leng qi hou	1
东格鲁病毒病	dong ge lu bing du bing	1
冬瓜	dong gua	1
冻害	dong hai	1
冬寒菜	dong han cai	1
冬化	dong hua	1
冬剪	dong jian	1
冻结深度	dong jie shen du	1
冻结温度	dong jie wen du	1
冻结资产	dong jie zi chan	1
洞经音乐	dong jing yin yue	1
东莨菪	dong lang dang	1
冻涝害	dong lao hai	1
动力锄	dong li chu	1
动力割草机	dong li ge cao ji	1
冬末春初	dong mo chun chu	1
冬农开发	dong nong kai fa	1
冬前	dong qian	1
冬青	dong qing	1
冻融交替	dong rong jiao ti	1
冬湿寒冷气候	dong shi han leng qi hou	1
冻死	dong si	1
冻死率	dong si lv	1
冻土	dong tu	1
动物防疫	dong wu fang yi	1
动物检疫	dong wu jian yi	1
动物饲养业	dong wu si yang ye	1
冬小麦	dong xiao mai	1
冬性	dong xing	1
东亚飞蝗	dong ya fei huang	1
冬洋芋	dong yang yu	1
冬夜蛾	dong ye e	1
冬油菜	dong you cai	1
冻雨	dong yu	1
冬玉米	dong yu mi	1
冬至	dong zhi	1
豆瓣菜	dou ban cai	1
斗北	dou bei	1
豆草除	dou cao chu	1
豆草灵	dou cao ling	1
豆草隆	dou cao long	1
豆草特	dou cao te	1
豆草特号	dou cao te hao	1
豆锄	dou chu	1
豆大卫	dou da wei	1
豆盗毒蛾	dou dao du e	1
豆多	dou duo	1
都尔速收	dou er su shou	1
豆二条萤叶甲	dou er tiao ying ye jia	1
豆杆	dou gan	1
豆秆	dou gan	1
豆秆黑潜蝇	dou gan hei qian ying	1
豆秆野螟	dou gan ye ming	1
豆根蛇潜蝇	dou gen she qian ying	1
豆功	dou gong	1
豆磺隆	dou huang long	1
豆灰蝶	dou hui die	1
豆荚斑螟	dou jia ban ming	1
豆荚螟	dou jia ming	1
豆荚野螟	dou jia ye ming	1
豆科	dou ke	1
豆科绿肥	dou ke lv fei	1
豆科作物	dou ke zuo wu	1
豆魁	dou kui	1
豆来福	dou lai fu	1
兜兰	dou lan	1
豆类蔬菜	dou lei shu cai	1
豆类植物	dou lei zhi wu	1
豆梨	dou li	1
豆粒	dou li	1
豆垅	dou long	1
豆奇	dou qi	1
豆青亮	dou qing liang	1
斗渠	dou qu	1
豆蚀叶野螟	dou shi ye ye ming	1
豆薯	dou shu	1
豆说好	dou shuo hao	1
豆斯	dou si	1
豆天蛾	dou tian e	1
豆突眼长蝽	dou tu yan chang chun	1
豆威	dou wei	1
豆维	dou wei	1
豆象	dou xiang	1
豆小卷叶蛾	dou xiao juan ye e	1
豆星	dou xing	1
豆蚜	dou ya	1
豆芽菜	dou ya cai	1
豆颜	dou yan	1
窦炎	dou yan	1
斗羊	dou yang	1
豆叶东潜蝇	dou ye dong qian ying	1
豆叶螨	dou ye man	1
豆芫菁	dou yuan jing	1
渡槽	du cao	1
蠹虫	du chong	1
毒虫威	du chong wei	1
毒词	du ci	1
毒蛾	du e	1
毒饵	du er	1
毒氟磷	du fu lin	1
毒甲辛	du jia xin	1
毒家星	du jia xing	1
杜净	du jing	1
毒菌酚	du jun fen	1
毒菌锡	du jun xi	1
杜梨	du li	1
毒力	du li	1
独立性测验	du li xing ce yan	1
毒麦	du mai	1
毒旁定	du pang ding	1
毒壤磷	du rang lin	1
毒杀芬	du sha fen	1
毒鼠硅	du shu gui	1
毒丝本	du si ben	1
毒死蜱	du si pi	1
笃斯越桔	du si yue ju	1
杜松	du song	1
毒土	du tu	1
独效磷	du xiao lin	1
毒性	du xing	1
独行菜	du xing cai	1
读者投书栏	du zhe tou shu lan	1
毒植物素	du zhi wu su	1
杜仲	du zhong	1
杜仲甙	du zhong dai	1
端大蓟马	duan da ji ma	1
短额负蝗	duan e fu huang	1
断肥	duan fei	1
短果枝	duan guo zhi	1
短肩棘缘蝽	duan jian ji yuan chun	1
椴木	duan mu	1
断奶肥	duan nai fei	1
短期信贷	duan qi xin dai	1
短日	duan ri	1
短日照	duan ri zhao	1
短日照作物	duan ri zhao zuo wu	1
煅烧	duan shao	1
短时高温加工	duan shi gao wen jia gong	1
椴树	duan shu	1
段兴祥	duan xing xiang	1
短壮芽	duan zhuang ya	1
对比法	dui bi fa	1
堆草机	dui cao ji	1
堆肥	dui fei	1
对硫磷	dui liu lin	1
对流性雨	dui liu xing yu	1
对氯二甲苯酚	dui lv er jia ben fen	1
堆沤	dui ou	1
堆砂蛀	dui sha zhu	1
兑水	dui shui	1
堆捂	dui wu	1
遁迹	dun ji	1
吨粮	dun liang	1
吨粮田	dun liang tian	1
蹲苗	dun miao	1
蹲苗期	dun miao qi	1
趸售	dun shou	1
多虫灵	duo chong ling	1
多虫清	duo chong qing	1
多虫畏	duo chong wei	1
朵大	duo da	1
多分枝	duo fen zhi	1
多丰农	duo feng nong	1
夺丰收	duo feng shou	1
多福种衣剂	duo fu zhong yi ji	1
多光谱扫描仪	duo guang pu sao miao yi	1
多花菜豆	duo hua cai dou	1
多花黑麦草	duo hua hei mai cao	1
多寄生	duo ji sheng	1
多井	duo jing	1
多菌灵	duo jun ling	1
多菌灵磺酸盐	duo jun ling huang suan yan	1
多菌灵盐酸盐	duo jun ling yan suan yan	1
多抗	duo kang	1
多抗霉素	duo kang mei su	1
多来宝	duo lai bao	1
多棱大麦	duo leng da mai	1
多粒型花生	duo li xing hua sheng	1
多硫	duo liu	1
多硫化钡	duo liu hua bei	1
多氯萘类	duo lv nai lei	1
多毛毒蜘蛛	duo mao du zhi zhu	1
多灭灵	duo mie ling	1
多螟丹	duo ming dan	1
多年生	duo nian sheng	1
多年生海岛棉	duo nian sheng hai dao mian	1
多年生蔬菜作物	duo nian sheng shu cai zuo wu	1
多年生作物	duo nian sheng zuo wu	1
多蘖	duo nie	1
多蘖壮秧	duo nie zhuang yang	1
多噻烷	duo sai wan	1
多杀霉素	duo sha mei su	1
多施	duo shi	1
多时相	duo shi xiang	1
多食性	duo shi xing	1
多熟	duo shu	1
多熟制	duo shu zhi	1
多穗	duo sui	1
多系品种	duo xi pin zhong	1
多系杂交	duo xi za jiao	1
多项式回归	duo xiang shi hui gui	1
多效霉素	duo xiao mei su	1
多效唑	duo xiao zuo	1
多溴福	duo xiu fu	1
多芽	duo ya	1
多芽期	duo ya qi	1
多元回归	duo yuan hui gui	1
多元抗性	duo yuan kang xing	1
噁草灵	e cao ling	1
恶草醚	e cao mi	1
噁草酮	e cao tong	1
恶虫酮	e chong tong	1
噁虫威	e chong wei	1
恶虫威	e chong wei	1
噁庚草烷	e geng cao wan	1
蛾类	e lei	1
鳄梨	e li	1
恶苗病	e miao bing	1
萼片	e pian	1
噁霜灵	e shuang ling	1
恶霜灵	e shuang ling	1
蛾蝇腈	e ying jing	1
鄂玉	e yu	1
鹅掌楸	e zhang qiu	1
噁唑菌酮	e zuo jun tong	1
二白谷	er bai gu	1
二白谷型	er bai gu xing	1
二斑叶螨	er ban ye man	1
二苯胺	er ben an	1
二冲程发动机	er chong cheng fa dong ji	1
二重接	er chong jie	1
二次污染物	er ci wu ran wu	1
二点红蜘蛛	er dian hong zhi zhu	1
二点螟	er dian ming	1
二分线	er fen xian	1
二化螟	er hua ming	1
二甲基二硫醚	er jia ji er liu mi	1
二甲四氯	er jia si lv	1
二甲戊乐灵	er jia wu le ling	1
二进制码	er jin zhi ma	1
二进制数字	er jin zhi shu zi	1
二进制位	er jin zhi wei	1
二棱大麦	er leng da mai	1
饵料系数	er liao xi shu	1
二硫氰基甲烷	er liu qing ji jia wan	1
二氯苯隆	er lv ben long	1
二氯苯醚菊酯	er lv ben mi ju zhi	1
二氯喹啉酸	er lv kui lin suan	1
二氯喹磷酸	er lv kui lin suan	1
二氯脲	er lv niao	1
耳霉菌	er mei jun	1
二年生	er nian sheng	1
二年生蔬菜作物	er nian sheng shu cai zuo wu	1
二年生作物	er nian sheng zuo wu	1
耳鸟	er niao	1
二七年	er qi nian	1
二嗪磷	er qin lin	1
二氰蒽醌	er qing en kun	1
二十八星瓢虫	er shi ba xing piao chong	1
二十四节气	er shi si jie qi	1
二十碳烯酮	er shi tan xi tong	1
二熟	er shu	1
二熟制	er shu zhi	1
二条叶甲	er tiao ye jia	1
二五减租	er wu jian zu	1
二硝酯	er xiao zhi	1
二星蝽	er xing chun	1
二溴磷	er xiu lin	1
二溴氯丙烷	er xiu lv bing wan	1
二元酸铜	er yuan suan tong	1
发病指数	fa bing zhi shu	1
发菜	fa cai	1
伐虫脒	fa chong mi	1
发出撞击声	fa chu zhuang ji sheng	1
发丛	fa cong	1
发动机停转	fa dong ji ting zhuan	1
发根	fa gen	1
发工资日	fa gong zi ri	1
法规股	fa gui gu	1
发果	fa guo	1
法国白兰地	fa guo bai lan di	1
法国菜豆	fa guo cai dou	1
法国冬青	fa guo dong qing	1
发挥效益	fa hui xiao yi	1
发酵工程	fa jiao gong cheng	1
发酵素菌	fa jiao su jun	1
发菌	fa jun	1
发棵	fa ke	1
发硫磷	fa liu lin	1
伐灭磷	fa mie lin	1
发情探测	fa qing tan ce	1
发生量预测	fa sheng liang yu ce	1
发生期	fa sheng qi	1
发生期预测	fa sheng qi yu ce	1
发行份数	fa xing fen shu	1
发芽率	fa ya lv	1
发芽势	fa ya shi	1
发芽试验	fa ya shi yan	1
反刍动物生产力	fan chu dong wu sheng chan li	1
饭豆	fan dou	1
翻耕	fan geng	1
番红花	fan hong hua	1
反季	fan ji	1
反季节蔬菜	fan ji jie shu cai	1
反季蔬菜	fan ji shu cai	1
番荔枝	fan li zhi	1
番硫磷	fan liu lin	1
番木瓜	fan mu gua	1
番茄	fan qie	1
返青期	fan qing qi	1
反散射	fan san she	1
反射辐射	fan she fu she	1
反射率	fan she lv	1
反渗透	fan shen tou	1
番石榴	fan shi liu	1
番杏	fan xing	1
翻压	fan ya	1
翻译程序	fan yi cheng xu	1
繁殖率	fan zhi lv	1
繁殖区	fan zhi qu	1
繁殖系数	fan zhi xi shu	1
反枝苋	fan zhi xian	1
繁种	fan zhong	1
防病虫	fang bing chong	1
方差分析	fang cha fen xi	1
方程式汽车	fang cheng shi qi che	1
防虫磷	fang chong lin	1
防虫网	fang chong wang	1
纺锤形	fang chui xing	1
防倒	fang dao	1
防盗保险	fang dao bao xian	1
防盗窃险	fang dao qie xian	1
防腐剂	fang fu ji	1
防腐剂保藏	fang fu ji bao cang	1
方格簇	fang ge cu	1
防护林	fang hu lin	1
防护林带	fang hu lin dai	1
防滑路面	fang hua lu mian	1
防滑装置	fang hua zhuang zhi	1
防火梯	fang huo ti	1
房间钥匙	fang jian yao shi	1
防涝	fang lao	1
防霉宝	fang mei bao	1
防霉灵	fang mei ling	1
放苗	fang miao	1
放射免疫分析	fang she mian yi fen xi	1
放射生态学	fang she sheng tai xue	1
放射生物学	fang she sheng wu xue	1
放射土壤杆菌	fang she tu rang gan jun	1
放射性示踪物	fang she xing shi zong wu	1
放射性污染	fang she xing wu ran	1
仿生安	fang sheng an	1
防霜	fang shuang	1
防松螺母	fang song luo mu	1
放线菌	fang xian jun	1
方向指示灯	fang xiang zhi shi deng	1
方向指示器	fang xiang zhi shi qi	1
芳香作物	fang xiang zuo wu	1
防灾抗灾能力	fang zai kang zai neng li	1
防早衰	fang zao shuai	1
防治	fang zhi	1
防治规划	fang zhi gui hua	1
防治技术	fang zhi ji shu	1
防治效果	fang zhi xiao guo	1
纺织原料生产	fang zhi yuan liao sheng chan	1
防治指标	fang zhi zhi biao	1
防渍	fang zi	1
非持久性病毒	fei chi jiu xing bing du	1
飞锄	fei chu	1
飞达红	fei da hong	1
飞达红号	fei da hong hao	1
菲岛毛眼水蝇	fei dao mao yan shui ying	1
肥地	fei di	1
非点源	fei dian yuan	1
非放射性示踪物	fei fang she xing shi zong wu	1
非共生固氮作用	fei gong sheng gu dan zuo yong	1
非灌溉稻田	fei guan gai dao tian	1
肥害	fei hai	1
飞机草	fei ji cao	1
飞机喷雾	fei ji pen wu	1
飞机撒播器	fei ji sa bo qi	1
非技术工人	fei ji shu gong ren	1
非监督分类	fei jian du fen lei	1
肥力素	fei li su	1
肥料利用率	fei liao li yong lv	1
肥料品位	fei liao pin wei	1
肥料效率	fei liao xiao lv	1
肥料效应	fei liao xiao ying	1
非轮回亲本	fei lun hui qin ben	1
非密度制约因子	fei mi du zhi yue yin zi	1
飞鸟型农业	fei niao xing nong ye	1
非侵染性病害	fei qin ran xing bing hai	1
非生物环境	fei sheng wu huan jing	1
飞虱	fei shi	1
肥水	fei shui	1
废水处理	fei shui chu li	1
肥土	fei tu	1
废物再循环	fei wu zai xun huan	1
非线性回归	fei xian xing hui gui	1
肥效	fei xiao	1
飞燕草	fei yan cao	1
肥药	fei yao	1
肥药混喷	fei yao hun pen	1
肥源	fei yuan	1
非整倍体	fei zheng bei ti	1
非洲大蜗牛	fei zhou da wo niu	1
非洲鳄	fei zhou e	1
非洲棉	fei zhou mian	1
榧子	fei zi	1
分辨率	fen bian lv	1
分辨时间	fen bian shi jian	1
分布型	fen bu xing	1
分布预测	fen bu yu ce	1
分层	fen ceng	1
粉痴病	fen chi bing	1
分次剂量	fen ci ji liang	1
分次施肥	fen ci shi fei	1
粉葛	fen ge	1
分化期	fen hua qi	1
粉剂	fen ji	1
粉蚧	fen jie	1
分开离合器	fen kai li he qi	1
粉糠	fen kang	1
分类程序	fen lei cheng xu	1
分类机	fen lei ji	1
分类人员	fen lei ren yuan	1
分馏	fen liu	1
粉霉灵	fen mei ling	1
粪尿	fen niao	1
分蘖	fen nie	1
分蘖多	fen nie duo	1
分蘖肥	fen nie fei	1
分蘖节	fen nie jie	1
分蘖力	fen nie li	1
分蘖期	fen nie qi	1
分蘖少	fen nie shao	1
分配奖品	fen pei jiang pin	1
分期偿付	fen qi chang fu	1
分墒	fen shang	1
粪水	fen shui	1
粉碎机	fen sui ji	1
分厢	fen xiang	1
粉锈宁	fen xiu ning	1
分枝繁殖	fen zhi fan zhi	1
分枝期	fen zhi qi	1
分子式	fen zi shi	1
粉唑醇	fen zuo chun	1
砜拌磷	feng ban lin	1
丰丙磷	feng bing lin	1
丰产性	feng chan xing	1
封锄	feng chu	1
风倒	feng dao	1
凤稻	feng dao	1
凤蝶	feng die	1
封豆洁	feng dou jie	1
风干	feng gan	1
蜂糕	feng gao	1
风害	feng hai	1
凤梨	feng li	1
凤梨病	feng li bing	1
风力发动机	feng li fa dong ji	1
风力机	feng li ji	1
蜂雀	feng que	1
风沙暴	feng sha bao	1
凤氏彝兰	feng shi yi lan	1
丰收计划	feng shou ji hua	1
丰收之年	feng shou zhi nian	1
枫树	feng shu	1
封滩育林	feng tan yu lin	1
凤尾蝶	feng wei die	1
凤尾蕨	feng wei jue	1
风味饮食	feng wei yin shi	1
凤仙花	feng xian hua	1
枫香	feng xiang	1
风箱式照相机	feng xiang shi zhao xiang ji	1
风信花	feng xin hua	1
封行	feng xing	1
封行期	feng xing qi	1
风选	feng xuan	1
风选机	feng xuan ji	1
凤眼兰	feng yan lan	1
凤眼莲	feng yan lian	1
疯长	feng zhang	1
风折	feng zhe	1
佛肚竹	fo du zhu	1
佛手瓜	fo shou gua	1
氟胺氰菊酯	fu an qing ju zhi	1
父本	fu ben	1
氟苯脲	fu ben niao	1
氟吡菌胺	fu bi jun an	1
腐必清	fu bi qing	1
氟吡乙禾草灵	fu bi yi he cao ling	1
氟丙菊酯	fu bing ju zhi	1
伏草胺	fu cao an	1
氟草除	fu cao chu	1
氟草定	fu cao ding	1
呋草黄	fu cao huang	1
氟草净	fu cao jing	1
氟草灵	fu cao ling	1
副产品	fu chan pin	1
氟虫胺	fu chong an	1
氟虫腈	fu chong jing	1
伏虫隆	fu chong long	1
伏虫脲	fu chong niao	1
氟虫脲	fu chong niao	1
副代表	fu dai biao	1
氟啶胺	fu ding an	1
氟啶虫酰胺	fu ding chong xian an	1
氟啶脲	fu ding niao	1
浮动汇率	fu dong hui lv	1
呋多	fu duo	1
呋多甲	fu duo jia	1
呋多酮种衣剂	fu duo tong zhong yi ji	1
呋多五种衣剂	fu duo wu zhong yi ji	1
复方多菌灵	fu fang duo jun ling	1
复方井冈霉素	fu fang jing gang mei su	1
扶芳藤	fu fang teng	1
复肥	fu fei	1
氟伏虫脲	fu fu chong niao	1
呋福种衣剂	fu fu zhong yi ji	1
覆盖度	fu gai du	1
覆盖物	fu gai wu	1
覆盖作物	fu gai zuo wu	1
腐根	fu gen	1
复耕	fu geng	1
氟硅菊酯	fu gui ju zhi	1
氟硅唑	fu gui zuo	1
符号语言	fu hao yu yan	1
复合肥	fu he fei	1
复合肥料	fu he fei liao	1
复合家庭	fu he jia ting	1
复合太阳能加热系统	fu he tai yang neng jia re xi tong	1
复合微生物	fu he wei sheng wu	1
复合杂交	fu he za jiao	1
氟化物中毒	fu hua wu zhong du	1
氟环唑	fu huan zuo	1
氟磺胺草醚	fu huang an cao mi	1
氟磺星	fu huang xing	1
负积温	fu ji wen	1
附加系	fu jia xi	1
呋甲种衣剂	fu jia zhong yi ji	1
福甲种衣剂	fu jia zhong yi ji	1
氟节胺	fu jie an	1
氟蚧胺	fu jie an	1
呋菌胺	fu jun an	1
肤菌隆	fu jun long	1
氟菌唑	fu jun zuo	1
复拉丁方设计	fu la ding fang she ji	1
腐烂病	fu lan bing	1
福朗	fu lang	1
氟乐灵	fu le ling	1
富力库	fu li ku	1
福利松	fu li song	1
拂菱	fu ling	1
氟铃脲	fu ling niao	1
氟硫隆	fu liu long	1
福禄考	fu lu kao	1
孵卵机	fu luan ji	1
孵卵室	fu luan shi	1
氟氯菊酯	fu lv ju zhi	1
氟氯氰菊酯	fu lv qing ju zhi	1
氟吗啉	fu ma lin	1
福马株式会社	fu ma zhu shi hui she	1
氟螨	fu man	1
氟螨胺	fu man an	1
氟满脲	fu man niao	1
氟螨嗪	fu man qin	1
稃毛	fu mao	1
福美甲胂	fu mei jia shen	1
腐霉利	fu mei li	1
福美胂	fu mei shen	1
福美双	fu mei shuang	1
福美双福美锌	fu mei shuang fu mei xin	1
福美锌	fu mei xin	1
呋醚唑	fu mi zuo	1
氟醚唑	fu mi zuo	1
覆膜	fu mo	1
呋喃虫酰肼	fu nan chong xian jing	1
呋喃丹	fu nan dan	1
负泥虫	fu ni chong	1
负泥甲	fu ni jia	1
复配农药	fu pei nong yao	1
麸皮	fu pi	1
扶贫办	fu pin ban	1
扶贫攻坚	fu pin gong jian	1
氟氰菊酯	fu qing ju zhi	1
氟氰戊菊酯	fu qing wu ju zhi	1
负趋性	fu qu xing	1
副热带	fu re dai	1
副热带雨林气候	fu re dai yu lin qi hou	1
伏杀硫磷	fu sha liu lin	1
辐射保藏	fu she bao cang	1
辐射处理	fu she chu li	1
辐射带动能力	fu she dai dong neng li	1
辐射防护	fu she fang hu	1
辐射分解	fu she fen jie	1
辐射计	fu she ji	1
辐射抗性	fu she kang xing	1
辐射灭菌	fu she mie jun	1
辐射敏感性	fu she min gan xing	1
辐射强度	fu she qiang du	1
辐射生物学	fu she sheng wu xue	1
辐射损伤	fu she sun shang	1
辐射遗传学	fu she yi chuan xue	1
辐射诱发突变体	fu she you fa tu bian ti	1
腐生物	fu sheng wu	1
复式簿记	fu shi bu ji	1
腐食酪螨	fu shi lao man	1
副食品厂	fu shi pin chang	1
福寿螺	fu shou luo	1
氟鼠定	fu shu ding	1
附属委员会	fu shu wei yuan hui	1
氟特力	fu te li	1
覆土	fu tu	1
覆瓦状	fu wa zhuang	1
负温度	fu wen du	1
服务三农	fu wu san nong	1
呋酰胺	fu xian an	1
氟酰胺	fu xian an	1
呋线威	fu xian wei	1
复相关	fu xiang guan	1
副乡长	fu xiang zhang	1
复性	fu xing	1
复叶	fu ye	1
富意	fu yi	1
伏蚁灵	fu yi ling	1
伏蚁腙	fu yi zong	1
浮游生物	fu you sheng wu	1
浮游植物	fu you zhi wu	1
辐照度	fu zhao du	1
辐照工厂	fu zhao gong chang	1
辐照加工	fu zhao jia gong	1
辐照量	fu zhao liang	1
辐照率	fu zhao lv	1
辐照室	fu zhao shi	1
复制	fu zhi	1
腐殖化	fu zhi hua	1
腐殖酸钠	fu zhi suan na	1
腐殖酸铜	fu zhi suan tong	1
腐殖质	fu zhi zhi	1
复制子	fu zhi zi	1
复种	fu zhong	1
复种指数	fu zhong zhi shu	1
辅助剂	fu zhu ji	1
辅助授粉	fu zhu shou fen	1
辅助因子	fu zhu yin zi	1
富滋	fu zi	1
盖草	gai cao	1
盖草灵	gai cao ling	1
盖草能	gai cao neng	1
改厕	gai ce	1
盖虫散	gai chong san	1
改厨	gai chu	1
该村	gai cun	1
钙肥	gai fei	1
改厩	gai jiu	1
芥蓝	gai lan	1
芥蓝菜	gai lan cai	1
改良品种	gai liang pin zhong	1
改良系谱法	gai liang xi pu fa	1
概率	gai lv	1
钙镁磷肥	gai mei lin fei	1
盖膜	gai mo	1
盖沙	gai sha	1
改善生活条件	gai shan sheng huo tiao jian	1
改土归流	gai tu gui liu	1
改土设流	gai tu she liu	1
盖种	gai zhong	1
干巴菌	gan ba jun	1
感病体	gan bing ti	1
感病性	gan bing xing	1
干菜	gan cai	1
干草叉	gan cao cha	1
干草棚	gan cao peng	1
干沉降	gan chen jiang	1
干豆粒	gan dou li	1
干腐	gan fu	1
干腐病	gan fu bing	1
秆高	gan gao	1
干谷	gan gu	1
感光剂	gan guang ji	1
感光性	gan guang xing	1
干海子	gan hai zi	1
干旱农业	gan han nong ye	1
干旱气候	gan han qi hou	1
秆黑粉病	gan hei fen bing	1
干灰化	gan hui hua	1
干尖线虫病	gan jian xian chong bing	1
甘蕉	gan jiao	1
柑桔大实蝇	gan ju da shi ying	1
柑桔红蜘蛛	gan ju hong zhi zhu	1
柑桔锈螨	gan ju xiu man	1
秆枯病	gan ku bing	1
橄榄	gan lan	1
甘蓝	gan lan	1
橄榄谷	gan lan gu	1
橄榄谷型	gan lan gu xing	1
甘蓝类蔬菜	gan lan lei shu cai	1
甘蓝型	gan lan xing	1
甘蓝型油菜	gan lan xing you cai	1
甘蓝蚜	gan lan ya	1
甘蓝夜蛾	gan lan ye e	1
甘露儿	gan lu er	1
干渠	gan qu	1
柑蛆	gan qu	1
干热	gan re	1
干热风	gan re feng	1
干热风害	gan re feng hai	1
干热河谷	gan re he gu	1
干热期	gan re qi	1
干烧心	gan shao xin	1
干湿交替	gan shi jiao ti	1
甘薯	gan shu	1
甘薯黑斑病	gan shu hei ban bing	1
甘薯小象虫	gan shu xiao xiang chong	1
感温感光性	gan wen gan guang xing	1
感温性	gan wen xing	1
干物质	gan wu zhi	1
秆行试验	gan xing shi yan	1
秆锈病	gan xiu bing	1
甘彝族	gan yi zu	1
秆蝇	gan ying	1
干燥气候	gan zao qi hou	1
甘蔗	gan zhe	1
甘蔗螟	gan zhe ming	1
干砧	gan zhen	1
干制保藏	gan zhi bao cang	1
干重	gan zhong	1
高倍特	gao bei te	1
高残留	gao can liu	1
高产创建	gao chan chuang jian	1
高产稳产	gao chan wen chan	1
高产优质	gao chan you zhi	1
高凳	gao deng	1
高毒	gao du	1
高肥	gao fei	1
高肥力	gao fei li	1
高秆	gao gan	1
稿杆	gao gan	1
稿秆	gao gan	1
高秆作物	gao gan zuo wu	1
高海拔	gao hai ba	1
高级报纸	gao ji bao zhi	1
高级农艺师	gao ji nong yi shi	1
高脚蕉	gao jiao jiao	1
高脚苗	gao jiao miao	1
高接	gao jie	1
高抗	gao kang	1
高粱芒蝇	gao liang mang ying	1
高粱米	gao liang mi	1
高粱蚜	gao liang ya	1
高粱瘿蚊	gao liang ying wen	1
高粱舟娥	gao liang zhou e	1
高灭磷	gao mie lin	1
高频干燥	gao pin gan zao	1
高畦	gao qi	1
高山反季蔬菜	gao shan fan ji shu cai	1
高渗异丙隆	gao shen yi bing long	1
高钛渣	gao tai zha	1
高特克	gao te ke	1
膏桐	gao tong	1
高稳产	gao wen chan	1
高温多雨	gao wen duo yu	1
高温干旱	gao wen gan han	1
高稳农田	gao wen nong tian	1
高温热害	gao wen re hai	1
高温少雨	gao wen shao yu	1
高温障碍	gao wen zhang ai	1
高效安绿宝	gao xiao an lv bao	1
高效吡氟	gao xiao bi fu	1
高效盖草能	gao xiao gai cao neng	1
高效磷	gao xiao lin	1
高效氯氰菊酯	gao xiao lv qing ju zhi	1
高效氯氰马	gao xiao lv qing ma	1
高效灭百可	gao xiao mie bai ke	1
高效氰戊菊酯	gao xiao qing wu ju zhi	1
膏药病	gao yao bing	1
高原气候	gao yuan qi hou	1
高脂膜	gao zhi mo	1
高枝压条	gao zhi ya tiao	1
割草机	ge cao ji	1
割草佳	ge cao jia	1
割草醚	ge cao mi	1
革除教门	ge chu jiao men	1
割袋	ge dai	1
割豆草	ge dou cao	1
咯菌腈	ge jun jing	1
咯喹酮	ge kui tong	1
割捆机	ge kun ji	1
隔离区设置	ge li qu she zhi	1
格螨酯	ge man zhi	1
戈瑞	ge rui	1
割晒机	ge shai ji	1
割晒牧草	ge shai mu cao	1
搁田	ge tian	1
鸽子树	ge zi shu	1
根癌病	gen ai bing	1
根菜类蔬菜	gen cai lei shu cai	1
根腐	gen fu	1
根腐病	gen fu bing	1
根腐瞒	gen fu man	1
根腐线虫病	gen fu xian chong bing	1
根冠比	gen guan bi	1
根黑腐病	gen hei fu bing	1
根接	gen jie	1
根芥菜	gen jie cai	1
根结线虫病	gen jie xian chong bing	1
根颈	gen jing	1
根颈腐病	gen jing fu bing	1
根茎叶	gen jing ye	1
根瘤	gen liu	1
根瘤菌剂	gen liu jun ji	1
根毛	gen mao	1
根芹菜	gen qin cai	1
根区	gen qu	1
根数	gen shu	1
根甜菜	gen tian cai	1
根外	gen wai	1
根线虫病	gen xian chong bing	1
根肿病	gen zhong bing	1
庚草利	geng cao li	1
耕地	geng di	1
耕地面积	geng di mian ji	1
庚烯磷	geng xi lin	1
耕整地机具	geng zheng di ji ju	1
耕作	geng zuo	1
耕作层	geng zuo ceng	1
耕作机具	geng zuo ji ju	1
耕作制	geng zuo zhi	1
工程微生物	gong cheng wei sheng wu	1
功底浅	gong di qian	1
供肥	gong fei	1
供肥能力	gong fei neng li	1
工分值	gong fen zhi	1
公共车辆	gong gong che liang	1
公共成分	gong gong cheng fen	1
公害	gong hai	1
汞化合物	gong hua he wu	1
功能叶	gong neng ye	1
共生固氮作用	gong sheng gu dan zuo yong	1
公式茶会	gong shi cha hui	1
供体	gong ti	1
珙桐	gong tong	1
恭桶盖	gong tong gai	1
恭桶座圈	gong tong zuo quan	1
公兔	gong tu	1
公务电梯	gong wu dian ti	1
公羊	gong yang	1
工业胶带	gong ye jiao dai	1
工业原料作物	gong ye yuan liao zuo wu	1
工蚁	gong yi	1
共育	gong yu	1
汞制剂	gong zhi ji	1
公主岭霉素	gong zhu ling mei su	1
工资指数	gong zi zhi shu	1
工作存储器	gong zuo cun chu qi	1
工作滞后	gong zuo zhi hou	1
沟长	gou chang	1
钩翅娥	gou chi e	1
枸骨	gou gu	1
沟灌	gou guan	1
购机补贴协议	gou ji bu tie xie yi	1
购机农户	gou ji nong hu	1
沟金针虫	gou jin zhen chong	1
枸桔	gou ju	1
沟宽	gou kuan	1
沟泥	gou ni	1
沟平	gou ping	1
沟深	gou shen	1
沟施	gou shi	1
狗尾草	gou wei cao	1
沟直	gou zhi	1
构筑梯田	gou zhu ti tian	1
谷斑皮囊	gu ban pi nang	1
谷糙分离	gu cao fen li	1
估产	gu chan	1
孤雌生殖	gu ci sheng zhi	1
固氮	gu dan	1
固氮菌	gu dan jun	1
固氮能力	gu dan neng li	1
固氮作用	gu dan zuo yong	1
谷地	gu di	1
固定模型	gu ding mo xing	1
固定债务	gu ding zhai wu	1
谷蠹	gu du	1
骨粉	gu fen	1
股份基金	gu fen ji jin	1
谷黄	gu huang	1
估价发票	gu jia fa piao	1
古建筑文物	gu jian zhu wen wu	1
谷壳分离	gu ke fen li	1
谷枯病	gu ku bing	1
谷婪步甲	gu lan bu jia	1
钴蓝色	gu lan se	1
菇蕾	gu lei	1
菇类蛋白多糖	gu lei dan bai duo tang	1
谷类作物	gu lei zuo wu	1
谷粒	gu li	1
鼓粒	gu li	1
鼓粒肥	gu li fei	1
菇连体	gu lian ti	1
谷粮仓	gu liang cang	1
谷鳞斑叶甲	gu lin ban ye jia	1
股面价格	gu mian jia ge	1
股票持有人	gu piao chi you ren	1
股票交易所	gu piao jiao yi suo	1
估税标准	gu shui biao zhun	1
菇体	gu ti	1
固体废物	gu ti fei wu	1
孤挺花	gu ting hua	1
谷文昌	gu wen chang	1
谷物干燥机	gu wu gan zao ji	1
古蜥蜴	gu xi yi	1
谷象	gu xiang	1
固相放射免疫分析	gu xiang fang she mian yi fen xi	1
谷雨	gu yu	1
谷子白发病	gu zi bai fa bing	1
谷子负泥甲	gu zi fu ni jia	1
古紫色	gu zi se	1
刮粪机	gua fen ji	1
瓜丰灵	gua feng ling	1
挂果率	gua guo lv	1
瓜菊酯	gua ju zhi	1
瓜枯宁	gua ku ning	1
瓜类蔬菜	gua lei shu cai	1
挂晾	gua liang	1
挂牌收粮	gua pai shou liang	1
寡食性	gua shi xing	1
挂图	gua tu	1
寡雄腐霉菌	gua xiong fu mei jun	1
瓜叶菊	gua ye ju	1
罐藏	guan cang	1
冠层	guan ceng	1
管道技工	guan dao ji gong	1
冠腐病	guan fu bing	1
灌溉农业	guan gai nong ye	1
灌溉水质标准	guan gai shui zhi biao zhun	1
灌溉条件	guan gai tiao jian	1
灌浆期	guan jiang qi	1
冠接	guan jie	1
观剧会	guan ju hui	1
冠菌铜	guan jun tong	1
管理卫生	guan li wei sheng	1
灌渠	guan qu	1
灌区改造	guan qu gai zao	1
观赏园艺	guan shang yuan yi	1
观赏植物	guan shang zhi wu	1
管水	guan shui	1
灌透	guan tou	1
管制经济	guan zhi jing ji	1
光饱和点	guang bao he dian	1
光补偿点	guang bu chang dian	1
广锄	guang chu	1
广大农民	guang da nong min	1
广大农民群众	guang da nong min qun zhong	1
光符阅读机	guang fu yue du ji	1
广柑	guang gan	1
光合	guang he	1
光合强度	guang he qiang du	1
光核桃	guang he tao	1
光合细菌	guang he xi jun	1
光合效率	guang he xiao lv	1
光合有效辐射	guang he you xiao fu she	1
光合作用	guang he zuo yong	1
光肩星天牛	guang jian xing tian niu	1
光壳	guang ke	1
光壳型	guang ke xing	1
桄榔	guang lang	1
广灭净	guang mie jing	1
广灭灵	guang mie ling	1
光能利用率	guang neng li yong lv	1
光谱测量	guang pu ce liang	1
光谱范围	guang pu fan wei	1
光谱信息	guang pu xin xi	1
光扫描器	guang sao miao qi	1
光温生产潜力	guang wen sheng chan qian li	1
广玉兰	guang yu lan	1
光照处理	guang zhao chu li	1
光照阶段	guang zhao jie duan	1
光照强度	guang zhao qiang du	1
光周期	guang zhou qi	1
光周期现象	guang zhou qi xian xiang	1
光资源	guang zi yuan	1
硅白灵	gui bai ling	1
龟背天牛	gui bei tian niu	1
归仓	gui cang	1
桂朝	gui chao	1
桂花	gui hua	1
鬼脸天蛾	gui lian tian e	1
规模化	gui mo hua	1
规模养殖户	gui mo yang zhi hu	1
硅噻菌胺	gui sai jun an	1
硅酸细菌	gui suan xi jun	1
桂圆	gui yuan	1
滚压器	gun ya qi	1
果菜类蔬菜	guo cai lei shu cai	1
过迟	guo chi	1
果虫磷	guo chong lin	1
果醋	guo cu	1
果冻	guo dong	1
过度生长	guo du sheng zhang	1
果尔	guo er	1
果丰定	guo feng ding	1
过干	guo gan	1
果干	guo gan	1
国槐	guo huai	1
国际检疫	guo ji jian yi	1
国际新闻协会	guo ji xin wen xie hui	1
果荚	guo jia	1
国家农业综合门户网站	guo jia nong ye zong he men hu wang zhan	1
果酒	guo jiu	1
果壳	guo ke	1
过量食物	guo liang shi wu	1
过磷酸钙	guo lin suan gai	1
过滤	guo lv	1
果满磷	guo man lin	1
过密	guo mi	1
过密枝	guo mi zhi	1
果面	guo mian	1
果面表光	guo mian biao guang	1
过敏性	guo min xing	1
果木树	guo mu shu	1
国内检疫	guo nei jian yi	1
果泥	guo ni	1
果农	guo nong	1
果潜蝇	guo qian ying	1
果肉饮料	guo rou yin liao	1
过筛	guo shai	1
过湿	guo shi	1
果实直感	guo shi zhi gan	1
过熟	guo shu	1
果数	guo shu	1
果疏多	guo shu duo	1
果树苗木	guo shu miao mu	1
果树学	guo shu xue	1
果树栽培	guo shu zai pei	1
过头粮	guo tou liang	1
国土资源部	guo tu zi yuan bu	1
过稀	guo xi	1
果型	guo xing	1
国有公路	guo you gong lu	1
国债项目	guo zhai xiang mu	1
哈密瓜	ha mi gua	1
海拔高度	hai ba gao du	1
海带	hai dai	1
海岛棉	hai dao mian	1
海鲷	hai diao	1
海禾	hai he	1
害极灭	hai ji mie	1
海陆风	hai lu feng	1
还苗	hai miao	1
还苗期	hai miao qi	1
海棠果	hai tang guo	1
海棠花	hai tang hua	1
还田	hai tian	1
海桐	hai tong	1
海洋河流	hai yang he liu	1
海枣	hai zao	1
海藻素	hai zao su	1
海震	hai zhen	1
旱草枯	han cao ku	1
寒潮	han chao	1
旱床育秧	han chuang yu yang	1
寒带	han dai	1
旱稻	han dao	1
旱地	han di	1
旱地农业	han di nong ye	1
旱金莲	han jin lian	1
韩乐宁暂定	han le ning zan ding	1
旱粮	han liang	1
旱粮水浇	han liang shui jiao	1
旱粮组	han liang zu	1
寒露	han lu	1
寒露风	han lu feng	1
旱芹	han qin	1
含水量	han shui liang	1
旱田	han tian	1
寒温带	han wen dai	1
旱莠定	han you ding	1
旱育	han yu	1
旱育保姆	han yu bao mu	1
旱育秧	han yu yang	1
旱作农业	han zuo nong ye	1
行间	hang jian	1
行间距	hang jian ju	1
行间中耕机	hang jian zhong geng ji	1
行距	hang ju	1
航空相片	hang kong xiang pian	1
航片	hang pian	1
夯实农业基础	hang shi nong ye ji chu	1
蒿秆覆盖	hao gan fu gai	1
毫公	hao gong	1
毫公型	hao gong xing	1
豪华桥车	hao hua qiao che	1
好来施	hao lai shi	1
好立达	hao li da	1
好灭丹	hao mie dan	1
好年冬	hao nian dong	1
好气性	hao qi xing	1
耗水	hao shui	1
耗水量	hao shui liang	1
耗水系数	hao shui xi shu	1
毫微秒	hao wei miao	1
好易净	hao yi jing	1
禾爱施	he ai shi	1
河坝洋芋	he ba yang yu	1
禾拜灵	he bai ling	1
褐斑病	he ban bing	1
荷包牡丹	he bao mu dan	1
禾本豆好	he ben dou hao	1
禾本科	he ben ke	1
禾本科绿肥	he ben ke lv fei	1
褐边绿刺蛾	he bian lv ci e	1
褐边螟	he bian ming	1
合并债务	he bing zhai wu	1
禾草丹	he cao dan	1
禾草克	he cao ke	1
禾草灵	he cao ling	1
禾草清	he cao qing	1
禾草特	he cao te	1
禾草畏	he cao wei	1
合成孔径雷达	he cheng kong jing lei da	1
合成作用	he cheng zuo yong	1
核磁共振	he ci gong zhen	1
禾大壮	he da zhuang	1
褐点盾蚧	he dian dun jie	1
合法婚姻	he fa hun yin	1
褐飞虱	he fei shi	1
褐腐	he fu	1
何弗米丁	he fu mi ding	1
核苷酸	he gan suan	1
褐根病	he gen bing	1
禾谷镰刀菌病	he gu lian dao jun bing	1
禾果利	he guo li	1
荷花玉兰	he hua yu lan	1
禾蓟马	he ji ma	1
核技术	he ji shu	1
禾克	he ke	1
禾枯灵	he ku ling	1
禾捆	he kun	1
禾捆堆	he kun dui	1
荷兰菊	he lan ju	1
荷兰路森公司	he lan lu sen gong si	1
河狸	he li	1
合理密植	he li mi zhi	1
核裂变	he lie bian	1
河流断面	he liu duan mian	1
河漫滩地	he man tan di	1
河门口	he men kou	1
禾耐斯	he nai si	1
核能级	he neng ji	1
河泥	he ni	1
禾农思	he nong si	1
核农学	he nong xue	1
核盘菌茎腐病	he pan jun jing fu bing	1
核融合	he rong he	1
核溶解	he rong jie	1
核乳胶	he ru jiao	1
河沙	he sha	1
合杀威	he sha wei	1
和尚庄	he shang zhuang	1
何氏凤仙	he shi feng xian	1
河水猛涨	he shui meng zhang	1
核素	he su	1
核酸	he suan	1
核酸酶	he suan mei	1
和穗宁	he sui ning	1
禾穗宁	he sui ning	1
河滩地	he tan di	1
核糖核酸	he tang he suan	1
核桃	he tao	1
核桃树	he tao shu	1
褐天牛	he tian niu	1
褐土	he tu	1
禾畏	he wei	1
褐纹金针虫	he wen jin zhen chong	1
合系	he xi	1
核心家庭	he xin jia ting	1
核心酶	he xin mei	1
核型	he xing	1
核雄性不育系	he xiong xing bu yu xi	1
核移植	he yi zhi	1
褐雨燕	he yu yan	1
河源湖	he yuan hu	1
核质互作	he zhi hu zuo	1
核质杂种	he zhi za zhong	1
诃子瘤蛾	he zi liu e	1
合作农场	he zuo nong chang	1
合作医疗	he zuo yi liao	1
黑疤病	hei ba bing	1
黑斑病	hei ban bing	1
黑翅土白蚁	hei chi tu bai yi	1
黑刺粉虱	hei ci fen shi	1
黑刺李	hei ci li	1
黑点银纹夜蛾	hei dian yin wen ye e	1
黑痘病	hei dou bing	1
黑额光叶甲	hei e guang ye jia	1
黑粉病	hei fen bing	1
黑粉菌	hei fen jun	1
黑粉虱	hei fen shi	1
黑缝叶甲	hei feng ye jia	1
黑腐病	hei fu bing	1
黑钙土	hei gai tu	1
黑根	hei gen	1
黑谷	hei gu	1
黑谷型	hei gu xing	1
黑节病	hei jie bing	1
黑胫病	hei jing bing	1
黑龙江简喙象	hei long jiang jian hui xiang	1
黑麦	hei mai	1
黑莓	hei mei	1
黑木耳	hei mu er	1
黑皮蠹	hei pi du	1
黑潜蝇	hei qian ying	1
黑曲霉病	hei qu mei bing	1
黑绒金龟	hei rong jin gui	1
黑色蔗龟	hei se zhe gui	1
黑森瘿蚊	hei sen ying wen	1
黑山羊	hei shan yang	1
黑薯	hei shu	1
黑束病	hei shu bing	1
黑穗病	hei sui bing	1
黑体辐射	hei ti fu she	1
黑条矮缩病	hei tiao ai suo bing	1
黑土宝	hei tu bao	1
黑尾叶蝉	hei wei ye chan	1
黑纹粉蝶	hei wen fen die	1
黑彝	hei yi	1
黑彝族	hei yi zu	1
黑颖病	hei ying bing	1
黑鸢	hei yuan	1
黑痣病	hei zhi bing	1
黑子南瓜	hei zi nan gua	1
黑足黑守瓜	hei zu hei shou gua	1
痕量元素	hen liang yuan su	1
横径	heng jing	1
横式照片	heng shi zhao pian	1
横纹菜蝽	heng wen cai chun	1
红矮病毒病	hong ai bing du bing	1
红斑病	hong ban bing	1
红背安缘蝽	hong bei an yuan chun	1
红菜薹	hong cai tai	1
红茶	hong cha	1
红橙	hong cheng	1
红醋栗	hong cu li	1
红豆杉	hong dou shan	1
红豆越桔	hong dou yue ju	1
红粉蚧	hong fen jie	1
红河橙	hong he cheng	1
红花	hong hua	1
红花菜豆	hong hua cai dou	1
红花实蝇	hong hua shi ying	1
红花籽油	hong hua zi you	1
红花酢浆草	hong hua zuo jiang cao	1
红黄草	hong huang cao	1
红脚	hong jiao	1
红蜡蚧	hong la jie	1
红蜡阶	hong la jie	1
红铃虫性诱素	hong ling chong xing you su	1
红螺疣	hong luo you	1
红绿灯峨	hong lv deng e	1
红麻	hong ma	1
红毛丹	hong mao dan	1
红皮	hong pi	1
红萍	hong ping	1
烘青	hong qing	1
红壤	hong rang	1
红色根腐病	hong se gen fu bing	1
红杉	hong shan	1
红树	hong shu	1
红隼	hong sun	1
红外扫描	hong wai sao miao	1
红外线干燥	hong wai xian gan zao	1
红外线加热	hong wai xian jia re	1
红叶病	hong ye bing	1
宏裕	hong yu	1
宏裕灵	hong yu ling	1
宏裕星	hong yu xing	1
红圆蚧	hong yuan jie	1
红棕灰夜蛾	hong zong hui ye e	1
厚孢轮枝菌	hou bao lun zhi jun	1
候补中央委员	hou bu zhong yang wei yuan	1
后茬	hou cha	1
后翅	hou chi	1
后窗玻璃	hou chuang bo li	1
后辍名	hou chuo ming	1
后代测验	hou dai ce yan	1
后辐照	hou fu zhao	1
猴面包树	hou mian bao shu	1
后熟	hou shu	1
猴头菌	hou tou jun	1
后效	hou xiao	1
后作物	hou zuo wu	1
虎斑病	hu ban bing	1
胡葱	hu cong	1
蝴蝶花	hu die hua	1
蝴蝶兰	hu die lan	1
胡蜂	hu feng	1
护丰安	hu feng an	1
湖港区	hu gang qu	1
瓠瓜	hu gua	1
槲寄生	hu ji sheng	1
胡家村	hu jia cun	1
互交	hu jiao	1
琥胶肥酸铜	hu jiao fei suan tong	1
胡椒硷	hu jiao jian	1
呼叫指令	hu jiao zhi ling	1
户均	hu jun	1
胡萝卜	hu luo bo	1
胡麻斑病	hu ma ban bing	1
琥珀酸铜	hu po suan tong	1
胡桃	hu tao	1
湖田	hu tian	1
虎尾草	hu wei cao	1
护矽得	hu xi de	1
呼吸系数	hu xi xi shu	1
户用	hu yong	1
户用沼气	hu yong zhao qi	1
沪玉糯	hu yu nuo	1
华北蝼蛄	hua bei lou gu	1
花柄	hua bing	1
花菜类蔬菜	hua cai lei shu cai	1
花蝽	hua chun	1
花而不实	hua er bu shi	1
化肥撒肥机	hua fei sa fei ji	1
花粉不育性	hua fen bu yu xing	1
花粉蒙导	hua fen meng dao	1
花粉培养	hua fen pei yang	1
花腐病	hua fu bing	1
化感素	hua gan su	1
花谷型	hua gu xing	1
华光霉素	hua guang mei su	1
花黑粉病	hua hei fen bing	1
花红	hua hong	1
花卉布置	hua hui bu zhi	1
花卉栽培	hua hui zai pei	1
花卉装饰	hua hui zhuang shi	1
花蓟马	hua ji ma	1
花椒树	hua jiao shu	1
花菱草	hua ling cao	1
画眉草	hua mei cao	1
花魔芋	hua mo yu	1
花弄蝶	hua nong die	1
花荞	hua qiao	1
华山松	hua shan song	1
花生病害	hua sheng bing hai	1
花生酱	hua sheng jiang	1
花生烂种	hua sheng lan zhong	1
花生挖掘机	hua sheng wa jue ji	1
花生油	hua sheng you	1
铧式犁	hua shi li	1
华氏温标	hua shi wen biao	1
花数	hua shu	1
花图式	hua tu shi	1
花托	hua tuo	1
划线支票	hua xian zhi piao	1
花型	hua xing	1
花序	hua xu	1
化学反应产物	hua xue fan ying chan wu	1
化学防治	hua xue fang zhi	1
化学肥料	hua xue fei liao	1
化学需氧量	hua xue xu yang liang	1
化学诱变剂	hua xue you bian ji	1
化学治疗	hua xue zhi liao	1
花薰茶	hua xun cha	1
花芽	hua ya	1
花药	hua yao	1
花药培养	hua yao pei yang	1
花叶病	hua ye bing	1
花叶病毒病	hua ye bing du bing	1
花椰菜	hua ye cai	1
花油	hua you	1
坏死	huai si	1
环斑	huan ban	1
环斑病	huan ban bing	1
环斑病毒病	huan ban bing du bing	1
环丙津	huan bing jin	1
环丙唑醇	huan bing zuo chun	1
环草胺	huan cao an	1
环草丹	huan cao dan	1
环草特	huan cao te	1
换茬	huan cha	1
缓冲存储器	huan chong cun chu qi	1
缓冲基金	huan chong ji jin	1
环腐病	huan fu bing	1
环己基甲酸锌	huan ji ji jia suan xin	1
环境标准	huan jing biao zhun	1
环境参数	huan jing can shu	1
环境毒性	huan jing du xing	1
环境恶化	huan jing e hua	1
环境模拟	huan jing mo ni	1
环境评价	huan jing ping jia	1
环境容量	huan jing rong liang	1
环境危害	huan jing wei hai	1
环境友好型	huan jing you hao xing	1
环境预测	huan jing yu ce	1
环境指数	huan jing zhi shu	1
环境准则	huan jing zhun ze	1
环境资源	huan jing zi yuan	1
环菊酯	huan ju zhi	1
环菌胺	huan jun an	1
环羟螨	huan qiang man	1
环嗪酮	huan qin tong	1
缓释肥料	huan shi fei liao	1
缓释剂	huan shi ji	1
环烯	huan xi	1
环行路	huan xing lu	1
还原糖	huan yuan tang	1
环唑醇	huan zuo chun	1
黄矮病毒病	huang ai bing du bing	1
黄柏褐斑病	huang bai he ban bing	1
黄板	huang ban	1
黄斑病	huang ban bing	1
黄斑叶枯病	huang ban ye ku bing	1
磺苯腈	huang ben jing	1
黄草伏	huang cao fu	1
磺草磷	huang cao lin	1
磺草灵	huang cao ling	1
磺草酮	huang cao tong	1
黄草乌	huang cao wu	1
黄蝉	huang chan	1
蝗虫	huang chong	1
黄刺蛾	huang ci e	1
黄呆蓟马	huang dai ji ma	1
黄弹子	huang dan zi	1
黄地老虎	huang di lao hu	1
黄顶病	huang ding bing	1
黄凤蝶	huang feng die	1
黄腐酸	huang fu suan	1
黄瓜	huang gua	1
黄瓜花叶病	huang gua hua ye bing	1
黄化	huang hua	1
黄化病	huang hua bing	1
黄花苜蓿	huang hua mu xu	1
黄花烟草	huang hua yan cao	1
黄花叶病	huang hua ye bing	1
黄金间碧玉竹	huang jin jian bi yu zhu	1
黄卷叶蛾	huang juan ye e	1
磺菌胺	huang jun an	1
磺菌威	huang jun wei	1
黄壳麦	huang ke mai	1
黄宽条菜	huang kuan tiao cai	1
黄兰	huang lan	1
黄龙病	huang long bing	1
黄栌	huang lu	1
黄绿苗	huang lv miao	1
黄麻	huang ma	1
黄毛虫	huang mao chong	1
黄苗	huang miao	1
黄螟	huang ming	1
荒漠化	huang mo hua	1
黄皮	huang pi	1
黄皮树	huang pi shu	1
黄芩	huang qin	1
黄秋葵	huang qiu kui	1
黄曲霉病	huang qu mei bing	1
黄曲条跳甲	huang qu tiao tiao jia	1
黄壤	huang rang	1
黄热病	huang re bing	1
黄熟	huang shu	1
黄水仙	huang shui xian	1
黄萎病	huang wei bing	1
黄尾球跳甲	huang wei qiu tiao jia	1
磺吸磷	huang xi lin	1
黄狭条跳甲	huang xia tiao tiao jia	1
黄心	huang xin	1
黄星蝗	huang xing huang	1
黄星天牛	huang xing tian niu	1
黄锈病	huang xiu bing	1
黄杨	huang yang	1
黄叶病	huang ye bing	1
黄栀子灰蝶	huang zhi zi hui die	1
黄棕壤	huang zong rang	1
灰斑病	hui ban bing	1
毁草	hui cao	1
会车灯	hui che deng	1
汇豆克	hui dou ke	1
灰度	hui du	1
灰飞虱	hui fei shi	1
灰粪	hui fen	1
灰粉蚧	hui fen jie	1
辉丰杀敌	hui feng sha di	1
辉丰一号	hui feng yi hao	1
恢复肥	hui fu fei	1
恢复系	hui fu xi	1
回归	hui gui	1
回归线	hui gui xian	1
茴蒿素	hui hao su	1
灰褐色	hui he se	1
灰褐羽蛾	hui he yu e	1
回交	hui jiao	1
会交点	hui jiao dian	1
毁林开荒	hui lin kai huang	1
灰露病	hui lu bing	1
灰霉病	hui mei bing	1
灰漠土	hui mo tu	1
灰泥	hui ni	1
回头浪	hui tou lang	1
茴香	hui xiang	1
会议开幕	hui yi kai mu	1
混合氨基酸镁	hun he an ji suan mei	1
混合氨基酸锰	hun he an ji suan meng	1
混合氨基酸铜	hun he an ji suan tong	1
混合氨基酸锌	hun he an ji suan xin	1
混合法	hun he fa	1
混合肥料	hun he fei liao	1
混合经济	hun he jing ji	1
混合模型	hun he mo xing	1
混合授粉	hun he shou fen	1
混合霜冻	hun he shuang dong	1
混合选择	hun he xuan ze	1
混合油处理	hun he you chu li	1
混合脂肪酸	hun he zhi fang suan	1
混录	hun lu	1
混灭威	hun mie wei	1
混凝土搅拌车	hun ning tu jiao ban che	1
混喷	hun pen	1
混杀硫	hun sha liu	1
混杀威	hun sha wei	1
混系品种	hun xi pin zhong	1
混杂设计	hun za she ji	1
混杂退化	hun za tui hua	1
混作	hun zuo	1
活扳子	huo ban zi	1
火锄	huo chu	1
火葱	huo cong	1
获得抗性	huo de kang xing	1
获得免疫性	huo de mian yi xing	1
活动车篷汽车	huo dong che peng qi che	1
活动积温	huo dong ji wen	1
活动温度	huo dong wen du	1
活化剂	huo hua ji	1
火灰	huo hui	1
火鸡场	huo ji chang	1
货架期延长	huo jia qi yan chang	1
活棵	huo ke	1
活力测定	huo li ce ding	1
活络扳手	huo luo ban shou	1
活络扳子	huo luo ban zi	1
霍普金生物气候律	huo pu jin sheng wu qi hou lv	1
霍香蓟	huo xiang ji	1
活性污泥	huo xing wu ni	1
货运卡车	huo yun ka che	1
基本方位	ji ben fang wei	1
基本苗	ji ben miao	1
基本农田	ji ben nong tian	1
疾病诊断	ji bing zhen duan	1
机播	ji bo	1
荠菜	ji cai	1
蕺菜	ji cai	1
机插	ji cha	1
极差	ji cha	1
级差土地收入	ji cha tu di shou ru	1
鸡场	ji chang	1
计程汽车	ji cheng qi che	1
鸡枞油	ji cong you	1
吉单	ji dan	1
瘠地	ji di	1
极地气候	ji di qi hou	1
几丁聚糖	ji ding ju tang	1
激动素	ji dong su	1
基督教界	ji du jiao jie	1
积分剂量计	ji fen ji liang ji	1
姬蜂	ji feng	1
基腐病	ji fu bing	1
机耕路	ji geng lu	1
鸡冠花	ji guan hua	1
激光微束辐照	ji guang wei shu fu zhao	1
几何校正	ji he jiao zheng	1
几何平均数	ji he ping jun shu	1
几何衰减	ji he shuai jian	1
计划预防维修制	ji hua yu fang wei xiu zhi	1
激活子	ji huo zi	1
吉家村	ji jia cun	1
季节包工	ji jie bao gong	1
季节工	ji jie gong	1
季节性蔬菜	ji jie xing shu cai	1
鸡街子	ji jie zi	1
积累	ji lei	1
剂量	ji liang	1
剂量测定	ji liang ce ding	1
剂量划分	ji liang hua fen	1
剂量计	ji liang ji	1
剂量率	ji liang lv	1
剂量效应	ji liang xiao ying	1
剂量效应曲线	ji liang xiao ying qu xian	1
吉林省农委	ji lin sheng nong wei	1
蓟马	ji ma	1
稷米	ji mi	1
冀棉	ji mian	1
挤奶厂	ji nai chang	1
挤奶机	ji nai ji	1
挤奶器	ji nai qi	1
挤奶台	ji nai tai	1
纪念宴会	ji nian yan hui	1
几噻唑	ji sai zuo	1
鸡舍	ji she	1
寄生蜂	ji sheng feng	1
寄生物	ji sheng wu	1
寄生性	ji sheng xing	1
寄生性病害	ji sheng xing bing hai	1
寄生性天敌	ji sheng xing tian di	1
寄生蝇	ji sheng ying	1
基施	ji shi	1
计数率	ji shu lv	1
技术培训	ji shu pei xun	1
基塘系统	ji tang xi tong	1
集体农场	ji ti nong chang	1
极甜	ji tian	1
季酮螨酯	ji tong man zhi	1
鸡头	ji tou	1
集团法	ji tuan fa	1
集团选择	ji tuan xuan ze	1
积温	ji wen	1
机械防治	ji xie fang zhi	1
机械工程学	ji xie gong cheng xue	1
机械化耕作	ji xie hua geng zuo	1
机械化栽培	ji xie hua zai pei	1
机械通风干燥	ji xie tong feng gan zao	1
机械钻	ji xie zuan	1
极性	ji xing	1
急性暴露	ji xing bao lu	1
急性毒性	ji xing du xing	1
急性辐照	ji xing fu zhao	1
急性接触	ji xing jie chu	1
急性伤害	ji xing shang hai	1
急性症状	ji xing zheng zhuang	1
积雪	ji xue	1
挤压加工	ji ya jia gong	1
挤压膨化	ji ya peng hua	1
基因工程	ji yin gong cheng	1
基因库	ji yin ku	1
基因库材料	ji yin ku cai liao	1
基因文库	ji yin wen ku	1
基因性不育	ji yin xing bu yu	1
基因源	ji yin yuan	1
基因转移	ji yin zhuan yi	1
寄蝇	ji ying	1
鸡油菌	ji you jun	1
机油溴氰	ji you xiu qing	1
集约耕作	ji yue geng zuo	1
集约化	ji yue hua	1
集约农业	ji yue nong ye	1
机载侧视雷达	ji zai ce shi lei da	1
机制钵	ji zhi bo	1
寄主	ji zhu	1
寄主范围	ji zhu fan wei	1
寄主选择性	ji zhu xuan ze xing	1
机助制图	ji zhu zhi tu	1
寄主植物	ji zhu zhi wu	1
寄主专一性	ji zhu zhuan yi xing	1
己唑醇	ji zuo chun	1
甲胺敌	jia an di	1
甲胺敌畏	jia an di wei	1
甲胺磷	jia an lin	1
甲拌磷	jia ban lin	1
假彩色	jia cai se	1
甲草胺	jia cao an	1
甲草醚	jia cao mi	1
甲草嗪	jia cao qin	1
驾车逃逸	jia che tao yi	1
假齿	jia chi	1
家畜利用年限	jia chu li yong nian xian	1
家畜饲料	jia chu si liao	1
加大支农力度	jia da zhi nong li du	1
加代	jia dai	1
甲敌	jia di	1
甲多	jia duo	1
钾肥	jia fei	1
加肥灌溉	jia fei guan gai	1
甲氟菊酯	jia fu ju zhi	1
甲呋酰胺	jia fu xian an	1
甲呋酰苯胺	jia fu xian ben an	1
价格冻结	jia ge dong jie	1
加工番茄	jia gong fan qie	1
加工型玉米	jia gong xing yu mi	1
荚果	jia guo	1
甲磺虫腙	jia huang chong zong	1
甲黄隆	jia huang long	1
甲磺隆	jia huang long	1
甲磺威	jia huang wei	1
甲基毒死蜱	jia ji du si pi	1
甲基对硫磷	jia ji dui liu lin	1
甲基二磺隆	jia ji er huang long	1
甲基立枯磷	jia ji li ku lin	1
甲基硫环磷	jia ji liu huan lin	1
甲基硫菌灵	jia ji liu jun ling	1
甲基硫菌灵硫	jia ji liu jun ling liu	1
甲基硫扑津	jia ji liu pu jin	1
甲基嘧啶磷	jia ji mi ding lin	1
甲基胂酸锌	jia ji shen suan xin	1
甲基十八烯	jia ji shi ba xi	1
甲基托布津	jia ji tuo bu jin	1
甲基辛硫磷	jia ji xin liu lin	1
甲基异柳磷	jia ji yi liu lin	1
甲基乙酯磷	jia ji yi zhi lin	1
嫁接结合部	jia jie jie he bu	1
嫁接嵌合体	jia jie qian he ti	1
嫁接亲和力	jia jie qin he li	1
甲菌利	jia jun li	1
荚枯病	jia ku bing	1
甲硫磷	jia liu lin	1
甲硫灭	jia liu mie	1
甲霉灵	jia mei ling	1
甲猛素	jia meng su	1
甲醚磺隆	jia mi huang long	1
甲嘧磺隆	jia mi huang long	1
荚螟	jia ming	1
甲萘威	jia nai wei	1
甲哌啶	jia pai ding	1
甲扑磷	jia pu lin	1
甲羟鎓	jia qiang weng	1
甲壳类	jia qiao lei	1
甲氰菊脂	jia qing ju zhi	1
加氢作用	jia qing zuo yong	1
夹肉面包	jia rou mian bao	1
加瑞农	jia rui nong	1
甲噻	jia sai	1
家山药	jia shan yao	1
假设测验	jia she ce yan	1
加收米	jia shou mi	1
荚数	jia shu	1
家鼠	jia shu	1
甲霜安	jia shuang an	1
甲霜灵	jia shuang ling	1
甲霜灵锰锌	jia shuang ling meng xin	1
甲霜锰锌	jia shuang meng xin	1
家庭解体	jia ting jie ti	1
家庭宴会	jia ting yan hui	1
甲维	jia wei	1
甲维盐	jia wei yan	1
加温干燥	jia wen gan zao	1
家系	jia xi	1
家系选择	jia xi xuan ze	1
甲酰脲类	jia xian niao lei	1
甲香菌酯	jia xiang jun zhi	1
加性效应	jia xing xiao ying	1
加性遗传方差	jia xing yi chuan fang cha	1
假眼小绿叶蝉	jia yan xiao lv ye chan	1
甲氧虫酰肼	jia yang chong xian jing	1
甲氧毒草胺	jia yang du cao an	1
甲氧隆	jia yang long	1
甲氧嗪磺隆	jia yang qin huang long	1
荚野螟	jia ye ming	1
加油泵	jia you beng	1
甲晕	jia yun	1
假植	jia zhi	1
夹竹桃	jia zhu tao	1
简并	jian bing	1
剪草机	jian cao ji	1
间除	jian chu	1
监督分类	jian du fen lei	1
间断分布	jian duan fen bu	1
间断性变量	jian duan xing bian liang	1
舰队街	jian dui jie	1
间隔	jian ge	1
间隔期	jian ge qi	1
坚黑粉病	jian hei fen bing	1
坚黑穗病	jian hei sui bing	1
碱化	jian hua	1
剪花架	jian hua jia	1
剑粳	jian jing	1
剑兰	jian lan	1
碱炼	jian lian	1
剑麻	jian ma	1
间密	jian mi	1
间苗	jian miao	1
间苗机	jian miao ji	1
箭舌豌豆	jian she wan dou	1
渐渗杂交	jian shen za jiao	1
碱式硫酸铜	jian shi liu suan tong	1
捡拾压捆机	jian shi ya kun ji	1
间套作	jian tao zuo	1
碱土	jian tu	1
建文皇帝	jian wen huang di	1
间歇辐照	jian xie fu zhao	1
碱性土	jian xing tu	1
剑叶病	jian ye bing	1
兼用型	jian yong xing	1
鲣鱼	jian yu	1
间种	jian zhong	1
建筑开工	jian zhu kai gong	1
建筑物正面	jian zhu wu zheng mian	1
健壮苗	jian zhuang miao	1
间作	jian zuo	1
豇豆	jiang dou	1
僵果病	jiang guo bing	1
姜弄蝶	jiang nong die	1
降湿	jiang shi	1
降水	jiang shui	1
降水强度	jiang shui qiang du	1
降水效率	jiang shui xiao lv	1
降水蒸发比	jiang shui zheng fa bi	1
江鱼	jiang yu	1
降雨持续时间	jiang yu chi xu shi jian	1
胶氨铜	jiao an tong	1
角斑病	jiao ban bing	1
焦斑病	jiao ban bing	1
交叉检查	jiao cha jian cha	1
交叉犁耕	jiao cha li geng	1
交叉侵染	jiao cha qin ran	1
交叉双臂	jiao cha shuang bi	1
交叉污染物	jiao cha wu ran wu	1
较干	jiao gan	1
角果	jiao guo	1
交互作用	jiao hu zuo yong	1
交换量	jiao huan liang	1
交换性钾	jiao huan xing jia	1
交换性盐基	jiao huan xing yan ji	1
交换子	jiao huan zi	1
交货付现	jiao huo fu xian	1
交结点	jiao jie dian	1
角蜡蚧	jiao la jie	1
胶霉素	jiao mei su	1
胶泥田	jiao ni tian	1
胶泥土	jiao ni tu	1
胶片	jiao pian	1
胶片夹	jiao pian jia	1
胶乳	jiao ru	1
搅乳器	jiao ru qi	1
较湿	jiao shi	1
浇施	jiao shi	1
交通安全岛	jiao tong an quan dao	1
交通指挥灯	jiao tong zhi hui deng	1
浇透	jiao tou	1
浇透水	jiao tou shui	1
角枭	jiao xiao	1
教学日	jiao xue ri	1
焦亚硫酸钠	jiao ya liu suan na	1
校验数位	jiao yan shu wei	1
脚掌心	jiao zhang xin	1
茭爪	jiao zhao	1
校正	jiao zheng	1
校正曲线	jiao zheng qu xian	1
脚制动器	jiao zhi dong qi	1
搅种灵	jiao zhong ling	1
捷安肽素暂定	jie an tai su zan ding	1
节本增	jie ben zeng	1
芥菜	jie cai	1
芥菜类蔬菜	jie cai lei shu cai	1
芥菜型油菜	jie cai xing you cai	1
解草安	jie cao an	1
解草啶	jie cao ding	1
解草酮	jie cao tong	1
解草烷	jie cao wan	1
解草烯	jie cao xi	1
解草唑	jie cao zuo	1
揭除	jie chu	1
街道清扫	jie dao qing sao	1
街道清扫车	jie dao qing sao che	1
介电加热	jie dian jia re	1
解冻	jie dong	1
阶段发育	jie duan fa yu	1
借方差额	jie fang cha e	1
秸秆	jie gan	1
秸秆还田	jie gan hai tian	1
接骨木	jie gu mu	1
节瓜	jie gua	1
结果肥	jie guo fei	1
结果期	jie guo qi	1
结果习性	jie guo xi xing	1
结果枝	jie guo zhi	1
结果周期性	jie guo zhou qi xing	1
洁禾金飘	jie he jin piao	1
结合态农药残留物	jie he tai nong yao can liu wu	1
结合我县实际	jie he wo xian shi ji	1
结婚宴会	jie hun yan hui	1
结荚	jie jia	1
结荚率	jie jia lv	1
结荚期	jie jia qi	1
节间	jie jian	1
拮抗	jie kang	1
拮抗体	jie kang ti	1
拮抗效应	jie kang xiao ying	1
捷马乙环唑	jie ma yi huan zuo	1
蚧螨净	jie man jing	1
揭膜	jie mo	1
节目制作者	jie mu zhi zuo zhe	1
结球	jie qiu	1
结球甘蓝	jie qiu gan lan	1
结球期	jie qiu qi	1
结球莴苣	jie qiu wo ju	1
接上离合器	jie shang li he qi	1
结实率	jie shi lv	1
结薯	jie shu	1
节水改造项目	jie shui gai zao xiang mu	1
芥酸	jie suan	1
接穗	jie sui	1
街心转盘	jie xin zhuan pan	1
截形叶螨	jie xing ye man	1
截形叶蜗	jie xing ye wo	1
接芽	jie ya	1
津奥啉	jin ao lin	1
荩草	jin cao	1
金翅雀	jin chi que	1
浸出	jin chu	1
紧凑型	jin cou xing	1
近代农业	jin dai nong ye	1
晋单	jin dan	1
金稻龙	jin dao long	1
金封异	jin feng yi	1
金光菊	jin guang ju	1
金龟甲	jin gui jia	1
金禾草星	jin he cao xing	1
金合欢树	jin he huan shu	1
金核霉素	jin he mei su	1
金琥	jin hu	1
金花菜	jin hua cai	1
近交	jin jiao	1
近交退化	jin jiao tui hua	1
近交系数	jin jiao xi shu	1
金桔	jin ju	1
金扩灭灵	jin kuo mie ling	1
金镰刀	jin lian dao	1
金莲花	jin lian hua	1
晋宁小粒豆	jin ning xiao li dou	1
金钱菊	jin qian ju	1
金钱松	jin qian song	1
近亲交配	jin qin jiao pei	1
金色狗尾草	jin se gou wei cao	1
锦熟黄杨	jin shu huang yang	1
金属托盘	jin shu tuo pan	1
金线虫病	jin xian chong bing	1
金小蜂	jin xiao feng	1
金银花	jin yin hua	1
金银木	jin yin mu	1
金鱼草	jin yu cao	1
金盏菊	jin zhan ju	1
金针菜	jin zhen cai	1
金针虫	jin zhen chong	1
金针虫类	jin zhen chong lei	1
禁止掉头	jin zhi diao tou	1
禁止刊行	jin zhi kan xing	1
禁止右转弯	jin zhi you zhuan wan	1
浸种灵	jin zhong ling	1
精氨酸	jing an suan	1
腈苯唑	jing ben zuo	1
精吡氟禾草灵	jing bi fu he cao ling	1
精骠	jing biao	1
茎部	jing bu	1
茎菜类蔬菜	jing cai lei shu cai	1
靖单	jing dan	1
粳稻	jing dao	1
茎点枯病	jing dian ku bing	1
精噁唑禾草灵	jing e zuo he cao ling	1
经费自给	jing fei zi ji	1
茎腐病	jing fu bing	1
精盖草能	jing gai cao neng	1
茎秆	jing gan	1
茎秆强度	jing gan qiang du	1
井冈霉素	jing gang mei su	1
井冈玉米素	jing gang yu mi su	1
净光合作用	jing guang he zuo yong	1
精旱作丰	jing han zuo feng	1
精禾草克	jing he cao ke	1
茎黑点病	jing hei dian bing	1
净化剂	jing hua ji	1
茎基	jing ji	1
经济波动	jing ji bo dong	1
茎基腐病	jing ji fu bing	1
经济复原	jing ji fu yuan	1
茎基宽	jing ji kuan	1
经济林果	jing ji lin guo	1
经济平衡	jing ji ping heng	1
经济渠道	jing ji qu dao	1
经济趋势	jing ji qu shi	1
经济阈值	jing ji yu zhi	1
经济允许水平	jing ji yun xu shui ping	1
经济作物	jing ji zuo wu	1
精甲霜灵	jing jia shuang ling	1
茎尖	jing jian	1
茎节	jing jie	1
茎芥菜	jing jie cai	1
敬酒歌	jing jiu ge	1
精久农业	jing jiu nong ye	1
腈菌唑	jing jun zuo	1
精克草能	jing ke cao neng	1
茎枯病	jing ku bing	1
精喹禾灵	jing kui he ling	1
精炼油	jing lian you	1
径流	jing liu	1
精隆	jing long	1
茎蔓	jing man	1
精密播种机	jing mi bo zhong ji	1
精米机	jing mi ji	1
精密计时器	jing mi ji shi qi	1
茎螟	jing ming	1
京尼平甙	jing ni ping dai	1
净哌磷	jing pai lin	1
净哌磷混剂	jing pai lin hun ji	1
精品制种	jing pin zhi zhong	1
景气衰退	jing qi shuai tui	1
景气停滞	jing qi ting zhi	1
腈杀威	jing sha wei	1
警示胶带	jing shi jiao dai	1
晶体敌百虫	jing ti di bai chong	1
茎纹病	jing wen bing	1
警纹地老虎	jing wen di lao hu	1
精稳杀得	jing wen sha de	1
腈肟磷	jing wo lin	1
茎线虫病	jing xian chong bing	1
茎象甲	jing xiang jia	1
茎叶	jing ye	1
茎叶比	jing ye bi	1
茎疫病	jing yi bing	1
经营体制	jing ying ti zhi	1
竞争能力	jing zheng neng li	1
精制油	jing zhi you	1
净种	jing zhong	1
净种灵	jing zhong ling	1
经作	jing zuo	1
经作所	jing zuo suo	1
经作站	jing zuo zhan	1
酒吧间	jiu ba jian	1
韭保净乳油	jiu bao jing ru you	1
韭菜蛆	jiu cai qu	1
韭葱	jiu cong	1
厩肥	jiu fei	1
救荒	jiu huang	1
救荒作物	jiu huang zuo wu	1
旧货店	jiu huo dian	1
酒精测定计	jiu jing ce ding ji	1
酒精指标	jiu jing zhi biao	1
韭莲	jiu lian	1
久效磷	jiu xiao lin	1
久效威	jiu xiao wei	1
久星	jiu xing	1
酒椰	jiu ye	1
厩蝇	jiu ying	1
救援车辆	jiu yuan che liang	1
局部枯斑	ju bu ku ban	1
拒虫剂	ju chong ji	1
菊敌	ju di	1
局地气候	ju di qi hou	1
锯谷盗	ju gu dao	1
聚合果	ju he guo	1
聚合杂交	ju he za jiao	1
菊花	ju hua	1
菊花瘿蚊	ju hua ying wen	1
桔黄粉虱	ju huang fen shi	1
菊苣软腐病	ju ju ruan fu bing	1
聚类	ju lei	1
聚类分析	ju lei fen xi	1
菊马	ju ma	1
菊马乳油	ju ma ru you	1
居民委员会	ju min wei yuan hui	1
巨膜长蝽	ju mo chang chun	1
菊潜叶蝇	ju qian ye ying	1
聚伞	ju san	1
聚伞花序	ju san hua xu	1
菊杀	ju sha	1
拒食胺	ju shi an	1
菊天牛	ju tian niu	1
菊小长管蚜	ju xiao chang guan ya	1
菊氧	ju yang	1
菊氧合剂	ju yang he ji	1
菊芋	ju yu	1
枸橼	ju yuan	1
菊酯	ju zhi	1
菊酯复合乳剂	ju zhi fu he ru ji	1
菊酯类	ju zhi lei	1
居住单元	ju zhu dan yuan	1
桔子酱	ju zi jiang	1
桔子水	ju zi shui	1
桔子原汁	ju zi yuan zhi	1
卷丹	juan dan	1
卷曲病	juan qu bing	1
卷缩发	juan suo fa	1
卷叶	juan ye	1
卷叶蛾	juan ye e	1
卷叶期	juan ye qi	1
蕨菜	jue cai	1
掘地生	jue di sheng	1
决定系数	jue ding xi shu	1
绝对湿度	jue dui shi du	1
掘穴机	jue xue ji	1
决议草案	jue yi cao an	1
绝育磷	jue yu lin	1
菌柄	jun bing	1
菌虫清	jun chong qing	1
君达菜果脚病	jun da cai guo jiao bing	1
菌达灭	jun da mie	1
菌袋	jun dai	1
菌毒清	jun du qing	1
均方	jun fang	1
菌盖	jun gai	1
菌根	jun gen	1
菌核病	jun he bing	1
菌核秆腐病	jun he gan fu bing	1
菌核净	jun he jing	1
菌膜	jun mo	1
君迁子	jun qian zi	1
均数	jun shu	1
菌丝体	jun si ti	1
菌条	jun tiao	1
菌物	jun wu	1
菌药	jun yao	1
卡草胺	ka cao an	1
咖啡豆象	ka fei dou xiang	1
咖啡粉蚧	ka fei fen jie	1
咖啡果小蠹	ka fei guo xiao du	1
咖啡虎天牛	ka fei hu tian niu	1
咖啡木囊蛾	ka fei mu nang e	1
咖啡潜叶蛾	ka fei qian ye e	1
咖啡枝小蠹	ka fei zhi xiao du	1
卡口灯泡	ka kou deng pao	1
卡片穿孔机	ka pian chuan kong ji	1
卡片阅读机	ka pian yue du ji	1
卡死克	ka si ke	1
卡塔普	ka ta pu	1
卡特兰	ka te lan	1
凯安保	kai an bao	1
开匙	kai chi	1
开发性农业	kai fa xing nong ye	1
开沟	kai gou	1
开沟犁	kai gou li	1
开沟压条	kai gou ya tiao	1
开花期	kai hua qi	1
凯门鳄	kai men e	1
开墒	kai shang	1
开斯明	kai si ming	1
凯素灵	kai su ling	1
开胃食品	kai wei shi pin	1
坎尔井	kan er jing	1
看麦娘	kan mai niang	1
砍青	kan qing	1
康拜因	kang bai yin	1
抗变剂	kang bian ji	1
抗变色	kang bian se	1
抗病力	kang bing li	1
抗病力强	kang bing li qiang	1
抗病力弱	kang bing li ruo	1
抗病性	kang bing xing	1
抗病性强	kang bing xing qiang	1
抗病育种	kang bing yu zhong	1
抗虫威	kang chong wei	1
抗虫性	kang chong xing	1
抗虫育种	kang chong yu zhong	1
抗倒	kang dao	1
抗倒胺	kang dao an	1
抗倒伏	kang dao fu	1
抗倒伏性	kang dao fu xing	1
抗倒性	kang dao xing	1
抗倒酯	kang dao zhi	1
抗冻	kang dong	1
抗冻能力	kang dong neng li	1
抗冻素	kang dong su	1
抗风性	kang feng xing	1
抗高温	kang gao wen	1
抗寒	kang han	1
抗寒力	kang han li	1
抗旱力强	kang han li qiang	1
抗旱力弱	kang han li ruo	1
抗寒能力	kang han neng li	1
抗寒性	kang han xing	1
抗菌霉素	kang jun mei su	1
糠菌唑	kang jun zuo	1
抗枯灵	kang ku ling	1
抗枯宁	kang ku ning	1
抗裂荚	kang lie jia	1
抗螨唑	kang man zuo	1
抗霉菌素	kang mei jun su	1
康纳馨	kang na xin	1
抗逆力	kang ni li	1
抗逆育种	kang ni yu zhong	1
抗生性	kang sheng xing	1
糠粞分离	kang xi fen li	1
抗性	kang xing	1
抗性机制	kang xing ji zhi	1
抗锈	kang xiu	1
抗血清	kang xue qing	1
抗蚜威	kang ya wei	1
抗氧剂保藏	kang yang ji bao cang	1
抗药性	kang yao xing	1
抗蝇威	kang ying wei	1
抗诱变因素	kang you bian yin su	1
抗幼烯	kang you xi	1
抗原	kang yuan	1
烤钵	kao bo	1
烤酒	kao jiu	1
考种	kao zhong	1
克百威	ke bai wei	1
壳薄	ke bo	1
克草胺	ke cao an	1
克草神	ke cao shen	1
可兑换性	ke dui huan xing	1
克多甲种衣剂	ke duo jia zhong yi ji	1
克多酮种衣剂	ke duo tong zhong yi ji	1
克多五	ke duo wu	1
克多种衣剂	ke duo zhong yi ji	1
克蛾宝	ke e bao	1
可分配总收入	ke fen pei zong shou ru	1
克福多种衣剂	ke fu duo zhong yi ji	1
克福种衣剂	ke fu zhong yi ji	1
克福唑种衣剂	ke fu zuo zhong yi ji	1
壳厚	ke hou	1
客货两用车	ke huo liang yong che	1
科技服务	ke ji fu wu	1
科技讲座	ke ji jiang zuo	1
科技培训	ke ji pei xun	1
科技特派员	ke ji te pai yuan	1
科技咨询服务	ke ji zi xun fu wu	1
克甲种衣剂	ke jia zhong yi ji	1
科教处	ke jiao chu	1
可交配性	ke jiao pei xing	1
克菌铜	ke jun tong	1
克菌壮	ke jun zhuang	1
可可树	ke ke shu	1
可可象虫	ke ke xiang chong	1
可可油	ke ke you	1
克劳优	ke lao you	1
颗粒肥	ke li fei	1
颗粒肥料	ke li fei liao	1
颗粒归仓	ke li gui cang	1
颗粒剂	ke li ji	1
颗粒杀虫剂	ke li sha chong ji	1
颗粒物料分选	ke li wu liao fen xuan	1
颗粒无收	ke li wu shou	1
克啉菌	ke lin jun	1
可灵达	ke ling da	1
克露	ke lu	1
克螨隆	ke man long	1
克螨特	ke man te	1
克灭鼠	ke mie shu	1
可能蒸散	ke neng zheng san	1
科普图书	ke pu tu shu	1
可溶性	ke rong xing	1
可杀得	ke sha de	1
可湿性	ke shi xing	1
可湿性粉剂	ke shi xing fen ji	1
棵数	ke shu	1
克霜氰	ke shuang qing	1
可调手钳	ke tiao shou qian	1
克瘟散	ke wen san	1
克瘟唑	ke wen zuo	1
克芜踪	ke wu zong	1
克线丹	ke xian dan	1
克线磷	ke xian lin	1
苛性钠	ke xing na	1
克蚜螟	ke ya ming	1
可用资产	ke yong zi chan	1
克原子	ke yuan zi	1
可再生能源	ke zai sheng neng yuan	1
可再生资源	ke zai sheng zi yuan	1
壳针孢叶枯病	ke zhen bao ye ku bing	1
棵蛛甲	ke zhu jia	1
垦殖指数	ken zhi zhi shu	1
坑洼	keng wa	1
空白试验	kong bai shi yan	1
空秕粒	kong bi li	1
空秕率	kong bi lv	1
控虫素	kong chong su	1
孔垂柱	kong chui zhu	1
控氮	kong dan	1
空秆	kong gan	1
空间隔离	kong jian ge li	1
空间数据	kong jian shu ju	1
空间信息	kong jian xin xi	1
空胫病	kong jing bing	1
孔径规	kong jing gui	1
空粒	kong li	1
控苗	kong miao	1
空气污染	kong qi wu ran	1
空腔	kong qiang	1
孔雀草	kong que cao	1
控水	kong shui	1
控田	kong tian	1
空心菜	kong xin cai	1
空心莲子草	kong xin lian zi cao	1
空心砖	kong xin zhuan	1
控制发霉	kong zhi fa mei	1
控制授粉	kong zhi shou fen	1
空中压条	kong zhong ya tiao	1
口恶霉灵	kou e mei ling	1
口恶霜灵	kou e shuang ling	1
口恶霜锰锌	kou e shuang meng xin	1
口恶酰胺	kou e xian an	1
口器	kou qi	1
枯斑	ku ban	1
苦菜锈病	ku cai xiu bing	1
库虫净	ku chong jing	1
库存量	ku cun liang	1
苦豆子总碱	ku dou zi zong jian	1
苦瓜	ku gua	1
酷极	ku ji	1
苦苣	ku ju	1
枯茗	ku ming	1
苦脑	ku nao	1
苦皮藤素	ku pi teng su	1
苦荞	ku qiao	1
苦荞麦	ku qiao mai	1
苦参碱	ku shen jian	1
苦生碱	ku sheng jian	1
苦生碱醇	ku sheng jian chun	1
苦生素	ku sheng su	1
库塘	ku tang	1
枯萎病	ku wei bing	1
枯萎宁	ku wei ning	1
枯萎盐	ku wei yan	1
枯心	ku xin	1
块根	kuai gen	1
块根播种机	kuai gen bo zhong ji	1
块根作物	kuai gen zuo wu	1
会计簿册	kuai ji bu ce	1
会计统计	kuai ji tong ji	1
块茎	kuai jing	1
块茎播种机	kuai jing bo zhong ji	1
块茎蛾	kuai jing e	1
块茎嫁接	kuai jing jia jie	1
块茎指数	kuai jing zhi shu	1
块茎作物	kuai jing zuo wu	1
块菌	kuai jun	1
快灵	kuai ling	1
快杀稗	kuai sha bai	1
快杀敌	kuai sha di	1
快杀灵	kuai sha ling	1
快杀灵二号	kuai sha ling er hao	1
块石面路	kuai shi mian lu	1
块状结构	kuai zhuang jie gou	1
款冬白绢病	kuan dong bai juan bing	1
宽皮桔	kuan pi ju	1
宽行	kuan xing	1
宽叶独行菜	kuan ye du xing cai	1
宽窄行	kuan zhai xing	1
矿质氮	kuang zhi dan	1
葵菜	kui cai	1
喹草酸	kui cao suan	1
喹恶磷	kui e lin	1
喹恶硫磷	kui e liu lin	1
喹禾灵	kui he ling	1
奎禾灵	kui he ling	1
喹菌酮	kui jun tong	1
奎菌酮	kui jun tong	1
喹啉盐	kui lin yan	1
喹硫磷	kui liu lin	1
喹螨醚	kui man mi	1
馈送	kui song	1
溃疡病	kui yang bing	1
昆布	kun bu	1
昆交会	kun jiao hui	1
昆明白皮豆	kun ming bai pi dou	1
昆攀	kun pan	1
捆束机	kun shu ji	1
醌肟腙	kun wo zong	1
昆武	kun wu	1
阔草克	kuo cao ke	1
阔草清	kuo cao qing	1
扩散系数	kuo san xi shu	1
阔莎克星	kuo sha ke xing	1
阔收	kuo shou	1
阔叶净	kuo ye jing	1
阔叶散	kuo ye san	1
拉丁方设计	la ding fang she ji	1
腊肥	la fei	1
辣根	la gen	1
辣根素	la gen su	1
喇蛄	la gu	1
垃圾处置	la ji chu zhi	1
垃圾收集工	la ji shou ji gong	1
辣椒	la jiao	1
辣椒碱	la jiao jian	1
拉美斑潜蝇	la mei ban qian ying	1
拉米豆	la mi dou	1
蜡熟	la shu	1
蜡熟末期	la shu mo qi	1
蜡熟期	la shu qi	1
拉维因	la wei yin	1
蜡质型	la zhi xing	1
蜡质芽孢杆菌	la zhi ya bao gan jun	1
蜡质状	la zhi zhuang	1
赖氨酸	lai an suan	1
来回票	lai hui piao	1
来檬	lai meng	1
来人支票	lai ren zhi piao	1
蓝矮病毒病	lan ai bing du bing	1
烂场雨	lan chang yu	1
烂根	lan gen	1
兰花苕子	lan hua shao zi	1
拦门酒	lan men jiu	1
蓝尾迷萤叶甲	lan wei mi ying ye jia	1
烂芽	lan ya	1
烂秧	lan yang	1
烂秧病	lan yang bing	1
烂种	lan zhong	1
狼毒素	lang du su	1
劳动工分	lao dong gong fen	1
劳动日值	lao dong ri zhi	1
涝害	lao hai	1
劳力波动	lao li bo dong	1
劳力成本	lao li cheng ben	1
老年谷	lao nian gu	1
老熟	lao shu	1
老鼠瓜	lao shu gua	1
老鼠牙型	lao shu ya xing	1
劳务基地	lao wu ji di	1
劳务输转	lao wu shu zhuan	1
涝渍	lao zi	1
乐戈	le ge	1
乐果	le guo	1
乐斯本	le si ben	1
乐斯灵暂定名	le si ling zan ding ming	1
雷暴	lei bao	1
类病毒	lei bing du	1
雷多米尔	lei duo mi er	1
雷公藤甲素	lei gong teng jia su	1
累进税	lei jin shui	1
累进税制	lei jin shui zhi	1
蕾期	lei qi	1
蕾期授粉	lei qi shou fen	1
蕾苔	lei tai	1
蕾薹	lei tai	1
蕾苔肥	lei tai fei	1
蕾薹肥	lei tai fei	1
蕾苔期	lei tai qi	1
冷藏库	leng cang ku	1
冷床	leng chuang	1
冷冻保藏	leng dong bao cang	1
冷冻干燥	leng dong gan zao	1
冷害	leng hai	1
棱角丝瓜	leng jiao si gua	1
冷浸田	leng jin tian	1
冷凉	leng liang	1
冷夏	leng xia	1
梨耙	li ba	1
鳢肠	li chang	1
粒大	li da	1
立刀豆	li dao dou	1
犁底层	li di ceng	1
粒肥	li fei	1
犁幅宽度	li fu kuan du	1
犁沟	li gou	1
理沟	li gou	1
离核木棉	li he mu mian	1
离合器踏板	li he qi ta ban	1
梨花网蝽	li hua wang chun	1
藜灰斑病	li hui ban bing	1
利己素	li ji su	1
篱架	li jia	1
离均差	li jun cha	1
立克除	li ke chu	1
利克菌	li ke jun	1
立克秀	li ke xiu	1
立枯病	li ku bing	1
利枯灵	li ku ling	1
利枯灭	li ku mie	1
立枯丝核菌病	li ku si he jun bing	1
丽绿刺蛾	li lv ci e	1
立苗	li miao	1
沥去	li qu	1
丽色油菜叶甲	li se you cai ye jia	1
理墒	li shang	1
立食宴会	li shi yan hui	1
利收	li shou	1
粒数	li shu	1
藜霜霉病	li shuang mei bing	1
沥水	li shui	1
利它素	li ta su	1
离体保存	li ti bao cun	1
立体间套作	li ti jian tao zuo	1
立体镜	li ti jing	1
立体农业	li ti nong ye	1
离体突变	li ti tu bian	1
离体突变发生	li ti tu bian fa sheng	1
犁田者	li tian zhe	1
粒瘟	li wen	1
理想株型	li xiang zhu xing	1
粒小	li xiao	1
梨小食心虫	li xiao shi xin chong	1
丽蚜小蜂	li ya xiao feng	1
藜叶斑病	li ye ban bing	1
利益毛额	li yi mao e	1
粒瘿线虫病	li ying xian chong bing	1
梨园蚧	li yuan jie	1
荔枝	li zhi	1
粒重	li zhong	1
李子树	li zi shu	1
联苯肼酯	lian ben jing zhi	1
联苯菊酯	lian ben ju zhi	1
联苯三唑醇	lian ben san zuo chun	1
镰刀谷	lian dao gu	1
镰刀谷型	lian dao gu xing	1
镰刀菌根腐病	lian dao jun gen fu bing	1
镰刀菌萎蔫病	lian dao jun wei nian bing	1
链格孢黑斑病	lian ge bao hei ban bing	1
链格孢叶斑病	lian ge bao ye ban bing	1
链格孢叶枯病	lian ge bao ye ku bing	1
连骨肉	lian gu rou	1
链轨式拖拉机	lian gui shi tuo la ji	1
联核木棉	lian he mu mian	1
联合收割机	lian he shou ge ji	1
莲花白	lian hua bai	1
连枷	lian jia	1
连接酶	lian jie mei	1
镰净	lian jing	1
链霉索	lian mei suo	1
炼苗	lian miao	1
连片	lian pian	1
连晴	lian qing	1
楝素	lian su	1
联体病毒	lian ti bing du	1
连阴雨	lian yin yu	1
鲢鱼	lian yu	1
连作	lian zuo	1
莲座期	lian zuo qi	1
晾曝	liang bao	1
粮仓	liang cang	1
两次曝光	liang ci bao guang	1
两丛	liang cong	1
亮蓟马	liang ji ma	1
粮经饲比例	liang jing si bi li	1
凉米	liang mi	1
凉晒	liang shai	1
粮食产量	liang shi chan liang	1
粮食局	liang shi ju	1
粮食面积	liang shi mian ji	1
粮食年度	liang shi nian du	1
粮食三定	liang shi san ding	1
粮食四统一	liang shi si tong yi	1
粮食统购统销	liang shi tong gou tong xiao	1
粮食议购议销	liang shi yi gou yi xiao	1
粮食增产	liang shi zeng chan	1
粮食征购	liang shi zheng gou	1
粮食征购基数	liang shi zheng gou ji shu	1
粮食直补资金	liang shi zhi bu zi jin	1
粮食作物	liang shi zuo wu	1
两熟	liang shu	1
凉薯	liang shu	1
量水坝	liang shui ba	1
量水槽	liang shui cao	1
量水堰	liang shui yan	1
两塘	liang tang	1
晾田	liang tian	1
量天尺炭疽病	liang tian chi tan ju bing	1
良种繁殖场	liang zhong fan zhi chang	1
两株	liang zhu	1
粮作	liang zuo	1
粮作所	liang zuo suo	1
辽单	liao dan	1
撂荒地	liao huang di	1
猎蝽	lie chun	1
列当	lie dang	1
裂区设计	lie qu she ji	1
列入议程	lie ru yi cheng	1
鬣蜥	lie xi	1
临奥	lin ao	1
邻苯基苯酚	lin ben ji ben fen	1
邻苯基苯酚钠	lin ben ji ben fen na	1
磷肥	lin fei	1
林果	lin guo	1
磷化铝	lin hua lv	1
磷化镁	lin hua mei	1
磷化锌	lin hua xin	1
磷钾	lin jia	1
邻甲氧基酚	lin jia yang ji fen	1
临界期	lin jie qi	1
临界生长期	lin jie sheng zhang qi	1
临界湿度	lin jie shi du	1
临界昼长	lin jie zhou chang	1
磷矿粉	lin kuang fen	1
磷硫威	lin liu wei	1
淋滤	lin lv	1
临麦	lin mai	1
林木病虫害	lin mu bing chong hai	1
林木生长量	lin mu sheng zhang liang	1
淋溶	lin rong	1
林麝	lin she	1
淋失	lin shi	1
临时登记证	lin shi deng ji zheng	1
临时收购	lin shi shou gou	1
临时证件	lin shi zheng jian	1
临时主席	lin shi zhu xi	1
磷酸二氢钾	lin suan er qing jia	1
磷酸盐	lin suan yan	1
膦酸乙酯铝	lin suan yi zhi lv	1
淋窝	lin wo	1
淋洗	lin xi	1
邻烯丙基苯酚	lin xi bing ji ben fen	1
淋洗定额	lin xi ding e	1
邻酰胺	lin xian an	1
磷亚威	lin ya wei	1
林业产业	lin ye chan ye	1
林业基金	lin ye ji jin	1
领办	ling ban	1
领导挂项	ling dao gua xiang	1
另丁津	ling ding jin	1
灵福	ling fu	1
零假设	ling jia she	1
令箭荷花	ling jian he hua	1
铃兰	ling lan	1
凌霄	ling xiao	1
铃行法	ling xing fa	1
铃行试验	ling xing shi yan	1
柳蝙蛾	liu bian e	1
硫丙磷	liu bing lin	1
硫虫畏	liu chong wei	1
留存现金	liu cun xian jin	1
硫甙	liu dai	1
硫代碳酸钠	liu dai tan suan na	1
硫丹	liu dan	1
流动债务	liu dong zhai wu	1
硫氟肟醚	liu fu wo mi	1
流化床干燥	liu hua chuang gan zao	1
硫环磷	liu huan lin	1
流胶病	liu jiao bing	1
硫菌灵	liu jun ling	1
柳蓝叶甲	liu lan ye jia	1
六氯苯	liu lv ben	1
硫氯散	liu lv san	1
硫醚磷	liu mi lin	1
留苗	liu miao	1
硫氰	liu qing	1
硫氰苯噻	liu qing ben sai	1
柳杉	liu shan	1
硫双灭多威	liu shuang mie duo wei	1
硫双威	liu shuang wei	1
硫酸铵	liu suan an	1
硫酸钾	liu suan jia	1
硫酸铜	liu suan tong	1
硫酸铜钙	liu suan tong gai	1
硫酸锌	liu suan xin	1
流通服务	liu tong fu wu	1
硫肟醚	liu wo mi	1
留稀	liu xi	1
硫线磷	liu xian lin	1
瘤胸材小蠹	liu xiong cai xiao du	1
浏阳霉素	liu yang mei su	1
硫乙草灭	liu yi cao mie	1
隆草特	long cao te	1
龙船花	long chuan hua	1
隆大拿	long da na	1
龙旦	long dan	1
垄耕	long geng	1
砻谷	long gu	1
砻谷机	long gu ji	1
龙克菌	long ke jun	1
龙葵	long kui	1
笼内释放	long nei shi fang	1
龙舌兰	long she lan	1
龙头企业建设	long tou qi ye jian she	1
龙须牡丹	long xu mu dan	1
龙爪花	long zhao hua	1
隆重开会	long zhong kai hui	1
漏播	lou bo	1
搂草机	lou cao ji	1
蝼蛄	lou gu	1
蝼蛄类	lou gu lei	1
楼梯栏杆	lou ti lan gan	1
路单	lu dan	1
鲁单	lu dan	1
陆稻	lu dao	1
露地	lu di	1
陆地棉	lu di mian	1
陆地生态系统	lu di sheng tai xi tong	1
陆地卫星	lu di wei xing	1
露地栽培	lu di zai pei	1
芦荟	lu hui	1
鲁棉	lu mian	1
路面狭窄	lu mian xia zhai	1
露泥	lu ni	1
芦粟	lu su	1
露田	lu tian	1
露土	lu tu	1
露尾甲	lu wei jia	1
录音合成	lu yin he cheng	1
露营车	lu ying che	1
卵孵	luan fu	1
卵孵高峰	luan fu gao feng	1
卵孵化	luan fu hua	1
卵寄生物	luan ji sheng wu	1
卵菌	luan jun	1
卵形瓶	luan xing ping	1
略扁	lue bian	1
轮毂罩	lun gu zhao	1
轮回亲本	lun hui qin ben	1
轮回选择	lun hui xuan ze	1
轮式拖拉机	lun shi tuo la ji	1
轮胎气压	lun tai qi ya	1
轮纹病	lun wen bing	1
轮歇地	lun xie di	1
轮休地	lun xiu di	1
轮作	lun zuo	1
轮作顺序	lun zuo shun xu	1
轮作周期	lun zuo zhou qi	1
络氨铜	luo an tong	1
络氨铜锌	luo an tong xin	1
罗宾根蜗	luo bin gen wo	1
萝卜地种蝇	luo bo di zhong ying	1
罗布麻	luo bu ma	1
落草胺	luo cao an	1
螺虫乙酯	luo chong yi zhi	1
裸大麦	luo da mai	1
裸大麦粉	luo da mai fen	1
罗达普	luo da pu	1
罗尔斯罗伊斯	luo er si luo yi si	1
罗浮	luo fu	1
落干	luo gan	1
落果	luo guo	1
落花	luo hua	1
落黄	luo huang	1
落荚	luo jia	1
罗口灯泡	luo kou deng pao	1
落葵	luo kui	1
落葵紫斑病	luo kui zi ban bing	1
罗勒	luo le	1
落蕾	luo lei	1
落粒	luo li	1
落粒数	luo li shu	1
螺螨酯	luo man zhi	1
螺丝菜	luo si cai	1
罗素发	luo su fa	1
裸土	luo tu	1
罗望子	luo wang zi	1
罗婺	luo wu	1
罗婺部	luo wu bu	1
罗婺故土	luo wu gu tu	1
罗婺文化	luo wu wen hua	1
罗婺彝寨	luo wu yi zhai	1
罗婺彝族	luo wu yi zu	1
落下灰	luo xia hui	1
裸燕麦	luo yan mai	1
落叶果树	luo ye guo shu	1
落叶松	luo ye song	1
落羽杉	luo yu shan	1
氯胺磷	lv an lin	1
氯苯胺灵	lv ben an ling	1
氯苯嘧啶醇	lv ben mi ding chun	1
氯苯肟唑建议	lv ben wo zuo jian yi	1
氯吡硫磷	lv bi liu lin	1
绿菜花	lv cai hua	1
律草	lv cao	1
绿草定	lv cao ding	1
绿翅脊萤叶甲	lv chi ji ying ye jia	1
氯虫苯甲酰胺	lv chong ben jia xian an	1
氯虫酰肼	lv chong xian jing	1
氯丹	lv dan	1
氯啶菌酯	lv ding jun zhi	1
绿豆	lv dou	1
绿豆象	lv dou xiang	1
绿度值	lv du zhi	1
绿肥	lv fei	1
绿肥作物	lv fei zuo wu	1
绿丰	lv feng	1
氯氟吡氧乙酸	lv fu bi yang yi suan	1
氯氟草除	lv fu cao chu	1
氯氟氰菊酯	lv fu qing ju zhi	1
滤光片	lv guang pian	1
氯化铵	lv hua an	1
氯化钾	lv hua jia	1
氯磺隆	lv huang long	1
绿黄隆	lv huang long	1
绿磺隆	lv huang long	1
绿僵菌	lv jiang jun	1
氯菊辛	lv ju xin	1
氯菊酯	lv ju zhi	1
旅客席	lv ke xi	1
绿鳞象甲	lv lin xiang jia	1
氯硫磷	lv liu lin	1
驴骡	lv luo	1
氯马	lv ma	1
绿麦隆	lv mai long	1
氯螨	lv man	1
绿盲蝽	lv mang chun	1
氯嘧磺隆	lv mi huang long	1
氯脲杀	lv niao sha	1
绿萍	lv ping	1
氯氰菊酯	lv qing ju zhi	1
氯噻啉	lv sai lin	1
绿三角农业	lv san jiao nong ye	1
绿色明珠	lv se ming zhu	1
绿色证书	lv se zheng shu	1
氯杀螨	lv sha man	1
氯鼠酮	lv shu tong	1
绿尾大蚕蛾	lv wei da can e	1
氯硝酚	lv xiao fen	1
氯硝萘	lv xiao nai	1
氯硝散	lv xiao san	1
绿新菊酯	lv xin ju zhi	1
绿秀隆	lv xiu long	1
氯溴异氰尿酸	lv xiu yi qing niao suan	1
氯亚胺硫磷	lv ya an liu lin	1
绿叶菜和生食叶菜类	lv ye cai he sheng shi ye cai lei	1
绿叶豆	lv ye dou	1
绿叶宁	lv ye ning	1
氯藻胺	lv zao an	1
绿洲	lv zhou	1
氯唑磷	lv zuo lin	1
马齿苋	ma chi xian	1
马齿型	ma chi xing	1
麻豆秧	ma dou yang	1
马尔萨斯主义	ma er sa si zhu yi	1
马耳他热	ma er ta re	1
马蜂橙	ma feng cheng	1
马甲乳剂	ma jia ru ji	1
马椒	ma jiao	1
吗菌威	ma jun wei	1
麻壳	ma ke	1
马拉硫磷	ma la liu lin	1
麻类	ma lei	1
麻类加工工艺	ma lei jia gong gong yi	1
麻类所	ma lei suo	1
麻类研究所	ma lei yan jiu suo	1
麻类作物	ma lei zuo wu	1
马联苯	ma lian ben	1
马蔺	ma lin	1
马蔺锈病	ma lin xiu bing	1
马铃薯	ma ling shu	1
马铃薯甲虫	ma ling shu jia chong	1
马铃薯块茎蛾	ma ling shu kuai jing e	1
马铃薯泥	ma ling shu ni	1
马铃薯全粉	ma ling shu quan fen	1
马铃薯收割机	ma ling shu shou ge ji	1
马铃薯挖掘机	ma ling shu wa jue ji	1
马铃薯晚疫病	ma ling shu wan yi bing	1
马骡	ma luo	1
马尼拉麻	ma ni la ma	1
马扑立克	ma pu li ke	1
马唐	ma tang	1
马蹄	ma ti	1
马提尼酒	ma ti ni jiu	1
马尾松毛虫	ma wei song mao chong	1
马歇特	ma xie te	1
麻业科技	ma ye ke ji	1
马缨杜鹃	ma ying du juan	1
马樱花	ma ying hua	1
麻早谷	ma zao gu	1
麻早谷型	ma zao gu xing	1
麻渣谷	ma zha gu	1
麻渣谷型	ma zha gu xing	1
麦凹胫跳甲	mai ao jing tiao jia	1
麦病净	mai bing jing	1
麦长管蚜	mai chang guan ya	1
脉冲幅度分析仪	mai chong fu du fen xi yi	1
麦地	mai di	1
麦堆	mai dui	1
麦蛾	mai e	1
麦二叉蚜	mai er cha ya	1
麦秆菊	mai gan ju	1
麦秆蝇	mai gan ying	1
麦根蝽象	mai gen chun xiang	1
麦黑斑潜叶蝇	mai hei ban qian ye ying	1
麦红吸浆虫	mai hong xi jiang chong	1
麦黄隆	mai huang long	1
麦黄吸浆虫	mai huang xi jiang chong	1
麦角	mai jiao	1
麦角病	mai jiao bing	1
麦茎蜂	mai jing feng	1
麦茎谷峨	mai jing gu e	1
麦区	mai qu	1
麦双尾蚜	mai shuang wei ya	1
麦水蝇	mai shui ying	1
麦穗宁	mai sui ning	1
麦穗夜峨	mai sui ye e	1
麦喜禾	mai xi he	1
麦芽	mai ya	1
麦蚜	mai ya	1
麦蜘蛛	mai zhi zhu	1
麦种蝇	mai zhong ying	1
螨胺磷	man an lin	1
蔓草磷	man cao lin	1
蔓长	man chang	1
满虫素	man chong su	1
螨代治	man dai zhi	1
漫灌	man guan	1
慢化	man hua	1
满江红	man jiang hong	1
螨克	man ke	1
螨死净	man si jing	1
慢速渗滤系统	man su shen lv xi tong	1
曼陀罗	man tuo luo	1
螨完锡	man wan xi	1
慢性辐照	man xing fu zhao	1
慢性伤害	man xing shang hai	1
镘子	man zi	1
芒蝇	mang ying	1
芒种	mang zhong	1
毛茶	mao cha	1
毛虫	mao chong	1
毛瓜	mao gua	1
毛管	mao guan	1
毛管传导度	mao guan chuan dao du	1
毛管孔	mao guan kong	1
毛管力	mao guan li	1
毛管容量	mao guan rong liang	1
毛管上限	mao guan shang xian	1
毛管势	mao guan shi	1
毛管水	mao guan shui	1
毛胫夜娥	mao jing ye e	1
毛块石	mao kuai shi	1
毛青	mao qing	1
毛渠	mao qu	1
茂叶宁	mao ye ning	1
毛叶秋海棠	mao ye qiu hai tang	1
毛叶苕子	mao ye shao zi	1
毛樱桃	mao ying tao	1
毛油	mao you	1
每百克	mei bai ke	1
每苞	mei bao	1
霉病	mei bing	1
每丛	mei cong	1
霉点病	mei dian bing	1
镁肥	mei fei	1
每分钟衰变	mei fen zhong shuai bian	1
美割	mei ge	1
酶工程	mei gong cheng	1
玫瑰	mei gui	1
玫瑰巾夜蛾	mei gui jin ye e	1
美国白蛾	mei guo bai e	1
美国硼砂集团	mei guo peng sha ji tuan	1
美国氰胺公司	mei guo qing an gong si	1
美国石竹	mei guo shi zhu	1
美国梧桐	mei guo wu tong	1
每荚	mei jia	1
霉菌	mei jun	1
霉菌灵	mei jun ling	1
每棵	mei ke	1
酶联免疫吸收分析	mei lian mian yi xi shou fen xi	1
霉能灵	mei neng ling	1
每千克	mei qian ke	1
美人蕉	mei ren jiao	1
每市斤	mei shi jin	1
每十克	mei shi ke	1
美术设计员	mei shu she ji yuan	1
每穗	mei sui	1
每塘	mei tang	1
煤纹病	mei wen bing	1
每窝	mei wo	1
每穴	mei xue	1
每枝	mei zhi	1
美洲斑潜蝇	mei zhou ban qian ying	1
美洲鳄	mei zhou e	1
美洲腹蛇	mei zhou fu she	1
美洲李	mei zhou li	1
美洲南瓜	mei zhou nan gua	1
美洲葡萄	mei zhou pu tao	1
美洲野牛	mei zhou ye niu	1
每株	mei zhu	1
梅子树	mei zi shu	1
糜子吸浆虫	mei zi xi jiang chong	1
闷种	men zhong	1
猛捕因	meng bu yin	1
蒙古土象	meng gu tu xiang	1
锰克磷	meng ke lin	1
猛农	meng nong	1
猛杀威	meng sha wei	1
萌芽期	meng ya qi	1
萌枝	meng zhi	1
醚苯磺隆	mi ben huang long	1
米扁虫	mi bian chong	1
咪草烟	mi cao yan	1
咪草酯	mi cao zhi	1
密达	mi da	1
嘧啶醇	mi ding chun	1
嘧啶磷	mi ding lin	1
嘧啶威	mi ding wei	1
嘧啶氧磷	mi ding yang lin	1
密度分割	mi du fen ge	1
密度制约因子	mi du zhi yue yin zi	1
糜疯病	mi feng bing	1
密花石斛	mi hua shi hu	1
醚黄隆	mi huang long	1
醚磺隆	mi huang long	1
嘧黄隆	mi huang long	1
醚菊酯	mi ju zhi	1
嘧菌胺	mi jun an	1
嘧菌环胺	mi jun huan an	1
咪菌腈	mi jun jing	1
嘧菌脲	mi jun niao	1
醚菌酯	mi jun zhi	1
嘧菌酯	mi jun zhi	1
米糠	mi kang	1
米糠油	mi kang you	1
米拉洋芋	mi la yang yu	1
米乐尔	mi le er	1
米螨	mi man	1
米满	mi man	1
嘧螨酯	mi man zhi	1
秘密会议	mi mi hui yi	1
迷你薯	mi ni shu	1
密穗	mi sui	1
蜜穗病	mi sui bing	1
密穗小麦	mi sui xiao mai	1
嘧肽霉素	mi tai mei su	1
弥雾机	mi wu ji	1
蜜腺	mi xian	1
咪鲜胺	mi xian an	1
咪鲜安	mi xian an	1
咪鲜胺锰盐	mi xian an meng yan	1
米象	mi xiang	1
米蚜胺	mi ya an	1
蜜源植物	mi yuan zhi wu	1
密植	mi zhi	1
咪唑喹啉酸	mi zuo kui lin suan	1
咪唑霉	mi zuo mei	1
咪唑乙烟酸	mi zuo yi yan suan	1
棉安磷	mian an lin	1
面包心	mian bao xin	1
棉大卷叶螟	mian da juan ye ming	1
面粉处理	mian fen chu li	1
面粉加工	mian fen jia gong	1
免耕	mian geng	1
免耕法	mian geng fa	1
缅桂	mian gui	1
棉果威	mian guo wei	1
棉红铃虫	mian hong ling chong	1
棉红蜘蛛	mian hong zhi zhu	1
棉华	mian hua	1
棉铃	mian ling	1
棉铃虫	mian ling chong	1
棉铃威	mian ling wei	1
棉隆	mian long	1
棉盲蝽	mian mang chun	1
绵毛酸模叶蓼	mian mao suan mo ye liao	1
棉绒	mian rong	1
棉萎丹	mian wei dan	1
棉萎灵	mian wei ling	1
棉小造桥虫	mian xiao zao qiao chong	1
棉蚜	mian ya	1
绵蚜	mian ya	1
棉叶蝉	mian ye chan	1
棉叶螨	mian ye man	1
免疫	mian yi	1
免疫密度	mian yi mi du	1
免疫性	mian yi xing	1
面源	mian yuan	1
面源污染	mian yuan wu ran	1
棉籽壳	mian zi ke	1
棉籽油	mian zi you	1
苗床	miao chuang	1
苗肥	miao fei	1
苗核病	miao he bing	1
苗棵	miao ke	1
苗枯病	miao ku bing	1
苗立枯病	miao li ku bing	1
苗龄	miao ling	1
苗齐	miao qi	1
苗期	miao qi	1
苗全	miao quan	1
苗弱	miao ruo	1
苗势	miao shi	1
苗数	miao shu	1
苗虅	miao teng	1
苗体	miao ti	1
苗旺	miao wang	1
苗小	miao xiao	1
苗匀	miao yun	1
苗壮	miao zhuang	1
灭白可	mie bai ke	1
灭百可	mie bai ke	1
灭病威	mie bing wei	1
灭草敌	mie cao di	1
灭草环	mie cao huan	1
灭草荒	mie cao huang	1
灭草喹	mie cao kui	1
灭草猛	mie cao meng	1
灭草松	mie cao song	1
灭草特	mie cao te	1
灭草烟	mie cao yan	1
灭茬	mie cha	1
灭茬犁	mie cha li	1
灭虫精	mie chong jing	1
灭虫灵丰果	mie chong ling feng guo	1
灭虫隆	mie chong long	1
灭除威	mie chu wei	1
灭多威	mie duo wei	1
灭尔锌	mie er xin	1
灭害威	mie hai wei	1
灭蚧	mie jie	1
灭菌	mie jun	1
灭菌方	mie jun fang	1
灭菌磷	mie jun lin	1
灭菌铜	mie jun tong	1
灭菌唑	mie jun zuo	1
灭克磷	mie ke lin	1
灭铃皇	mie ling huang	1
灭螨灵	mie man ling	1
灭螨特	mie man te	1
灭扑威	mie pu wei	1
灭扫利	mie sao li	1
灭杀毙	mie sha bi	1
灭鼠安	mie shu an	1
灭鼠腈	mie shu jing	1
灭鼠优	mie shu you	1
灭霜灵	mie shuang ling	1
灭梭威	mie suo wei	1
灭瘟素	mie wen su	1
灭瘟唑	mie wen zuo	1
灭蜗灵	mie wo ling	1
灭线磷	mie xian lin	1
灭锈胺	mie xiu an	1
灭蚜蜱	mie ya pi	1
灭蚁灵	mie yi ling	1
灭蝇胺	mie ying an	1
灭蝇磷	mie ying lin	1
灭莠津	mie you jin	1
灭幼脲	mie you niao	1
灭幼脲二号	mie you niao er hao	1
灭幼脲三号	mie you niao san hao	1
灭幼脲一号	mie you niao yi hao	1
灭幼唑	mie you zuo	1
灭藻醌	mie zao kun	1
灭蛀磷	mie zhu lin	1
敏感作物	min gan zuo wu	1
民情恳谈	min qing ken tan	1
民俗学家	min su xue jia	1
民族志	min zu zhi	1
明沟	ming gou	1
明惠帝	ming hui di	1
螟铃特	ming ling te	1
螟蛉畏	ming ling wei	1
名特优商品	ming te you shang pin	1
莫比朗	mo bi lang	1
抹除	mo chu	1
耱地	mo di	1
磨粉机	mo fen ji	1
抹灰工	mo hui gong	1
膜技术	mo ji shu	1
茉莉	mo li	1
模拟计算机	mo ni ji suan ji	1
磨砂灯泡	mo sha deng pao	1
墨水池	mo shui chi	1
膜质	mo zhi	1
母本	mu ben	1
木本油料	mu ben you liao	1
木菠萝	mu bo luo	1
牧草胺	mu cao an	1
牧草基地	mu cao ji di	1
牧草研究中心	mu cao yan jiu zhong xin	1
牧场工人	mu chang gong ren	1
牧场主	mu chang zhu	1
母畜生产周期	mu chu sheng chan zhou qi	1
母畜数量	mu chu shu liang	1
木蠹娥	mu du e	1
木耳菜	mu er cai	1
木腐菌	mu fu jun	1
木槿	mu jin	1
木兰	mu lan	1
木麻黄	mu ma huang	1
木莓	mu mei	1
木霉菌	mu mei jun	1
亩施	mu shi	1
木虱	mu shi	1
目视解译	mu shi jie yi	1
目视判读	mu shi pan du	1
木薯	mu shu	1
钼酸铵	mu suan an	1
钼酸钾	mu suan jia	1
木髓	mu sui	1
木条地板	mu tiao di ban	1
木纹石	mu wen shi	1
木樨	mu xi	1
木香	mu xiang	1
苜蓿	mu xu	1
木烟碱	mu yan jian	1
母羊	mu yang	1
亩用	mu yong	1
亩栽	mu zai	1
亩增	mu zeng	1
亩植	mu zhi	1
木质部	mu zhi bu	1
木质素	mu zhi su	1
拇指腕掌	mu zhi wan zhang	1
亩株数	mu zhu shu	1
拿捕净	na bu jing	1
纳他霉素	na ta mei su	1
萘氨磷	nai an lin	1
萘丙酰草胺	nai bing xian cao an	1
耐病性	nai bing xing	1
耐虫	nai chong	1
耐虫害性	nai chong hai xing	1
耐储运	nai chu yun	1
耐肥	nai fei	1
耐肥力	nai fei li	1
耐寒	nai han	1
耐旱	nai han	1
耐寒力强	nai han li qiang	1
耐寒力弱	nai han li ruo	1
耐寒蔬菜	nai han shu cai	1
耐旱作物	nai han zuo wu	1
耐瘠	nai ji	1
耐碱性	nai jian xing	1
耐涝	nai lao	1
耐涝作物	nai lao zuo wu	1
耐密	nai mi	1
耐密型	nai mi xing	1
奶牛场	nai niu chang	1
耐热蔬菜	nai re shu cai	1
耐热性	nai re xing	1
耐湿	nai shi	1
耐湿性	nai shi xing	1
耐性作物	nai xing zuo wu	1
耐盐	nai yan	1
耐盐性	nai yan xing	1
耐盐作物	nai yan zuo wu	1
萘氧丙草胺	nai yang bing cao an	1
奶油分离器	nai you fen li qi	1
耐贮藏	nai zhu cang	1
耐贮运	nai zhu yun	1
耐渍	nai zi	1
耐渍性	nai zi xing	1
男盥洗室	nan guan xi shi	1
南涧县	nan jian xian	1
南抗	nan kang	1
南美斑潜蝇	nan mei ban qian ying	1
南美栗鼠	nan mei li shu	1
南农	nan nong	1
南天竹	nan tian zhu	1
囊地鼠	nang di shu	1
囊肿线虫	nang zhong xian chong	1
囊肿线虫病	nang zhong xian chong bing	1
闹羊花素	nao yang hua su	1
内处理	nei chu li	1
内含子	nei han zi	1
内寄生物	nei ji sheng wu	1
内融合	nei rong he	1
内吸磷	nei xi lin	1
内吸杀虫剂	nei xi sha chong ji	1
内置版	nei zhi ban	1
嫩脆	nen cui	1
嫩果	nen guo	1
嫩葫芦	nen hu lu	1
嫩荚	nen jia	1
嫩茎叶	nen jing ye	1
嫩梢	nen shao	1
嫩穗	nen sui	1
能繁母畜	neng fan mu chu	1
能流物流分析	neng liu wu liu fen xi	1
能源建设	neng yuan jian she	1
逆辐射	ni fu she	1
逆光照	ni guang zhao	1
拟猎蝽	ni lie chun	1
拟菱	ni ling	1
尼索朗	ni suo lang	1
尼所螨醇	ni suo man chun	1
泥炭土	ni tan tu	1
逆温	ni wen	1
逆温层	ni wen ceng	1
逆转录酶	ni zhuan lu mei	1
粘虫	nian chong	1
黏稻	nian dao	1
年降水量	nian jiang shui liang	1
年较差	nian jiao cha	1
年景预报	nian jing yu bao	1
粘菌	nian jun	1
碾米	nian mi	1
碾米机	nian mi ji	1
碾磨	nian mo	1
粘土	nian tu	1
年种植	nian zhong zhi	1
酿酒葡萄	niang jiu pu tao	1
鸟巢蕨	niao chao jue	1
鸟蛤	niao ge	1
啮齿类	nie chi lei	1
蘖数	nie shu	1
蹑足而行	nie zu er xing	1
柠檬酸铜	ning meng suan tong	1
柠檬原汁	ning meng yuan zhi	1
宁南霉素	ning nan mei su	1
牛轭湖	niu e hu	1
牛儿苗	niu er miao	1
牛肝菌	niu gan jun	1
牛干菌	niu gan jun	1
牛脊肉	niu ji rou	1
牛角寨	niu jiao zhai	1
牛筋草	niu jin cao	1
牛毛毡	niu mao zhan	1
牛奶金桔	niu nai jin ju	1
牛肉干巴	niu rou gan ba	1
牛肉干巴厂	niu rou gan ba chang	1
牛蝇威	niu ying wei	1
农安磷	nong an lin	1
农残	nong can	1
农产品	nong chan pin	1
农产品加工	nong chan pin jia gong	1
农产品派购	nong chan pin pai gou	1
农产品商品量	nong chan pin shang pin liang	1
农产品商品率	nong chan pin shang pin lv	1
农产品收购	nong chan pin shou gou	1
农产品统购	nong chan pin tong gou	1
农产品议购	nong chan pin yi gou	1
农产品征购	nong chan pin zheng gou	1
农场短工	nong chang duan gong	1
农场工人	nong chang gong ren	1
农虫威	nong chong wei	1
农村产业结构	nong cun chan ye jie gou	1
农村电气化	nong cun dian qi hua	1
农村工业化	nong cun gong ye hua	1
农村工作会议	nong cun gong zuo hui yi	1
农村雇工	nong cun gu gong	1
农村雇工经营	nong cun gu gong jing ying	1
农村合作经济	nong cun he zuo jing ji	1
农村环境	nong cun huan jing	1
农村基层	nong cun ji ceng	1
农村经济	nong cun jing ji	1
农村能源	nong cun neng yuan	1
农村能源建设	nong cun neng yuan jian she	1
农村迁徙	nong cun qian xi	1
农村人口	nong cun ren kou	1
农村人民公社	nong cun ren min gong she	1
农村社会事业	nong cun she hui shi ye	1
农村消费	nong cun xiao fei	1
农村饮水安全	nong cun yin shui an quan	1
农村沼气	nong cun zhao qi	1
农村重点户	nong cun zhong dian hu	1
农村专业户	nong cun zhuan ye hu	1
农达	nong da	1
农得时	nong de shi	1
农地乐	nong di le	1
农福种衣剂	nong fu zhong yi ji	1
农工联合企业	nong gong lian he qi ye	1
农工一体化	nong gong yi ti hua	1
农广校	nong guang xiao	1
农户数	nong hu shu	1
农环站	nong huan zhan	1
农机更新	nong ji geng xin	1
农机工业	nong ji gong ye	1
农机管理处	nong ji guan li chu	1
农机化学校	nong ji hua xue xiao	1
农机监理站	nong ji jian li zhan	1
农机具	nong ji ju	1
农机具购置补贴政策	nong ji ju gou zhi bu tie zheng ce	1
农机配备	nong ji pei bei	1
农机设备	nong ji she bei	1
农技推广	nong ji tui guang	1
农技推广体系	nong ji tui guang ti xi	1
农机推广站	nong ji tui guang zhan	1
农技中心	nong ji zhong xin	1
农家宝	nong jia bao	1
农家肥	nong jia fei	1
农建站	nong jian zhan	1
农经	nong jing	1
农经站	nong jing zhan	1
农具房	nong ju fang	1
农抗	nong kang	1
农科所	nong ke suo	1
农科院	nong ke yuan	1
农口	nong kou	1
浓利磷	nong li lin	1
农螨丹	nong man dan	1
农美利	nong mei li	1
农民经纪人	nong min jing ji ren	1
农民利益	nong min li yi	1
农民培训	nong min pei xun	1
农民群众	nong min qun zhong	1
农民收入	nong min shou ru	1
农民素质	nong min su zhi	1
农民增收	nong min zeng shou	1
农牧产品	nong mu chan pin	1
农牛	nong niu	1
农牛粉剂	nong niu fen ji	1
农朋友	nong peng you	1
农情	nong qing	1
农情信息	nong qing xin xi	1
农渠	nong qu	1
农事	nong shi	1
农使友	nong shi you	1
农思	nong si	1
农思它	nong si ta	1
农特产品	nong te chan pin	1
农田防护林	nong tian fang hu lin	1
农田害鼠	nong tian hai shu	1
农田基本建设	nong tian ji ben jian she	1
农田建设	nong tian jian she	1
农田林网	nong tian lin wang	1
农田生态系统	nong tian sheng tai xi tong	1
农田鼠害	nong tian shu hai	1
农田小气候	nong tian xiao qi hou	1
农田蜘蛛	nong tian zhi zhu	1
农田作业机具	nong tian zuo ye ji ju	1
农推中心	nong tui zhong xin	1
农旺	nong wang	1
浓香	nong xiang	1
农休	nong xiu	1
农学	nong xue	1
农学家	nong xue jia	1
农学系	nong xue xi	1
农学专业	nong xue zhuan ye	1
农学专业词汇	nong xue zhuan ye ci hui	1
农药残留	nong yao can liu	1
农药化工	nong yao hua gong	1
农药化验	nong yao hua yan	1
农药检定所	nong yao jian ding suo	1
农药监督管理	nong yao jian du guan li	1
农药类别	nong yao lei bie	1
农药品种	nong yao pin zhong	1
农药审定	nong yao shen ding	1
农药审批	nong yao shen pi	1
农药污染	nong yao wu ran	1
农药制造	nong yao zhi zao	1
农业半机械化	nong ye ban ji xie hua	1
农业拨款	nong ye bo kuan	1
农业部	nong ye bu	1
农业布局	nong ye bu ju	1
农业部落	nong ye bu luo	1
农业部门经济	nong ye bu men jing ji	1
农业产量预测系统	nong ye chan liang yu ce xi tong	1
农业产业	nong ye chan ye	1
农业产业化	nong ye chan ye hua	1
农业粗放经营	nong ye cu fang jing ying	1
农业单一经营	nong ye dan yi jing ying	1
农业地理学	nong ye di li xue	1
农业地形气候学	nong ye di xing qi hou xue	1
农业电气化	nong ye dian qi hua	1
农业多种经营	nong ye duo zhong jing ying	1
农业发展	nong ye fa zhan	1
农业发展模式	nong ye fa zhan mo shi	1
农业发展战略	nong ye fa zhan zhan lue	1
农业废弃物处理	nong ye fei qi wu chu li	1
农业工程	nong ye gong cheng	1
农业管理体制	nong ye guan li ti zhi	1
农业关联产业	nong ye guan lian chan ye	1
农业规划	nong ye gui hua	1
农业害虫	nong ye hai chong	1
农业化学	nong ye hua xue	1
农业化学化	nong ye hua xue hua	1
农业环境保护	nong ye huan jing bao hu	1
农业环境监测	nong ye huan jing jian ce	1
农业机器人	nong ye ji qi ren	1
农业机器系统	nong ye ji qi xi tong	1
农业技术	nong ye ji shu	1
农业技术措施	nong ye ji shu cuo shi	1
农业技术革新	nong ye ji shu ge xin	1
农业技术推广	nong ye ji shu tui guang	1
农业机械化	nong ye ji xie hua	1
农业机械化规划	nong ye ji xie hua gui hua	1
农业集约经营	nong ye ji yue jing ying	1
农业建筑	nong ye jian zhu	1
农业经济	nong ye jing ji	1
农业经济理论	nong ye jing ji li lun	1
农业经济信息	nong ye jing ji xin xi	1
农业经济学	nong ye jing ji xue	1
农业经济周期	nong ye jing ji zhou qi	1
农业经营规模	nong ye jing ying gui mo	1
农业局	nong ye ju	1
农业科学	nong ye ke xue	1
农业昆虫学	nong ye kun chong xue	1
农业劳动	nong ye lao dong	1
农业劳动力	nong ye lao dong li	1
农业旅游	nong ye lv you	1
农业气候	nong ye qi hou	1
农业气候调查	nong ye qi hou diao cha	1
农业气候分析	nong ye qi hou fen xi	1
农业气候考察	nong ye qi hou kao cha	1
农业气候评价	nong ye qi hou ping jia	1
农业气候区	nong ye qi hou qu	1
农业气候区划	nong ye qi hou qu hua	1
农业气候图集	nong ye qi hou tu ji	1
农业气候相似原理	nong ye qi hou xiang si yuan li	1
农业气候学	nong ye qi hou xue	1
农业气候志	nong ye qi hou zhi	1
农业气候指标	nong ye qi hou zhi biao	1
农业气候资源	nong ye qi hou zi yuan	1
农业气象	nong ye qi xiang	1
农业气象产量预报	nong ye qi xiang chan liang yu bao	1
农业气象模拟	nong ye qi xiang mo ni	1
农业气象年报	nong ye qi xiang nian bao	1
农业气象情报	nong ye qi xiang qing bao	1
农业气象学	nong ye qi xiang xue	1
农业气象旬报	nong ye qi xiang xun bao	1
农业气象站	nong ye qi xiang zhan	1
农业气象指标	nong ye qi xiang zhi biao	1
农业企业	nong ye qi ye	1
农业区	nong ye qu	1
农业区划	nong ye qu hua	1
农业生产布局	nong ye sheng chan bu ju	1
农业生产结构	nong ye sheng chan jie gou	1
农业生产周期	nong ye sheng chan zhou qi	1
农业生态工程	nong ye sheng tai gong cheng	1
农业生态技术	nong ye sheng tai ji shu	1
农业生态系统	nong ye sheng tai xi tong	1
农业生态学	nong ye sheng tai xue	1
农业生物环境工程	nong ye sheng wu huan jing gong cheng	1
农业生物环境热力学	nong ye sheng wu huan jing re li xue	1
农业生物学	nong ye sheng wu xue	1
农业市场	nong ye shi chang	1
农业适度规模	nong ye shi du gui mo	1
农业试验	nong ye shi yan	1
农业水利化	nong ye shui li hua	1
农业厅	nong ye ting	1
农业统计学	nong ye tong ji xue	1
农业土壤	nong ye tu rang	1
农业土壤水分特性	nong ye tu rang shui fen te xing	1
农业土壤学	nong ye tu rang xue	1
农业网站	nong ye wang zhan	1
农业物理学	nong ye wu li xue	1
农业系统	nong ye xi tong	1
农业系统工程	nong ye xi tong gong cheng	1
农业系统模型	nong ye xi tong mo xing	1
农业现代化	nong ye xian dai hua	1
农业项目	nong ye xiang mu	1
农业小气候	nong ye xiao qi hou	1
农业新技术	nong ye xin ji shu	1
农业信息系统	nong ye xin xi xi tong	1
农业信息中心	nong ye xin xi zhong xin	1
农业遥感	nong ye yao gan	1
农业用地	nong ye yong di	1
农业原材料	nong ye yuan cai liao	1
农业再生产	nong ye zai sheng chan	1
农业增效	nong ye zeng xiao	1
农业政策	nong ye zheng ce	1
农业植物学	nong ye zhi wu xue	1
农业资源	nong ye zi yuan	1
农业综合开发	nong ye zong he kai fa	1
农艺类型	nong yi lei xing	1
农艺学	nong yi xue	1
农用	nong yong	1
农用工业	nong yong gong ye	1
农用抗菌素	nong yong kang jun su	1
农用链霉素	nong yong lian mei su	1
农用物资	nong yong wu zi	1
农用智能仪表	nong yong zhi neng yi biao	1
农资价格	nong zi jia ge	1
农资市场整治	nong zi shi chang zheng zhi	1
农作物	nong zuo wu	1
农作物病虫害	nong zuo wu bing chong hai	1
农作物新品种	nong zuo wu xin pin zhong	1
农作物制种	nong zuo wu zhi zhong	1
农作制	nong zuo zhi	1
农作制度	nong zuo zhi du	1
怒江小麦	nu jiang xiao mai	1
暖冬害	nuan dong hai	1
暖棚栽培	nuan peng zai pei	1
糯包谷	nuo bao gu	1
糯稻	nuo dao	1
糯高粱	nuo gao liang	1
诺廉	nuo lian	1
糯米	nuo mi	1
糯性	nuo xing	1
糯玉米	nuo yu mi	1
女店员	nv dian yuan	1
女盥洗室	nv guan xi shi	1
女记事员	nv ji shi yuan	1
女装裁剪师	nv zhuang cai jian shi	1
欧查果	ou cha guo	1
欧防风	ou fang feng	1
欧国葡萄	ou guo pu tao	1
欧芹	ou qin	1
欧洲防风	ou zhou fang feng	1
欧洲李	ou zhou li	1
欧洲山梨	ou zhou shan li	1
欧洲甜樱桃	ou zhou tian ying tao	1
欧洲玉米螟	ou zhou yu mi ming	1
怕旱	pa han	1
怕涝	pa lao	1
帕里醇	pa li chun	1
哌草丹	pai cao dan	1
排草丹	pai cao dan	1
排草净	pai cao jing	1
哌草磷	pai cao lin	1
派丹	pai dan	1
哌啶酯	pai ding zhi	1
排干	pai gan	1
哌净合剂	pai jing he ji	1
排气阀门	pai qi fa men	1
排趋性	pai qu xing	1
派生系统法	pai sheng xi tong fa	1
排水沟	pai shui gou	1
排序程序	pai xu cheng xu	1
哌壮素	pai zhuang su	1
排渍	pai zi	1
判别函数	pan bie han shu	1
盘脚坐	pan jiao zuo	1
蹒跚行走	pan shan xing zou	1
蟠桃	pan tao	1
疱痂	pao jia	1
抛闲	pao xian	1
抛秧	pao yang	1
抛栽	pao zai	1
抛植	pao zhi	1
赔产	pei chan	1
配方施肥	pei fang shi fei	1
配肥	pei fei	1
培肥	pei fei	1
配粉	pei fen	1
胚嫁接	pei jia jie	1
佩兰	pei lan	1
胚培养	pei pei yang	1
培强做大	pei qiang zuo da	1
胚乳直感	pei ru zhi gan	1
配水系统	pei shui xi tong	1
配套农机具	pei tao nong ji ju	1
培土	pei tu	1
培养料	pei yang liao	1
配准	pei zhun	1
配子选择	pei zi xuan ze	1
喷粉	pen fen	1
喷粉机	pen fen ji	1
喷灌	pen guan	1
喷杀	pen sha	1
喷施	pen shi	1
喷特	pen te	1
喷雾	pen wu	1
喷雾干燥	pen wu gan zao	1
喷雾机	pen wu ji	1
喷雾器	pen wu qi	1
喷烟机	pen yan ji	1
盆栽试验	pen zai shi yan	1
硼肥	peng fei	1
膨瓜肥	peng gua fei	1
膨化	peng hua	1
硼镁肥	peng mei fei	1
硼砂	peng sha	1
碰撞用汽车	peng zhuang yong qi che	1
皮薄	pi bao	1
啤酒大麦	pi jiu da mai	1
啤酒花	pi jiu hua	1
皮棉	pi mian	1
枇杷	pi pa	1
皮色	pi se	1
蜱虱威	pi shi wei	1
啤饲大麦	pi si da mai	1
披屋	pi wu	1
辟蚜雾	pi ya wu	1
披针形	pi zhen xing	1
偏旱	pian han	1
偏回归	pian hui gui	1
偏相关	pian xiang guan	1
片轴	pian zhou	1
瓢虫	piao chong	1
贫瘠土壤	pin ji tu rang	1
贫困村	pin kun cun	1
贫困县	pin kun xian	1
贫困乡	pin kun xiang	1
贫困学生	pin kun xue sheng	1
频数分布	pin shuo fen bu	1
品系	pin xi	1
品质差	pin zhi cha	1
品质好	pin zhi hao	1
品质劣	pin zhi lie	1
品质育种	pin zhi yu zhong	1
品种比较试验	pin zhong bi jiao shi yan	1
品种纯度	pin zhong chun du	1
品种登记	pin zhong deng ji	1
品种更换	pin zhong geng huan	1
品种间	pin zhong jian	1
品种鉴定	pin zhong jian ding	1
品种间杂交	pin zhong jian za jiao	1
品种间杂种	pin zhong jian za zhong	1
品种区域化	pin zhong qu yu hua	1
品种羊	pin zhong yang	1
品种优良	pin zhong you liang	1
平地	ping di	1
平方反比定率	ping fang fan bi ding lv	1
平方和	ping fang he	1
平腐灵	ping fu ling	1
平腹小蜂	ping fu xiao feng	1
评工记分	ping gong ji fen	1
苹果	ping guo	1
苹果顶芽卷叶蛾	ping guo ding ya juan ye e	1
苹果蠹蛾	ping guo du e	1
苹果红蜘蛛	ping guo hong zhi zhu	1
苹果绵蚜	ping guo mian ya	1
苹果树	ping guo shu	1
苹果树腐烂病	ping guo shu fu lan bing	1
苹果园	ping guo yuan	1
平衡不完全区组	ping heng bu wan quan qu zu	1
平交路口	ping jiao lu kou	1
平均差	ping jun cha	1
平均数	ping jun shu	1
平快车	ping kuai che	1
平流辐射霜冻	ping liu fu she shuang dong	1
平流霜冻	ping liu shuang dong	1
苹毛丽金龟	ping mao li jin gui	1
平面球形图	ping mian qiu xing tu	1
平畦	ping qi	1
苹小食心虫	ping xiao shi xin chong	1
瓶栽	ping zai	1
平展	ping zhan	1
粕处理	po chu li	1
坡改梯	po gai ti	1
破烂叶斑病	po lan ye ban bing	1
婆罗门参	po luo men can	1
破膜	po mo	1
坡田	po tian	1
蒲包花	pu bao hua	1
蒲菜	pu cai	1
扑草净	pu cao jing	1
扑打杀	pu da sha	1
铺地柏	pu di bai	1
匍匐茎	pu fu jing	1
匍匐型花生	pu fu xing hua sheng	1
普钙	pu gai	1
扑海因	pu hai yin	1
葡聚寡糖素	pu ju gua tang su	1
葡聚烯糖	pu ju xi tang	1
扑雷灵	pu lei ling	1
普力克	pu li ke	1
普日特	pu ri te	1
普杀特	pu sha te	1
扑杀威	pu sha wei	1
扑虱灵	pu shi ling	1
普施特	pu shi te	1
普收宝	pu shou bao	1
葡萄	pu tao	1
蒲桃	pu tao	1
葡萄根病蚜	pu tao gen bing ya	1
葡萄根瘤蚜	pu tao gen liu ya	1
葡萄酒城	pu tao jiu cheng	1
葡萄酒庄	pu tao jiu zhuang	1
葡萄柚	pu tao you	1
葡萄园	pu tao yuan	1
葡萄栽培	pu tao zai pei	1
葡萄榨汁机	pu tao zha zhi ji	1
普通过磷酸钙	pu tong guo lin suan gai	1
普通花叶病	pu tong hua ye bing	1
普通丝瓜	pu tong si gua	1
普通型花生	pu tong xing hua sheng	1
匍枝根霉病	pu zhi gen mei bing	1
铺筑	pu zhu	1
蛴螬	qi cao	1
起草委员会	qi cao wei yuan hui	1
汽车地下通道	qi che di xia tong dao	1
汽车修理师	qi che xiu li shi	1
气传病害	qi chuan bing hai	1
起动钮	qi dong niu	1
启动子	qi dong zi	1
齐墩霉素	qi dun mei su	1
七分管	qi fen guan	1
七氟菊酯	qi fu ju zhi	1
畦沟	qi gou	1
畦灌	qi guan	1
器官培养	qi guan pei yang	1
气候斑病	qi hou ban bing	1
气候变化	qi hou bian hua	1
气候变率	qi hou bian lv	1
气候带	qi hou dai	1
气候肥力	qi hou fei li	1
气候生产力	qi hou sheng chan li	1
气候生产潜力	qi hou sheng chan qian li	1
气候图	qi hou tu	1
气候型	qi hou xing	1
气候驯化	qi hou xun hua	1
气候要素	qi hou yao su	1
气候异常	qi hou yi chang	1
气候因素	qi hou yin su	1
气候因子	qi hou yin zi	1
气候灾害	qi hou zai hai	1
气候栽培界限	qi hou zai pei jie xian	1
气候资源	qi hou zi yuan	1
气化	qi hua	1
歧化选择	qi hua xuan ze	1
起垄犁	qi long li	1
七氯	qi lv	1
七氯苯	qi lv ben	1
齐螨素	qi man su	1
齐苗	qi miao	1
齐泥	qi ni	1
气溶胶	qi rong jiao	1
起墒	qi shang	1
起身期	qi shen qi	1
齐穗期	qi sui qi	1
七天净	qi tian jing	1
气调贮藏	qi tiao zhu cang	1
期望均方	qi wang jun fang	1
气温高	qi wen gao	1
气象学	qi xiang xue	1
旗叶	qi ye	1
绮夜娥	qi ye e	1
七叶树	qi ye shu	1
起云忠	qi yun zhong	1
前茬	qian cha	1
前翅	qian chi	1
千锄	qian chu	1
铅锤线	qian chui xian	1
黔单	qian dan	1
浅粉红色	qian fen hong se	1
潜伏期	qian fu qi	1
潜伏侵染	qian fu qin ran	1
前辐照	qian fu zhao	1
浅耕	qian geng	1
浅褐色	qian he se	1
千粒重	qian li zhong	1
前轮驱动	qian lun qu dong	1
千亩	qian mu	1
牵牛	qian niu	1
牵牛花	qian niu hua	1
潜热通量	qian re tong liang	1
千日红	qian ri hong	1
浅水层	qian shui ceng	1
前卫片	qian wei pian	1
前信号灯	qian xin hao deng	1
黔兴	qian xing	1
潜叶蛾	qian ye e	1
潜叶蝇	qian ye ying	1
牵引式农具	qian yin shi nong ju	1
潜蝇	qian ying	1
潜育层	qian yu ceng	1
潜育期	qian yu qi	1
浅栽	qian zai	1
潜在肥力	qian zai fei li	1
潜在蒸发	qian zai zheng fa	1
潜在蒸散	qian zai zheng san	1
浅中耕	qian zhong geng	1
前作	qian zuo	1
羟草酮	qiang cao tong	1
强感光	qiang gan guang	1
强感光性	qiang gan guang xing	1
强化	qiang hua	1
强化领导	qiang hua ling dao	1
羟化物	qiang hua wu	1
羟菌唑	qiang jun zuo	1
强力增产素	qiang li zeng chan su	1
抢晴	qiang qing	1
抢墒	qiang shang	1
抢时	qiang shi	1
枪乌贼	qiang wu zei	1
羟锈宁	qiang xiu ning	1
巧锄	qiao chu	1
乔灌草并茂	qiao guan cao bing mao	1
荞麦	qiao mai	1
巧施	qiao shi	1
桥式耕作系统	qiao shi geng zuo xi tong	1
巧收	qiao shou	1
荞子	qiao zi	1
茄果类蔬菜	qie guo lei shu cai	1
切花	qie hua	1
茄科	qie ke	1
茄科宁	qie ke ning	1
切连科夫辐射	qie lian ke fu fu she	1
切叶蜂	qie ye feng	1
嗪氨灵	qin an ling	1
芹菜	qin cai	1
嗪草酮	qin cao tong	1
嗪虫脲	qin chong niao	1
亲代	qin dai	1
禽肥	qin fei	1
亲和	qin he	1
亲和性	qin he xing	1
嗪磺隆	qin huang long	1
侵染	qin ran	1
侵染性	qin ran xing	1
侵染性病害	qin ran xing bing hai	1
侵染源	qin ran yuan	1
勤施	qin shi	1
侵蚀土壤	qin shi tu rang	1
氰氨态氮肥	qing an tai dan fei	1
青蚕豆	qing can dou	1
氰草津	qing cao jin	1
氰草净	qing cao jing	1
氰草嗪	qing cao qin	1
青虫菌	qing chong jun	1
青大豆	qing da dou	1
青岛星牌	qing dao xing pai	1
氰敌	qing di	1
清粉	qing fen	1
清粪水	qing fen shui	1
氰氟虫腙	qing fu chong zong	1
轻工原料	qing gong yuan liao	1
轻工原料基地	qing gong yuan liao ji di	1
清沟	qing gou	1
青果	qing guo	1
氢化	qing hua	1
青花菜	qing hua cai	1
清花机	qing hua ji	1
氢化硫	qing hua liu	1
氰菌胺	qing jun an	1
青菌灵	qing jun ling	1
青稞	qing ke	1
青稞面	qing ke mian	1
青枯病	qing ku bing	1
清理	qing li	1
苘麻	qing ma	1
氰马	qing ma	1
青霉穗腐病	qing mei sui fu bing	1
青年谷	qing nian gu	1
晴三	qing san	1
氰杀	qing sha	1
轻施	qing shi	1
氰霜唑	qing shuang zuo	1
青饲联合收割机	qing si lian he shou ge ji	1
氢酸	qing suan	1
青头菌	qing tou jun	1
青豌豆	qing wan dou	1
氰戊菊酯	qing wu ju zhi	1
氰烯菌酯	qing xi jun zhi	1
倾销差价	qing xiao cha jia	1
倾销幅度	qing xiao fu du	1
清选机	qing xuan ji	1
氢氧化铜	qing yang hua tong	1
氰氧乐	qing yang le	1
青鱼	qing yu	1
清淤	qing yu	1
青枣	qing zao	1
青枣树	qing zao shu	1
清障车	qing zhang che	1
轻质土壤	qing zhi tu rang	1
青贮	qing zhu	1
球孢白僵菌	qiu bao bai jiang jun	1
秋播	qiu bo	1
秋播作物	qiu bo zuo wu	1
秋冬农业	qiu dong nong ye	1
秋海棠	qiu hai tang	1
秋剪	qiu jian	1
球茎甘蓝	qiu jing gan lan	1
秋兰姆	qiu lan mu	1
秋末冬初	qiu mo dong chu	1
楸木	qiu mu	1
球腔菌叶斑病	qiu qiang jun ye ban bing	1
秋收作物	qiu shou zuo wu	1
球穗扁莎草	qiu sui bian suo cao	1
犰狳	qiu yu	1
球种	qiu zhong	1
秋种	qiu zhong	1
球状鼻	qiu zhuang bi	1
楸子	qiu zi	1
秋子梨	qiu zi li	1
驱避	qu bi	1
曲辰	qu chen	1
驱虫特	qu chong te	1
驱虫威	qu chong wei	1
趋触性	qu chu xing	1
取代苯类	qu dai ben lei	1
渠道开挖	qu dao kai wa	1
渠道清淤	qu dao qing yu	1
趋光性	qu guang xing	1
趋化性	qu hua xing	1
曲颈甑	qu jing zeng	1
苣荬菜	qu mai cai	1
取苗	qu miao	1
去氢枞酸铜	qu qing cong suan tong	1
取食刺激剂	qu shi ci ji ji	1
取食习性	qu shi xi xing	1
取食抑制剂	qu shi yi zhi ji	1
取土	qu tu	1
趣味体育	qu wei ti yu	1
驱蚊醇	qu wen chun	1
驱蚊灵	qu wen ling	1
趋性	qu xing	1
去雄	qu xiong	1
取样误差	qu yang wu cha	1
曲叶病毒病	qu ye bing du bing	1
驱蝇定	qu ying ding	1
区域试验	qu yu shi yan	1
区组	qu zu	1
全翅羽蛾	quan chi yu e	1
全国侨联	quan guo qiao lian	1
全国青联	quan guo qing lian	1
全国学联	quan guo xue lian	1
全酶	quan mei	1
全面敞开	quan mian chang kai	1
全苗	quan miao	1
全能性	quan neng xing	1
全蚀病	quan shi bing	1
全穗	quan sui	1
全田	quan tian	1
全天工作	quan tian gong zuo	1
全同胞交配	quan tong bao jiao pei	1
拳头瓜	quan tou gua	1
全爪螨	quan zhao man	1
炔草胺	que cao an	1
炔草酯	que cao zhi	1
缺乏劳力	que fa lao li	1
缺肥	que fei	1
炔禾灵	que he ling	1
缺口圆盘耙	que kou yuan pan ba	1
缺绿症	que lv zheng	1
炔螨特	que man te	1
炔咪菊酯	que mi ju zhi	1
缺苗	que miao	1
缺硼症	que peng zheng	1
缺素病	que su bing	1
缺素症	que su zheng	1
缺索症	que suo zheng	1
缺塘	que tang	1
缺氧保藏	que yang bao cang	1
缺株	que zhu	1
群体	qun ti	1
群体改良	qun ti gai liang	1
群体密度	qun ti mi du	1
染料作物	ran liao zuo wu	1
染色病毒病	ran se bing du bing	1
染色体工程	ran se ti gong cheng	1
壤虫威	rang chong wei	1
热带季风气候	re dai ji feng qi hou	1
热带稀树草原气候	re dai xi shu cao yuan qi hou	1
热带雨林气候	re dai yu lin qi hou	1
热带作物	re dai zuo wu	1
热辐射	re fu she	1
热害	re hai	1
热红外	re hong wai	1
热量平衡	re liang ping heng	1
热量资源	re liang zi yuan	1
热释光	re shi guang	1
热释光剂量测定	re shi guang ji liang ce ding	1
热水塘	re shui tang	1
热致发光剂量测定	re zhi fa guang ji liang ce ding	1
热柱	re zhu	1
人粪尿	ren fen niao	1
人工降雨	ren gong jiang yu	1
人工气候室	ren gong qi hou shi	1
人工气候箱	ren gong qi hou xiang	1
人工授粉	ren gong shou fen	1
人工饲料	ren gong si liao	1
人工选择	ren gong xuan ze	1
壬菌铜	ren jun tong	1
人均有粮	ren jun you liang	1
人口过剩	ren kou guo sheng	1
人口减少	ren kou jian shao	1
人口研究	ren kou yan jiu	1
人口增长	ren kou zeng zhang	1
人口增殖	ren kou zeng zhi	1
人口质量	ren kou zhi liang	1
人纹污灯蛾	ren wen wu deng e	1
人心果	ren xin guo	1
人行过街横道	ren xing guo jie heng dao	1
人造奶油	ren zao nai you	1
轫致辐射	ren zhi fu she	1
日本金龟子	ri ben jin gui zi	1
日本蜡蚧	ri ben la jie	1
日本五针松	ri ben wu zhen song	1
日本蛛甲	ri ben zhu jia	1
日变化	ri bian hua	1
日常费用	ri chang fei yong	1
日平均温度	ri ping jun wen du	1
日射	ri she	1
日文报纸	ri wen bao zhi	1
日照率	ri zhao lv	1
日照时间	ri zhao shi jian	1
日照时数	ri zhao shi shu	1
日振幅	ri zhen fu	1
日灼病	ri zhuo bing	1
茸毒蛾	rong du e	1
容积比热	rong ji bi re	1
溶剂回收	rong ji hui shou	1
绒蚧	rong jie	1
溶解氧	rong jie yang	1
融杀蚧螨	rong sha jie man	1
容许极限	rong xu ji xian	1
蝾螈	rong yuan	1
肉豆蔻	rou dou kou	1
肉鸽	rou ge	1
肉鸡舍	rou ji she	1
揉捻	rou nian	1
揉切	rou qie	1
肉羊	rou yang	1
肉煮	rou zhu	1
乳白灯泡	ru bai deng pao	1
褥草	ru cao	1
乳化剂	ru hua ji	1
乳剂	ru ji	1
茹类蛋白多糖	ru lei dan bai duo tang	1
乳牛业	ru niu ye	1
乳品加工业	ru pin jia gong ye	1
乳品业	ru pin ye	1
入渗	ru shen	1
入渗率	ru shen lv	1
乳熟	ru shu	1
乳熟期	ru shu qi	1
乳糖操纵子	ru tang cao zong zi	1
乳线	ru xian	1
乳油	ru you	1
乳制品	ru zhi pin	1
软磁盘	ruan ci pan	1
软磁盘机	ruan ci pan ji	1
软腐	ruan fu	1
软腐病	ruan fu bing	1
软化	ruan hua	1
软米	ruan mi	1
软米型	ruan mi xing	1
软片盒	ruan pian he	1
软设备	ruan she bei	1
软枣	ruan zao	1
软枣猕猴桃	ruan zao mi hou tao	1
软质小麦	ruan zhi xiao mai	1
瑞毒霉	rui du mei	1
瑞毒霉锰锌	rui du mei meng xin	1
瑞毒霉铜	rui du mei tong	1
瑞毒锰锌	rui du meng xin	1
瑞毒霜	rui du shuang	1
锐劲特	rui jin te	1
瑞枯霉	rui ku mei	1
瑞拉菌素	rui la jun su	1
瑞香	rui xiang	1
瑞香狼毒素	rui xiang lang du su	1
瑞泽水灵	rui ze shui ling	1
润豆	run dou	1
润麦	run mai	1
若虫	ruo chong	1
若虫期	ruo chong qi	1
弱感光	ruo gan guang	1
弱感光性	ruo gan guang xing	1
弱筋	ruo jin	1
弱苗	ruo miao	1
弱株	ruo zhu	1
撒播	sa bo	1
撒播机	sa bo ji	1
撒肥机	sa fei ji	1
撒粪机	sa fen ji	1
撒盖	sa gai	1
撒施	sa shi	1
萨瓦纳气候	sa wa na qi hou	1
撒籽	sa zi	1
赛稗津	sai bai jin	1
赛苯隆	sai ben long	1
赛波凯	sai bo kai	1
噻草胺	sai cao an	1
噻草平	sai cao ping	1
噻草酮	sai cao tong	1
噻虫胺	sai chong an	1
噻虫啉	sai chong lin	1
噻虫嗪	sai chong qin	1
噻虫醛	sai chong quan	1
赛丹	sai dan	1
噻吩磺隆	sai fen huang long	1
噻氟隆	sai fu long	1
噻磺吩隆	sai huang fen long	1
噻黄隆	sai huang long	1
噻磺隆	sai huang long	1
噻节因	sai jie yin	1
鳃金龟	sai jin gui	1
噻井	sai jing	1
噻菌胺	sai jun an	1
噻菌腈	sai jun jing	1
噻菌灵	sai jun ling	1
噻菌茂	sai jun mao	1
噻菌铜	sai jun tong	1
赛克津	sai ke jin	1
噻枯唑	sai ku zuo	1
赛乐收	sai le shou	1
赛铃灵	sai ling ling	1
噻螨胺	sai man an	1
噻螨醇	sai man chun	1
噻螨特	sai man te	1
噻螨酮	sai man tong	1
噻螨威	sai man wei	1
噻霉酮	sai mei tong	1
赛欧姆	sai ou mu	1
噻嗪酮	sai qin tong	1
鳃蚯蚓	sai qiu yin	1
噻森铜	sai sen tong	1
噻鼠酮	sai shu tong	1
赛松	sai song	1
噻唑膦	sai zuo lin	1
噻唑锌	sai zuo xin	1
三包一奖	san bao yi jiang	1
三苯基乙酸锡	san ben ji yi suan xi	1
三苯磷	san ben lin	1
三菜灭	san cai mie	1
三岔箐	san cha jing	1
三岛柴胡	san dao chai hu	1
三丁磷	san ding lin	1
三防体系	san fang ti xi	1
三分种	san fen zhong	1
三氟甲吡醚	san fu jia bi mi	1
三氟氯氰菊酯	san fu lv qing ju zhi	1
三氟咪唑	san fu mi zuo	1
三盖	san gai	1
散黑穗病	san hei sui bing	1
三化螟	san hua ming	1
三环锡	san huan xi	1
三环唑	san huan zuo	1
三角刮刀	san jiao gua dao	1
三角花	san jiao hua	1
三角叶杨	san jiao ye yang	1
散居型飞蝗	san ju xing fei huang	1
三磷锡	san lin xi	1
三硫磷	san liu lin	1
三氯杀螨醇	san lv sha man chun	1
三氯异氰尿酸	san lv yi qing niao suan	1
三农	san nong	1
三色堇	san se jin	1
三色苋	san se xian	1
散射光	san she guang	1
三熟	san shu	1
三熟制	san shu zhi	1
三维农业	san wei nong ye	1
三系杂种	san xi za zhong	1
三下乡	san xia xiang	1
三叶草	san ye cao	1
三乙膦酸铝	san yi lin suan lv	1
伞状	san zhuang	1
三唑醇	san zuo chun	1
三唑环锡	san zuo huan xi	1
三唑磷	san zuo lin	1
三唑硫磷	san zuo liu lin	1
三唑酮	san zuo tong	1
三唑酮硫	san zuo tong liu	1
三唑锡	san zuo xi	1
桑白盾蚧	sang bai dun jie	1
桑白绢病	sang bai juan bing	1
桑白毛虫	sang bai mao chong	1
桑尺蠖	sang chi huo	1
桑赤锈病	sang chi xiu bing	1
桑大象虫	sang da xiang chong	1
桑迪恩	sang di en	1
桑盾蚧	sang dun jie	1
桑菲纳	sang fei na	1
桑粉虱	sang fen shi	1
桑干枯病	sang gan ku bing	1
桑根结线虫病	sang gen jie xian chong bing	1
桑根瘿蚊	sang gen ying wen	1
桑国绿盲蝽	sang guo lv mang chun	1
桑褐斑病	sang he ban bing	1
桑褐刺蛾	sang he ci e	1
桑虎天牛	sang hu tian niu	1
桑花叶病	sang hua ye bing	1
桑花叶卷叶病	sang hua ye juan ye bing	1
桑蟥	sang huang	1
桑黄迷萤叶甲	sang huang mi ying ye jia	1
桑灰霉病	sang hui mei bing	1
桑卷叶枯病	sang juan ye ku bing	1
桑里白粉病	sang li bai fen bing	1
桑毛虫	sang mao chong	1
桑螟	sang ming	1
桑木虱	sang mu shi	1
桑拟干枯病	sang ni gan ku bing	1
桑纽蚧	sang niu jie	1
桑梢小囊虫	sang shao xiao nang chong	1
桑椹菌核病	sang shen jun he bing	1
桑虱	sang shi	1
桑丝叶病毒病	sang si ye bing du bing	1
桑蓑蛾	sang suo e	1
桑炭疽病	sang tan ju bing	1
桑天牛	sang tian niu	1
桑透翅蛾	sang tou chi e	1
桑瓦特	sang wa te	1
桑伪棍蓟马	sang wei gun ji ma	1
桑污叶病	sang wu ye bing	1
桑吸浆虫	sang xi jiang chong	1
桑细菌性疫病	sang xi jun xing yi bing	1
桑象虫	sang xiang chong	1
桑象甲	sang xiang jia	1
桑小灰象虫	sang xiao hui xiang chong	1
桑野蚕	sang ye can	1
桑叶蝉	sang ye chan	1
桑叶螨	sang ye man	1
桑叶瘿蚊	sang ye ying wen	1
桑园	sang yuan	1
桑褶翅尺蠖	sang zhe chi chi huo	1
桑蛀虫	sang zhu chong	1
桑紫纹羽病	sang zi wen yu bing	1
扫茀特	sao bo te	1
扫荒	sao huang	1
搔菌	sao jun	1
扫螨宝	sao man bao	1
扫螨净	sao man jing	1
扫描线	sao miao xian	1
色二孢穗腐病	se er bao sui fu bing	1
森林保护	sen lin bao hu	1
森林保护条例	sen lin bao hu tiao li	1
森林经营	sen lin jing ying	1
森林蓄积量	sen lin xu ji liang	1
森林永续利用	sen lin yong xu li yong	1
莎稗磷	sha bai lin	1
杀稗灵	sha bai ling	1
杀稗王	sha bai wang	1
杀草胺	sha cao an	1
杀草丹	sha cao dan	1
杀草净	sha cao jing	1
杀草狂	sha cao kuang	1
杀草隆	sha cao long	1
杀草畏	sha cao wei	1
刹车踏板	sha che ta ban	1
杀虫安	sha chong an	1
杀虫单	sha chong dan	1
杀虫单铵	sha chong dan an	1
杀虫灯	sha chong deng	1
杀虫钉	sha chong ding	1
杀虫环	sha chong huan	1
杀虫磺	sha chong huang	1
杀虫剂	sha chong ji	1
杀虫灵	sha chong ling	1
杀虫隆	sha chong long	1
杀虫脒	sha chong mi	1
杀虫双	sha chong shuang	1
杀虫素	sha chong su	1
沙打旺	sha da wang	1
杀毒钒	sha du fan	1
杀毒矾	sha du fan	1
莎多伏	sha duo fu	1
沙果	sha guo	1
砂礓	sha jiang	1
杀井	sha jing	1
杀菌剂	sha jun ji	1
杀克尔	sha ke er	1
莎阔净	sha kuo jing	1
沙梨	sha li	1
杀铃脲	sha ling niao	1
沙隆喜	sha long xi	1
杀螨剂	sha man ji	1
杀螨隆	sha man long	1
杀螨脒	sha man mi	1
杀螨特	sha man te	1
杀螨王	sha man wang	1
杀灭菊酯	sha mie ju zhi	1
杀螟丹	sha ming dan	1
杀螟杆菌	sha ming gan jun	1
杀螟腈	sha ming jing	1
杀螟菊酯	sha ming ju zhi	1
杀螟硫磷	sha ming liu lin	1
杀螟松	sha ming song	1
杀螟威	sha ming wei	1
沙漠化	sha mo hua	1
杀那特	sha na te	1
莎蜱磷	sha pi lin	1
杀扑磷	sha pu lin	1
杀青	sha qing	1
沙壤	sha rang	1
砂壤	sha rang	1
沙壤土	sha rang tu	1
砂壤土	sha rang tu	1
杀噻井	sha sai jing	1
杀鼠剂	sha shu ji	1
杀它仗	sha ta zhang	1
砂田	sha tian	1
砂土	sha tu	1
杀线虫剂	sha xian chong ji	1
杀线威	sha xian wei	1
杀雄啶	sha xiong ding	1
杀雄嗪	sha xiong qin	1
杀雄酮	sha xiong tong	1
沙枣	sha zao	1
筛豆龟蝽	shai dou gui chun	1
晒垡	shai fa	1
筛理	shai li	1
晒田	shai tian	1
山茶	shan cha	1
钐刀	shan dao	1
山稻蝗	shan dao huang	1
山地气候	shan di qi hou	1
山定子	shan ding zi	1
山豆子	shan dou zi	1
栅格数据	shan ge shu ju	1
山谷风	shan gu feng	1
闪光指示器	shan guang zhi shi qi	1
山核桃	shan he tao	1
山核桃树	shan he tao shu	1
珊瑚树	shan hu shu	1
珊瑚状	shan hu zhuang	1
山荆子	shan jing zi	1
山苦荬	shan ku mai	1
山梨	shan li	1
钐镰	shan lian	1
山毛榉	shan mao ju	1
山葡萄	shan pu tao	1
山区农业	shan qu nong ye	1
山桃	shan tao	1
山田	shan tian	1
山莴苣白粉病	shan wo ju bai fen bing	1
汕优	shan you	1
山鹬	shan yu	1
山楂	shan zha	1
山楂长小囊	shan zha chang xiao nang	1
山楂红蜘蛛	shan zha hong zhi zhu	1
山楂叶螨	shan zha ye man	1
山志学	shan zhi xue	1
山茱萸	shan zhu yu	1
山竹子	shan zhu zi	1
墒长	shang chang	1
墒高	shang gao	1
伤根	shang gen	1
商贾云集	shang gu yun ji	1
商界报纸	shang jie bao zhi	1
墒宽	shang kuan	1
墒面	shang mian	1
商品菜园	shang pin cai yuan	1
商品化	shang pin hua	1
商品交易会	shang pin jiao yi hui	1
商品蔬菜	shang pin shu cai	1
商品性	shang pin xing	1
商品性好	shang pin xing hao	1
墒平	shang ping	1
墒情	shang qing	1
伤亡保险	shang wang bao xian	1
上下开关窗	shang xia kai guan chuang	1
上限	shang xian	1
上行列车	shang xing lie che	1
梢腐病	shao fu bing	1
少耕	shao geng	1
少耕法	shao geng fa	1
梢瓜	shao gua	1
烧菌	shao jun	1
梢枯	shao ku	1
烧苗	shao miao	1
少蘖	shao nie	1
少施	shao shi	1
少雨	shao yu	1
烧种	shao zhong	1
韶子	shao zi	1
射干	she gan	1
社会负担费用	she hui fu dan fei yong	1
社交性宴会	she jiao xing yan hui	1
猞猁	she li	1
蛇麻	she ma	1
蛇目菊	she mu ju	1
涉农	she nong	1
设施农业	she shi nong ye	1
设施蔬菜	she shi shu cai	1
蛇丝瓜	she si gua	1
舌鳎	she ta	1
麝香石竹	she xiang shi zhu	1
麝香豌豆	she xiang wan dou	1
蛇眼蚧	she yan jie	1
摄影测量学	she ying ce liang xue	1
摄影推车	she ying tui che	1
深锄	shen chu	1
渗出	shen chu	1
神锄	shen chu	1
肾毒蛾	shen du e	1
深翻	shen fan	1
深翻耕	shen fan geng	1
深耕	shen geng	1
深灌	shen guan	1
渗灌	shen guan	1
肾坑翅夜蛾	shen keng chi ye e	1
什来特	shen lai te	1
渗漏	shen lou	1
渗漏计	shen lou ji	1
渗漏率	shen lou lv	1
渗漏水	shen lou shui	1
申嗪霉素	shen qin mei su	1
深施	shen shi	1
深水稻	shen shui dao	1
深松耕	shen song geng	1
胂铁铵	shen tie an	1
渗透深度	shen tou shen du	1
渗透吸力	shen tou xi li	1
渗透压	shen tou ya	1
神泽氏叶螨	shen ze shi ye man	1
深扎	shen zha	1
砷制剂	shen zhi ji	1
深中耕	shen zhong geng	1
生白果	sheng bai guo	1
生板栗	sheng ban li	1
生茶	sheng cha	1
省茶叶产业办	sheng cha ye chan ye ban	1
省柴灶	sheng chai zao	1
圣铲	sheng chan	1
生产发展	sheng chan fa zhan	1
生产过剩	sheng chan guo sheng	1
圣锄	sheng chu	1
牲畜出栏率	sheng chu chu lan lv	1
生创办	sheng chuang ban	1
圣丁蓝	sheng ding lan	1
生根	sheng gen	1
生根粉	sheng gen fen	1
省工	sheng gong	1
盛果期	sheng guo qi	1
生核桃	sheng he tao	1
盛花	sheng hua	1
盛花期	sheng hua qi	1
生化突变	sheng hua tu bian	1
生荒地	sheng huang di	1
生活宽裕	sheng huo kuan yu	1
生活力	sheng huo li	1
生活污水	sheng huo wu shui	1
生胶	sheng jiao	1
圣津特	sheng jin te	1
生境	sheng jing	1
生开心果	sheng kai xin guo	1
生理病害	sheng li bing hai	1
生理成熟	sheng li cheng shu	1
生理干旱	sheng li gan han	1
生命表	sheng ming biao	1
圣耐施	sheng nai shi	1
省农大	sheng nong da	1
省农科院	sheng nong ke yuan	1
圣农施	sheng nong shi	1
圣农秀	sheng nong xiu	1
省农业厅	sheng nong ye ting	1
圣农盈	sheng nong ying	1
盛期	sheng qi	1
生食	sheng shi	1
圣斯特	sheng si te	1
生态村	sheng tai cun	1
生态林业	sheng tai lin ye	1
生态旅游	sheng tai lv you	1
生态模拟	sheng tai mo ni	1
生态农业	sheng tai nong ye	1
生态农业模式	sheng tai nong ye mo shi	1
生态平衡	sheng tai ping heng	1
生态圈	sheng tai quan	1
生态失调	sheng tai shi tiao	1
生态危机	sheng tai wei ji	1
生态畜牧业	sheng tai xu mu ye	1
生物反应器	sheng wu fan ying qi	1
生物防治	sheng wu fang zhi	1
生物肥料	sheng wu fei liao	1
生物化学	sheng wu hua xue	1
生物技术	sheng wu ji shu	1
生物碱	sheng wu jian	1
生物监测	sheng wu jian ce	1
生物降解	sheng wu jiang jie	1
生物利用率	sheng wu li yong lv	1
生物浓缩	sheng wu nong suo	1
生物群落	sheng wu qun luo	1
生物摄取	sheng wu she qu	1
生物型	sheng wu xing	1
生物需氧量	sheng wu xu yang liang	1
生物质产业	sheng wu zhi chan ye	1
生物制剂	sheng wu zhi ji	1
生物质能	sheng wu zhi neng	1
生物种衣剂	sheng wu zhong yi ji	1
生物转化	sheng wu zhuan hua	1
生效部分	sheng xiao bu fen	1
生育期	sheng yu qi	1
生育期预测	sheng yu qi yu ce	1
生长发育	sheng zhang fa yu	1
生长率	sheng zhang lv	1
生长期	sheng zhang qi	1
生长习性	sheng zhang xi xing	1
生殖隔离	sheng zhi ge li	1
生殖力	sheng zhi li	1
使百	shi bai	1
石板笔	shi ban bi	1
时斑病	shi ban bing	1
施保功	shi bao gong	1
施保克咪鲜胺	shi bao ke mi xian an	1
市场畅销	shi chang chang xiao	1
市场竞争力强	shi chang jing zheng li qiang	1
矢车菊	shi che ju	1
湿沉降	shi chen jiang	1
食虫虻	shi chong meng	1
食虫瓢虫	shi chong piao chong	1
湿地松粉蚧	shi di song fen jie	1
施点发	shi dian fa	1
石刁柏	shi diao bai	1
湿度测量仪	shi du ce liang yi	1
十二碳烯醇	shi er tan xi chun	1
示范村	shi fan cun	1
示范点	shi fan dian	1
示范户	shi fan hu	1
示范基地	shi fan ji di	1
示范区	shi fan qu	1
示范县	shi fan xian	1
示范乡	shi fan xiang	1
示范样板	shi fan yang ban	1
施肥	shi fei	1
施肥播种机	shi fei bo zhong ji	1
施肥机	shi fei ji	1
施肥位置	shi fei wei zhi	1
施肥制度	shi fei zhi du	1
世高	shi gao	1
石膏粉	shi gao fen	1
施工技术员	shi gong ji shu yuan	1
事故保险	shi gu bao xian	1
事故险	shi gu xian	1
试管苗	shi guan miao	1
湿害	shi hai	1
适合性测验	shi he xing ce yan	1
石画	shi hua	1
施化肥	shi hua fei	1
始花期	shi hua qi	1
石灰土	shi hui tu	1
石灰性土	shi hui xing tu	1
石灰岩土	shi hui yan tu	1
石鸡	shi ji	1
实际收入	shi ji shou ru	1
食荚豌豆	shi jia wan dou	1
时间隔离	shi jian ge li	1
矢尖蚧	shi jian jie	1
施颗粒肥机	shi ke li fei ji	1
适口性	shi kou xing	1
实粒数	shi li shu	1
石硫合剂	shi liu he ji	1
石榴树	shi liu shu	1
施隆	shi long	1
莳萝	shi luo	1
失绿	shi lv	1
虱螨脲	shi man niao	1
十亩	shi mu	1
石楠	shi nan	1
食品保藏	shi pin bao cang	1
食品辐照技术	shi pin fu zhao ji shu	1
适期	shi qi	1
湿润剂	shi run ji	1
湿润气候	shi run qi hou	1
湿润温和气候	shi run wen he qi hou	1
湿润系数	shi run xi shu	1
湿润育秧	shi run yu yang	1
湿润指数	shi run zhi shu	1
十三吗啉	shi san ma lin	1
始盛期	shi sheng qi	1
实生砧	shi sheng zhen	1
事实报告	shi shi bao gao	1
时事问题	shi shi wen ti	1
十四点负泥甲	shi si dian fu ni jia	1
十四碳二烯醇	shi si tan er xi chun	1
石蒜	shi suan	1
始穗期	shi sui qi	1
使它隆	shi ta long	1
施田补	shi tian bu	1
施田扑	shi tian pu	1
蚀纹病毒病	shi wen bing du bing	1
虱纹灵	shi wen ling	1
食物链	shi wu lian	1
食心虫	shi xin chong	1
食蚜蝇	shi ya ying	1
试验区	shi yan qu	1
试验误差	shi yan wu cha	1
试验小区	shi yan xiao qu	1
试验种植	shi yan zhong zhi	1
试验种植计划书	shi yan zhong zhi ji hua shu	1
施药	shi yao	1
蚀叶野螟	shi ye ye ming	1
适宜性	shi yi xing	1
实蝇	shi ying	1
适应性	shi ying xing	1
适应性广	shi ying xing guang	1
适应性强	shi ying xing qiang	1
食用大黄	shi yong da huang	1
食用菌类	shi yong jun lei	1
施用量	shi yong liang	1
食用植物油	shi yong zhi wu you	1
食用作物	shi yong zuo wu	1
石油农业	shi you nong ye	1
嗜鱼蛇	shi yu she	1
石竹	shi zhu	1
石竹花	shi zhu hua	1
时装调配师	shi zhuang tiao pei shi	1
十字花科	shi zi hua ke	1
柿子树	shi zi shu	1
十字型大农业	shi zi xing da nong ye	1
施足	shi zu	1
售报处	shou bao chu	1
瘦薄	shou bo	1
授粉	shou fen	1
手扶式拖拉机	shou fu shi tuo la ji	1
手扶拖拉机	shou fu tuo la ji	1
收割机	shou ge ji	1
收割机械	shou ge ji xie	1
收购工作	shou gou gong zuo	1
收菇	shou gu	1
收获期	shou huo qi	1
瘦苗	shou miao	1
手示信号	shou shi xin hao	1
收税员	shou shui yuan	1
受体	shou ti	1
手梯	shou ti	1
兽医处	shou yi chu	1
收益净额	shou yi jing e	1
受益农户	shou yi nong hu	1
手栽	shou zai	1
手制动器	shou zhi dong qi	1
收种	shou zhong	1
蔬菜罐头	shu cai guan tou	1
蔬菜基地	shu cai ji di	1
蔬菜泥	shu cai ni	1
蔬菜生产	shu cai sheng chan	1
蔬菜园艺	shu cai yuan yi	1
蔬菜栽培	shu cai zai pei	1
蔬菜汁	shu cai zhi	1
蔬菜作物	shu cai zuo wu	1
熟茶	shu cha	1
鼠甘伏	shu gan fu	1
树冠反射	shu guan fan she	1
疏果	shu guo	1
蔬果净	shu guo jing	1
蔬果磷	shu guo lin	1
鼠害	shu hai	1
束禾机	shu he ji	1
黍红叶病	shu hong ye bing	1
疏花	shu hua	1
疏剪	shu jian	1
属间杂交	shu jian za jiao	1
数据	shu ju	1
数据编码	shu ju bian ma	1
数据格式	shu ju ge shi	1
薯块	shu kuai	1
疏蕾	shu lei	1
薯类作物	shu lei zuo wu	1
数码单反相机	shu ma dan fan xiang ji	1
树莓	shu mei	1
黍米	shu mi	1
疏密匀苗	shu mi yun miao	1
薯皮	shu pi	1
熟期	shu qi	1
薯肉	shu rou	1
疏松土壤	shu song tu rang	1
鼠完	shu wan	1
薯形	shu xing	1
属性数据	shu xing shu ju	1
数学模拟	shu xue mo ni	1
数学模型	shu xue mo xing	1
黍蚜	shu ya	1
树艺学	shu yi xue	1
薯蓣	shu yu	1
薯芋类蔬菜	shu yu lei shu cai	1
树脂植物	shu zhi zhi wu	1
数字滤波器	shu zi lv bo qi	1
数字乡村	shu zi xiang cun	1
刷麸	shua fu	1
刷麦	shua mai	1
衰变产物	shuai bian chan wu	1
衰变常数	shuai bian chang shu	1
衰减系数	shuai jian xi shu	1
衰老	shuai lao	1
双斑大蟋	shuang ban da xi	1
双斑萤叶甲	shuang ban ying ye jia	1
双倍体	shuang bei ti	1
双层公共汽车	shuang ceng gong gong qi che	1
双层经营	shuang ceng jing ying	1
双层汽车	shuang ceng qi che	1
双虫脒	shuang chong mi	1
霜代	shuang dai	1
双低	shuang di	1
双二倍体	shuang er bei ti	1
双胍辛胺	shuang gua xin an	1
霜害	shuang hai	1
双季	shuang ji	1
双季稻	shuang ji dao	1
双甲脒	shuang jia mi	1
霜降	shuang jiang	1
双交	shuang jiao	1
双交种	shuang jiao zhong	1
爽口辣	shuang kou la	1
双列杂交	shuang lie za jiao	1
双氯酚	shuang lv fen	1
霜霉	shuang mei	1
霜霉病	shuang mei bing	1
霜霉威	shuang mei wei	1
霜脲氰	shuang niao qing	1
霜期	shuang qi	1
双炔酰菌胺	shuang que xian jun an	1
双人房间	shuang ren fang jian	1
双人近景	shuang ren jin jing	1
双色穗	shuang se sui	1
双鼠脲	shuang shu niao	1
双素碱	shuang su jian	1
双头扳子	shuang tou ban zi	1
霜洼	shuang wa	1
双线盗毒蛾	shuang xian dao du e	1
双向犁	shuang xiang li	1
双效磷	shuang xiao lin	1
双效灵	shuang xiao ling	1
霜穴	shuang xue	1
双氧威	shuang yang wei	1
霜疫清	shuang yi qing	1
双乙威	shuang yi wei	1
双子叶	shuang zi ye	1
双子叶植物	shuang zi ye zhi wu	1
水胺硫磷	shui an liu lin	1
水胺氰	shui an qing	1
水城河	shui cheng he	1
水代法取油	shui dai fa qu you	1
水稻拔秧机	shui dao ba yang ji	1
水稻插秧机	shui dao cha yang ji	1
水稻旱播	shui dao han bo	1
水稻螟虫	shui dao ming chong	1
水稻田	shui dao tian	1
水稻土	shui dao tu	1
水稻组	shui dao zu	1
水底沉积物	shui di chen ji wu	1
水电局	shui dian ju	1
水分保持	shui fen bao chi	1
水分补偿	shui fen bu chang	1
水分供应率	shui fen gong ying lv	1
水分管理	shui fen guan li	1
水分亏缺	shui fen kui que	1
水分利用系数	shui fen li yong xi shu	1
水分平衡	shui fen ping heng	1
水分调节	shui fen tiao jie	1
水分循环	shui fen xun huan	1
水分状况	shui fen zhuang kuang	1
水浮莲	shui fu lian	1
水果罐头	shui guo guan tou	1
水果香精	shui guo xiang jing	1
水旱轮作	shui han lun zuo	1
水合霉素	shui he mei su	1
水葫芦	shui hu lu	1
水化	shui hua	1
水花生	shui hua sheng	1
水花生枯	shui hua sheng ku	1
水剂	shui ji	1
水浆	shui jiang	1
水浇	shui jiao	1
水浇地	shui jiao di	1
水利电力	shui li dian li	1
水利基础设施	shui li ji chu she shi	1
水利局	shui li ju	1
水利土壤改良	shui li tu rang gai liang	1
水帘	shui lian	1
睡莲	shui lian	1
水泥搅拌车	shui ni jiao ban che	1
水培	shui pei	1
水票制	shui piao zhi	1
水平抗性	shui ping kang xing	1
水平一体化	shui ping yi ti hua	1
水芹	shui qin	1
水杉	shui shan	1
水生生态系统	shui sheng sheng tai xi tong	1
水生蔬菜类	shui sheng shu cai lei	1
睡鼠	shui shu	1
水松	shui song	1
水田	shui tian	1
水田芥	shui tian jie	1
水土保持	shui tu bao chi	1
水土流失	shui tu liu shi	1
水稳性	shui wen xing	1
水文学	shui wen xue	1
水污染	shui wu ran	1
水污染监测	shui wu ran jian ce	1
水污染控制	shui wu ran kong zhi	1
水污染源	shui wu ran yuan	1
水杨菌胺	shui yang jun an	1
睡衣派对	shui yi pai dui	1
水域农业	shui yu nong ye	1
水质分析	shui zhi fen xi	1
水质评价	shui zhi ping jia	1
水渍状	shui zi zhuang	1
顺锄	shun chu	1
顺反子	shun fan zi	1
顺式氯氰菊酯	shun shi lv qing ju zhi	1
顺式氰戊菊酯	shun shi qing wu ju zhi	1
顺序排列	shun xu pai lie	1
硕丹	shuo dan	1
饲槽	si cao	1
丝大蓟马	si da ji ma	1
斯达姆	si da mu	1
死分活评	si fen huo ping	1
死分死记	si fen si ji	1
四氟甲醚菊酯	si fu jia mi ju zhi	1
思改革	si gai ge	1
丝核菌穗腐病	si he jun sui fu bing	1
丝黑穗病	si hei sui bing	1
四季葱	si ji cong	1
四季豆	si ji dou	1
四季桔	si ji ju	1
司库	si ku	1
丝兰	si lan	1
四棱豆	si leng dou	1
饲料食物	si liao shi wu	1
饲料作物	si liao zuo wu	1
四螨嗪	si man qin	1
四满嗪	si man qin	1
四霉素	si mei su	1
四密	si mi	1
死苗	si miao	1
死蘖	si nie	1
私人汽车	si ren qi che	1
死藤	si teng	1
四溴菊酯	si xiu ju zhi	1
四叶萍	si ye ping	1
私营成分	si ying cheng fen	1
饲用	si yong	1
饲用甘蓝	si yong gan lan	1
饲用谷物	si yong gu wu	1
饲用甜菜	si yong tian cai	1
四唑磺隆	si zuo huang long	1
送报员	song bao yuan	1
松材线虫	song cai xian chong	1
松粉	song fen	1
松碱柴油	song jian chai you	1
松雀鹰	song que ying	1
松土	song tu	1
松突圆蚧	song tu yuan jie	1
松脂酸钠	song zhi suan na	1
松脂酸铜	song zhi suan tong	1
松子油	song zi you	1
粟凹胫跳甲	su ao jing tiao jia	1
速保利	su bao li	1
速保利草除灵	su bao li cao chu ling	1
速达死	su da si	1
速敌合酯	su di he zhi	1
速敌杀	su di sha	1
速冻干燥	su dong gan zao	1
粟秆蝇	su gan ying	1
宿根蔗	su gen zhe	1
速灌	su guan	1
苏化	su hua	1
粟灰螟	su hui ming	1
速记打字员	su ji da zi yuan	1
速克灵	su ke ling	1
塑料大棚	su liao da peng	1
塑料塑胶	su liao su jiao	1
粟麦蛾	su mai e	1
速螨酮	su man tong	1
粟芒蝇	su mang ying	1
苏米硫磷	su mi liu lin	1
速灭虫	su mie chong	1
速灭敌	su mie di	1
速灭磷	su mie lin	1
速灭杀丁	su mie sha ding	1
速灭杀丁乳油	su mie sha ding ru you	1
速灭威	su mie wei	1
苏脲三号	su niao san hao	1
速排	su pai	1
塑盘	su pan	1
速扑灵	su pu ling	1
速扑杀	su pu sha	1
速杀硫磷	su sha liu lin	1
速杀畏	su sha wei	1
粟穗螟	su sui ming	1
苏铁	su tie	1
速效	su xiao	1
速效菊酯	su xiao ju zhi	1
速效扑虱灵	su xiao pu shi ling	1
速效性	su xiao xing	1
粟缘蝽	su yuan chun	1
苏云金杆菌	su yun jin gan jun	1
粟纵卷叶螟	su zong juan ye ming	1
蒜保	suan bao	1
酸橙	suan cheng	1
酸豆	suan dou	1
酸浆	suan jiang	1
酸角	suan jiao	1
酸角树	suan jiao shu	1
酸炼	suan lian	1
酸模	suan mo	1
酸模叶蓼	suan mo ye liao	1
酸性土	suan xing tu	1
酸雨	suan yu	1
酸枣	suan zao	1
酸渍	suan zi	1
髓部	sui bu	1
穗部	sui bu	1
穗长	sui chang	1
穗醋栗	sui cu li	1
穗大	sui da	1
穗发芽	sui fa ya	1
穗肥	sui fei	1
穗行法	sui hang fa	1
随机变量	sui ji bian liang	1
随机存取	sui ji cun qu	1
随机定律	sui ji ding lv	1
随机交配	sui ji jiao pei	1
随机模型	sui ji mo xing	1
随机排列	sui ji pai lie	1
随机取样	sui ji qu yang	1
随机区组	sui ji qu zu	1
随机误差	sui ji wu cha	1
随机样本	sui ji yang ben	1
随军记者	sui jun ji zhe	1
穗粒	sui li	1
穗粒肥	sui li fei	1
穗粒瘟	sui li wen	1
穗粒重	sui li zhong	1
穗密度	sui mi du	1
碎米莎草	sui mi suo cao	1
穗期	sui qi	1
穗数	sui shu	1
碎土块机	sui tu kuai ji	1
穗瘟	sui wen	1
穗小	sui xiao	1
穗行试验	sui xing shi yan	1
穗隐斑螟	sui yin ban ming	1
笋瓜	sun gua	1
孙蔓	sun man	1
损失估计	sun shi gu ji	1
损失率	sun shi lv	1
孙政才	sun zheng cai	1
缩节安	suo jie an	1
羧硫磷	suo liu lin	1
羧螨酮	suo man tong	1
缩株唑	suo zhu zuo	1
獭猴	ta hou	1
踏下加速踏板	ta xia jia su ta ban	1
酞胺硫磷	tai an liu lin	1
薹菜	tai cai	1
台地栽培	tai di zai pei	1
苔肥	tai fei	1
台风	tai feng	1
酞枯酸	tai ku suan	1
苔绿色	tai lv se	1
台湾稻螟	tai wan dao ming	1
台湾黄毒蛾	tai wan huang du e	1
台湾黄霉娥	tai wan huang mei e	1
台湾蝼蛄	tai wan lou gu	1
太阳辐射	tai yang fu she	1
太阳红外辐射	tai yang hong wai fu she	1
太阳能	tai yang neng	1
太阳能电池	tai yang neng dian chi	1
太阳能热水系统	tai yang neng re shui xi tong	1
太阳紫外辐射	tai yang zi wai fu she	1
碳铵	tan an	1
碳氮比	tan dan bi	1
炭腐病	tan fu bing	1
昙花	tan hua	1
炭灰色	tan hui se	1
炭疽病	tan ju bing	1
炭疽福美	tan ju fu mei	1
炭枯净	tan ku jing	1
碳氯灵	tan lv ling	1
贪青	tan qing	1
弹石路	tan shi lu	1
弹石路面	tan shi lu mian	1
碳水	tan shui	1
碳水化合物	tan shui hua he wu	1
碳酸氢铵	tan suan qing an	1
炭特灵	tan te ling	1
檀香煤病	tan xiang mei bing	1
碳循环	tan xun huan	1
糖草酯	tang cao zhi	1
唐菖蒲	tang chang pu	1
塘鹅	tang e	1
糖高粱	tang gao liang	1
唐家村	tang jia cun	1
塘间距	tang jian ju	1
塘距	tang ju	1
棠梨	tang li	1
糖料作物	tang liao zuo wu	1
塘留	tang liu	1
塘数	tang shu	1
糖用甜菜	tang yong tian cai	1
糖渍	tang zi	1
糖棕	tang zong	1
绦虫	tao chong	1
桃蠹螟	tao du ming	1
套耕	tao geng	1
陶管排水	tao guan pai shui	1
桃金娘科植物	tao jin niang ke zhi wu	1
桃小食心虫	tao xiao shi xin chong	1
桃蚜	tao ya	1
桃蛀螟	tao zhu ming	1
套作	tao zuo	1
特丙森锌	te bing sen xin	1
特草克	te cao ke	1
特丁津	te ding jin	1
特丁净	te ding jing	1
特丁硫磷	te ding liu lin	1
特丁通	te ding tong	1
特福力	te fu li	1
特富灵	te fu ling	1
特灭威	te mie wei	1
特谱丹	te pu dan	1
特谱唑	te pu zuo	1
特普唑	te pu zuo	1
特色宣明	te se xuan ming	1
特色优势产业	te se you shi chan ye	1
特殊配合力	te shu pei he li	1
特性特性	te xing te xing	1
特许权税	te xu quan shui	1
特讯	te xun	1
特征提取	te zheng ti qu	1
特征向量	te zheng xiang liang	1
特征值	te zheng zhi	1
提出修正案	ti chu xiu zheng an	1
提纯复壮	ti chun fu zhuang	1
替代性能源	ti dai xing neng yuan	1
鹈鹕	ti hu	1
提苗	ti miao	1
提苗肥	ti miao fei	1
涕灭威	ti mie wei	1
提莫菲维小麦	ti mo fei wei xiao mai	1
梯田	ti tian	1
梯田农业	ti tian nong ye	1
提温	ti wen	1
体细胞接合	ti xi bao jie he	1
体细胞杂交	ti xi bao za jiao	1
甜包谷	tian bao gu	1
甜菜	tian cai	1
甜菜安	tian cai an	1
甜菜宁	tian cai ning	1
甜菜潜叶蝇	tian cai qian ye ying	1
甜菜收获机	tian cai shou huo ji	1
甜菜象虫	tian cai xiang chong	1
甜菜夜蛾	tian cai ye e	1
田茶黄硬蓟马	tian cha huang ying ji ma	1
田产	tian chan	1
甜橙	tian cheng	1
甜脆	tian cui	1
甜脆豆	tian cui dou	1
田端大蓟马	tian duan da ji ma	1
天蛾	tian e	1
甜粉型	tian fen xing	1
甜高粮	tian gao liang	1
甜瓜	tian gua	1
田禾蓟马	tian he ji ma	1
田灰地种蝇	tian hui di zhong ying	1
田间	tian jian	1
田间地头	tian jian di tou	1
田间沟渠	tian jian gou qu	1
田间管理	tian jian guan li	1
田间技术	tian jian ji shu	1
田间配套	tian jian pei tao	1
田间去杂	tian jian qu za	1
田间释放	tian jian shi fang	1
田间试验	tian jian shi yan	1
田间需水量	tian jian xu shui liang	1
甜椒	tian jiao	1
田菁	tian jing	1
田块	tian kuai	1
田毛	tian mao	1
天门冬	tian men dong	1
田面	tian mian	1
田棉铃虫	tian mian ling chong	1
甜糯	tian nuo	1
天然堤岸	tian ran di an	1
天然温泉	tian ran wen quan	1
天人菊	tian ren ju	1
田薯	tian shu	1
甜酸角	tian suan jiao	1
田尾巴	tian wei ba	1
田斜纹夜峨	tian xie wen ye e	1
田旋花	tian xuan hua	1
田蚜虫	tian ya chong	1
田亚洲玉米螟	tian ya zhou yu mi ming	1
甜叶菊	tian ye ju	1
田叶螨	tian ye man	1
甜玉米	tian yu mi	1
天杂	tian za	1
甜质型	tian zhi xing	1
条按	tiao an	1
调吡脲	tiao bi niao	1
条播	tiao bo	1
条播机	tiao bo ji	1
条蜂缘蝽	tiao feng yuan chun	1
调果酸	tiao guo suan	1
挑花窗帘	tiao hua chuang lian	1
调环酸	tiao huan suan	1
跳甲	tiao jia	1
调节剂	tiao jie ji	1
调节磷	tiao jie lin	1
调料作物	tiao liao zuo wu	1
跳盲蝽	tiao mang chun	1
调嘧醇	tiao mi chun	1
条螟	tiao ming	1
挑旗	tiao qi	1
条沙叶蝉	tiao sha ye chan	1
条施	tiao shi	1
条纹矮缩病	tiao wen ai suo bing	1
条纹病	tiao wen bing	1
条纹病毒病	tiao wen bing du bing	1
条纹叶枯病	tiao wen ye ku bing	1
条锈病	tiao xiu bing	1
条栽	tiao zai	1
调种	tiao zhong	1
贴茬	tie cha	1
贴梗海棠	tie geng hai tang	1
铁壳麦	tie ke mai	1
铁灭克	tie mie ke	1
铁杉	tie shan	1
铁线蕨	tie xian jue	1
烃菊酯	ting ju zhi	1
庭园布置	ting yuan bu zhi	1
庭院经济	ting yuan jing ji	1
铜大师	tong da shi	1
通单	tong dan	1
同分异物现象	tong fen yi wu xian xiang	1
通风井	tong feng jing	1
通风透光	tong feng tou guang	1
统计量	tong ji liang	1
统计学家	tong ji xue jia	1
通径系数	tong jing xi shu	1
同菌唑	tong jun zuo	1
痛苦流涕	tong ku liu ti	1
统揽工作全局	tong lan gong zuo quan ju	1
同类群	tong lei qun	1
铜绿金龟	tong lv jin gui	1
统扑净	tong pu jing	1
同田	tong tian	1
同田对比	tong tian dui bi	1
通透性	tong tou xing	1
通透性土壤	tong tou xing tu rang	1
同位素	tong wei su	1
同位素分离	tong wei su fen li	1
同位素丰度	tong wei su feng du	1
同位素富集度	tong wei su fu ji du	1
同位素交换	tong wei su jiao huan	1
同位素稀释分析	tong wei su xi shi fen xi	1
同位素药盒	tong wei su yao he	1
同型巴蜗牛	tong xing ba wo niu	1
通译者	tong yi zhe	1
通用机架	tong yong ji jia	1
同源多倍体	tong yuan duo bei ti	1
同源四倍体	tong yuan si bei ti	1
铜制剂	tong zhi ji	1
同质性	tong zhi xing	1
同质性测验	tong zhi xing ce yan	1
同株	tong zhu	1
透翅天蛾	tou chi tian e	1
投稿家	tou gao jia	1
头号大标题	tou hao da biao ti	1
透习脱	tou xi tuo	1
透雨	tou yu	1
投资信托	tou zi xin tuo	1
突变第二代	tu bian di er dai	1
突变第一代	tu bian di yi dai	1
突变点	tu bian dian	1
突变频率	tu bian pin lv	1
突变谱	tu bian pu	1
突变热点	tu bian re dian	1
突变体间杂交种	tu bian ti jian za jiao zhong	1
突变体种质库	tu bian ti zhong zhi ku	1
突变易发点	tu bian yi fa dian	1
突变子	tu bian zi	1
土布散	tu bu san	1
荼草胺	tu cao an	1
土层深厚	tu ceng shen hou	1
土传	tu chuan	1
土传病害	tu chuan bing hai	1
土地	tu di	1
土地报酬	tu di bao chou	1
土地承包	tu di cheng bao	1
土地处理系统	tu di chu li xi tong	1
土地分级	tu di fen ji	1
土地分类	tu di fen lei	1
土地覆盖分类	tu di fu gai fen lei	1
土地改革	tu di gai ge	1
土地改良	tu di gai liang	1
土地公有制	tu di gong you zhi	1
土地构成	tu di gou cheng	1
土地管理	tu di guan li	1
土地规划	tu di gui hua	1
土地耗竭	tu di hao jie	1
土地开发	tu di kai fa	1
土地开垦	tu di kai ken	1
土地利用方式	tu di li yong fang shi	1
土地利用结构	tu di li yong jie gou	1
土地利用率	tu di li yong lv	1
土地买卖	tu di mai mai	1
土地面积	tu di mian ji	1
土地没收	tu di mo shou	1
土地评价	tu di ping jia	1
土地平整	tu di ping zheng	1
土地生产力	tu di sheng chan li	1
土地生产率	tu di sheng chan lv	1
土地生产能力	tu di sheng chan neng li	1
土地适宜性	tu di shi yi xing	1
土地私有制	tu di si you zhi	1
土地所有制	tu di suo you zhi	1
土地退化	tu di tui hua	1
土地拥有者	tu di yong you zhe	1
土地征收	tu di zheng shou	1
土地治理	tu di zhi li	1
土地质量	tu di zhi liang	1
土地制图单元	tu di zhi tu dan yuan	1
土地转包	tu di zhuan bao	1
土地资本	tu di zi ben	1
土地租佃	tu di zu dian	1
土地租用人	tu di zu yong ren	1
土豆地	tu dou di	1
兔耳花	tu er hua	1
土耳其玉色	tu er qi yu shai	1
土肥工作站	tu fei gong zuo zhan	1
土肥站	tu fei zhan	1
土瓜地	tu gua di	1
秃尖	tu jian	1
土菌灵	tu jun ling	1
土菌消	tu jun xiao	1
土库曼跳甲	tu ku man tiao jia	1
土块	tu kuai	1
土粒散	tu li san	1
土木技师	tu mu ji shi	1
土平	tu ping	1
土壤	tu rang	1
土壤比热	tu rang bi re	1
土壤比重	tu rang bi zhong	1
土壤不匀性	tu rang bu yun xing	1
土壤差异	tu rang cha yi	1
土壤处理	tu rang chu li	1
土壤处置	tu rang chu zhi	1
土壤处置系统	tu rang chu zhi xi tong	1
土壤地带性	tu rang di dai xing	1
土壤调查	tu rang diao cha	1
土壤冻结	tu rang dong jie	1
土壤肥力	tu rang fei li	1
土壤风蚀	tu rang feng shi	1
土壤腐殖质	tu rang fu zhi zhi	1
土壤改良	tu rang gai liang	1
土壤改良剂	tu rang gai liang ji	1
土壤耕性	tu rang geng xing	1
土壤耕作制	tu rang geng zuo zhi	1
土壤含水量	tu rang han shui liang	1
土壤呼吸	tu rang hu xi	1
土壤环境	tu rang huan jing	1
土壤碱度	tu rang jian du	1
土壤胶体	tu rang jiao ti	1
土壤结持度	tu rang jie chi du	1
土壤结持性	tu rang jie chi xing	1
土壤结构	tu rang jie gou	1
土壤结皮	tu rang jie pi	1
土壤紧实度	tu rang jin shi du	1
土壤净化	tu rang jing hua	1
土壤空气	tu rang kong qi	1
土壤孔隙度	tu rang kong xi du	1
土壤类型	tu rang lei xing	1
土壤毛管作用	tu rang mao guan zuo yong	1
土壤排水	tu rang pai shui	1
土壤培肥	tu rang pei fei	1
土壤侵蚀	tu rang qin shi	1
土壤热通量	tu rang re tong liang	1
土壤溶液	tu rang rong ye	1
土壤容重	tu rang rong zhong	1
土壤渗透性	tu rang shen tou xing	1
土壤生产力	tu rang sheng chan li	1
土壤生态系统	tu rang sheng tai xi tong	1
土壤生态学	tu rang sheng tai xue	1
土壤生物	tu rang sheng wu	1
土壤湿度	tu rang shi du	1
土壤适耕性	tu rang shi geng xing	1
土壤水	tu rang shui	1
土壤水分	tu rang shui fen	1
土壤水分特性	tu rang shui fen te xing	1
土壤水分胁迫	tu rang shui fen xie po	1
土壤水势	tu rang shui shi	1
土壤酸度	tu rang suan du	1
土壤特性	tu rang te xing	1
土壤条件	tu rang tiao jian	1
土壤通气	tu rang tong qi	1
土壤团聚体	tu rang tuan ju ti	1
土壤退化	tu rang tui hua	1
土壤温度	tu rang wen du	1
土壤物理性质	tu rang wu li xing zhi	1
土壤污染	tu rang wu ran	1
土壤无效水	tu rang wu xiao shui	1
土壤吸力	tu rang xi li	1
土壤吸湿水	tu rang xi shi shui	1
土壤系统	tu rang xi tong	1
土壤有机质	tu rang you ji zhi	1
土壤有效水	tu rang you xiao shui	1
土壤元素背景值	tu rang yuan su bei jing zhi	1
土壤蒸发计	tu rang zheng fa ji	1
土壤质地	tu rang zhi di	1
土壤质量评价	tu rang zhi liang ping jia	1
土壤重力水	tu rang zhong li shui	1
土壤自由水	tu rang zi you shui	1
土壤作物大气连续体	tu rang zuo wu da qi lian xu ti	1
土斯特	tu si te	1
菟丝子	tu si zi	1
菟丝子为害	tu si zi wei hai	1
土细	tu xi	1
土习脱	tu xi tuo	1
图象处理	tu xiang chu li	1
图象合成	tu xiang he cheng	1
土样	tu yang	1
屠莠胺	tu you an	1
土杂肥	tu za fei	1
土杂鸡	tu za ji	1
徒长	tu zhang	1
团碑	tuan bei	1
团棵	tuan ke	1
团棵期	tuan ke qi	1
团粒	tuan li	1
团粒结构	tuan li jie gou	1
湍流山溪	tuan liu shan xi	1
推广品种	tui guang pin zhong	1
推广体系	tui guang ti xi	1
推广站	tui guang zhan	1
推广种子	tui guang zhong zi	1
囤兵	tun bing	1
豚草	tun cao	1
屯玉	tun yu	1
托布津	tuo bu jin	1
脱臭	tuo chou	1
托尔克	tuo er ke	1
脱肥	tuo fei	1
脱果硅	tuo guo gui	1
脱胶	tuo jiao	1
脱蜡	tuo la	1
拖拉机牵引特性	tuo la ji qian yin te xing	1
脱粒	tuo li	1
脱粒机	tuo li ji	1
托泥板	tuo ni ban	1
托佩克	tuo pei ke	1
拖欠款项	tuo qian kuan xiang	1
脱壳	tuo qiao	1
脱水	tuo shui	1
脱水蔬菜	tuo shui shu cai	1
脱酸	tuo suan	1
拖拖曳	tuo tuo ye	1
脱盐	tuo yan	1
脱氧胞苷酸	tuo yang bao gan suan	1
脱氧核糖核酸	tuo yang he tang he suan	1
脱氧鸟苷酸	tuo yang niao gan suan	1
脱氧腺苷酸	tuo yang xian gan suan	1
挖沟	wa gou	1
挖田	wa tian	1
蛙眼病	wa yan bing	1
外出务工	wai chu wu gong	1
外汇兑换券	wai hui dui huan quan	1
外寄生物	wai ji sheng wu	1
外激素	wai ji su	1
外居地主	wai ju di zhu	1
弯孢霉穗腐病	wan bao mei sui fu bing	1
晚播	wan bo	1
晚茬	wan cha	1
弯刺黑蝽	wan ci hei chun	1
万丛	wan cong	1
万带兰	wan dai lan	1
晚稻	wan dao	1
豌豆	wan dou	1
豌豆尖	wan dou jian	1
豌豆潜叶蝇	wan dou qian ye ying	1
豌豆象	wan dou xiang	1
万公斤	wan gong jin	1
晚季	wan ji	1
万菌灵	wan jun ling	1
万灵	wan ling	1
万霉灵	wan mei ling	1
万苗	wan miao	1
万亩	wan mu	1
万能手钳	wan neng shou qian	1
晚秋作物	wan qiu zuo wu	1
完全肥料	wan quan fei liao	1
完全随机设计	wan quan sui ji she ji	1
晚收	wan shou	1
万寿菊	wan shou ju	1
完熟	wan shu	1
完熟初期	wan shu chu qi	1
晚熟性	wan shu xing	1
晚霜	wan shuang	1
晚香玉	wan xiang yu	1
弯腰树	wan yao shu	1
晚疫病	wan yi bing	1
万株	wan zhu	1
王百合	wang bai he	1
网斑病	wang ban bing	1
旺长	wang chang	1
旺长期	wang chang qi	1
旺苗	wang miao	1
网目拟地甲	wang mu ni di jia	1
忘年餐会	wang nian can hui	1
王铜	wang tong	1
王棕	wang zong	1
威霸	wei ba	1
威百亩	wei bai mu	1
尾孢菌叶斑病	wei bao jun ye ban bing	1
微波干燥	wei bo gan zao	1
微波遥感	wei bo yao gan	1
胃毒杀虫剂	wei du sha chong ji	1
威尔磷	wei er lin	1
微放射性自显影术	wei fang she xing zi xian ying shu	1
微肥	wei fei	1
萎福	wei fu	1
卫福	wei fu	1
薇甘菊	wei gan ju	1
维稿结实	wei gao jie shi	1
围沟	wei gou	1
微管蚜	wei guan ya	1
危害程度	wei hai cheng du	1
危害程度预测	wei hai cheng du yu ce	1
危害分析	wei hai fen xi	1
微剂量测定	wei ji liang ce ding	1
微机信息系统	wei ji xin xi xi tong	1
微碱性	wei jian xing	1
威菌磷	wei jun lin	1
未考好	wei kao hao	1
围垦地	wei ken di	1
围坑灌	wei keng guan	1
维立士	wei li shi	1
微量元素	wei liang yuan su	1
微量元素肥料	wei liang yuan su fei liao	1
委陵菜	wei ling cai	1
威罗生	wei luo sheng	1
微绿	wei lv	1
维苗	wei miao	1
萎蔫	wei nian	1
萎蔫病毒病	wei nian bing du bing	1
卫农	wei nong	1
威农	wei nong	1
委培式	wei pei shi	1
微生物杀虫剂	wei sheng wu sha chong ji	1
卫生性	wei sheng xing	1
卫生纸架	wei sheng zhi jia	1
喂食器	wei shi qi	1
微酸性	wei suan xing	1
萎缩不实症	wei suo bu shi zheng	1
微体繁殖	wei ti fan zhi	1
围田	wei tian	1
圩田	wei tian	1
未通过考试	wei tong guo kao shi	1
维西黄壳麦	wei xi huang ke mai	1
维西县	wei xi xian	1
微效基因抗	wei xiao ji yin kang	1
微型胶卷	wei xing jiao juan	1
萎锈灵	wei xiu ling	1
位置灯	wei zhi deng	1
纹白蝶	wen bai die	1
稳产性	wen chan xing	1
稳产性好	wen chan xing hao	1
温床	wen chuang	1
温床育苗	wen chuang yu miao	1
温床栽培	wen chuang zai pei	1
温带	wen dai	1
温带多雨气候	wen dai duo yu qi hou	1
温带气候	wen dai qi hou	1
稳定剂	wen ding ji	1
稳定遗传	wen ding yi chuan	1
温度雨量图	wen du yu liang tu	1
文冠果	wen guan guo	1
稳花肥	wen hua fei	1
纹黄蝶	wen huang die	1
文具胶带	wen ju jiao dai	1
瘟克星	wen ke xing	1
纹枯病	wen ku bing	1
纹枯利	wen ku li	1
纹理	wen li	1
稳磷	wen lin	1
纹霉清	wen mei qing	1
纹霉星	wen mei xing	1
纹螟丹	wen ming dan	1
稳杀得	wen sha de	1
温室	wen shi	1
温室白粉虱	wen shi bai fen shi	1
温湿度	wen shi du	1
温室二氧化碳加浓	wen shi er yang hua tan jia nong	1
温室管理	wen shi guan li	1
温室加热	wen shi jia re	1
温室通风	wen shi tong feng	1
温湿图	wen shi tu	1
温室效应	wen shi xiao ying	1
温室栽培	wen shi zai pei	1
文殊兰	wen shu lan	1
文献片	wen xian pian	1
文学教师	wen xue jiao shi	1
纹叶蝉	wen ye chan	1
文艺评论	wen yi ping lun	1
蚊蝇醚	wen ying mi	1
温州蜜柑	wen zhou mi gan	1
温周期	wen zhou qi	1
文竹	wen zhu	1
蕹菜	weng cai	1
肟草安	wo cao an	1
肟草酮	wo cao tong	1
喔草酯	wo cao zhi	1
渥堆	wo dui	1
肟菌酯	wo jun zhi	1
窝留	wo liu	1
肟硫磷	wo liu lin	1
蜗螺杀	wo luo sha	1
肟螨酯	wo man zhi	1
蜗牛散	wo niu san	1
五拌双	wu ban shuang	1
五笔画	wu bi hua	1
无壁犁	wu bi li	1
无病虫	wu bing chong	1
无病毒果树	wu bing du guo shu	1
无产者	wu chan zhe	1
武定大白豆	wu ding da bai dou	1
武定鸡	wu ding ji	1
屋顶平台	wu ding ping tai	1
武定狮子山	wu ding shi zi shan	1
武定壮鸡	wu ding zhuang ji	1
乌鸫	wu dong	1
乌东德	wu dong de	1
舞毒蛾	wu du e	1
五多	wu duo	1
五多邻	wu duo lin	1
芜飞净	wu fei jing	1
无稃毛	wu fu mao	1
无公害	wu gong hai	1
无公害农产品	wu gong hai nong chan pin	1
无公害生产	wu gong hai sheng chan	1
无公害蔬菜	wu gong hai shu cai	1
无害化	wu hai hua	1
物候观测	wu hou guan ce	1
物候历	wu hou li	1
物候谱	wu hou pu	1
物候期	wu hou qi	1
物候图	wu hou tu	1
物候学	wu hou xue	1
物候学定律	wu hou xue ding lv	1
无花果	wu hua guo	1
无花果叶瓜	wu hua guo ye gua	1
戊环隆	wu huan long	1
戊环唑	wu huan zuo	1
雾灰色	wu hui se	1
无机肥	wu ji fei	1
无机肥料	wu ji fei liao	1
无机废水	wu ji fei shui	1
无记名支票	wu ji ming zhi piao	1
物价管制	wu jia guan zhi	1
无结构土壤	wu jie gou tu rang	1
芜菁	wu jing	1
雾景	wu jing	1
芜菁甘蓝	wu jing gan lan	1
乌桕	wu jiu	1
戊菊酯	wu ju zhi	1
戊菌隆	wu jun long	1
戊菌唑	wu jun zuo	1
乌拉草	wu la cao	1
乌榄	wu lan	1
物理防治	wu li fang zhi	1
物理诱变因素	wu li you bian yin su	1
五敛子	wu lian zi	1
武凉	wu liang	1
五氯拌种双	wu lv ban zhong shuang	1
五氯多	wu lv duo	1
五氯酚	wu lv fen	1
五氯硝基苯	wu lv xiao ji ben	1
五氯溴	wu lv xiu	1
无苗	wu miao	1
污泥	wu ni	1
污染监测	wu ran jian ce	1
污染水平	wu ran shui ping	1
污染物	wu ran wu	1
污染预测	wu ran yu ce	1
污染源	wu ran yuan	1
无融合生殖	wu rong he sheng zhi	1
无声片	wu sheng pian	1
无收	wu shou	1
无霜	wu shuang	1
无霜带	wu shuang dai	1
无霜期	wu shuang qi	1
无霜日	wu shuang ri	1
污水处理	wu shui chu li	1
污水改良	wu shui gai liang	1
污水改良与再用	wu shui gai liang yu zai yong	1
污水灌溉	wu shui guan gai	1
污水灌溉系统	wu shui guan gai xi tong	1
乌丝越桔	wu si yue ju	1
雾凇	wu song	1
戊酸氰醚酯	wu suan qing mi zhi	1
乌塌菜	wu ta cai	1
乌檀	wu tan	1
无头甘蓝	wu tou gan lan	1
无土栽培	wu tu zai pei	1
屋瓦顶	wu wa ding	1
无网蚜	wu wang ya	1
无限花序	wu xian hua xu	1
无限生长	wu xian sheng zhang	1
戊硝酚	wu xiao fen	1
无效分蘖	wu xiao fen nie	1
无效假设	wu xiao jia she	1
无效降水量	wu xiao jiang shui liang	1
无性第二代	wu xing di er dai	1
无性第一代	wu xing di yi dai	1
无性繁殖	wu xing fan zhi	1
无性繁殖系	wu xing fan zhi xi	1
无性系砧木	wu xing xi zhen mu	1
无性杂交	wu xing za jiao	1
五溴	wu xiu	1
无须鳕	wu xu xue	1
五氧化二磷	wu yang hua er lin	1
武夷菌素	wu yi jun su	1
武夷霉素	wu yi mei su	1
武引	wu yin	1
戊唑醇	wu zuo chun	1
细胞工程	xi bao gong cheng	1
细胞培养	xi bao pei yang	1
细胞器移植	xi bao qi yi zhi	1
细胞亲和力	xi bao qin he li	1
细胞融合	xi bao rong he	1
细胞系	xi bao xi	1
细胞质不亲和性	xi bao zhi bu qin he xing	1
细胞质突变	xi bao zhi tu bian	1
细胞质雄性不育	xi bao zhi xiong xing bu yu	1
西北麦蝽	xi bei mai chun	1
惜别会	xi bie hui	1
烯丙苯噻唑	xi bing ben sai zuo	1
席草	xi cao	1
西草净	xi cao jing	1
烯草酮	xi cao tong	1
烯虫酯	xi chong zhi	1
稀点昌灯峨	xi dian chang deng e	1
稀点雪灯蛾	xi dian xue deng e	1
烯啶虫胺	xi ding chong an	1
西斗星	xi dou xing	1
吸肥	xi fei	1
细粪	xi fen	1
细粪土	xi fen tu	1
吸附脱色	xi fu tuo se	1
喜光	xi guang	1
喜旱莲子草	xi han lian zi cao	1
烯禾定	xi he ding	1
西葫芦	xi hu lu	1
西花蓟马	xi hua ji ma	1
熄火装置	xi huo zhuang zhi	1
细菌	xi jun	1
细菌斑疹病	xi jun ban zhen bing	1
细菌角斑病	xi jun jiao ban bing	1
细菌条斑病	xi jun tiao ban bing	1
烯菌酮	xi jun tong	1
细菌萎蔫病	xi jun wei nian bing	1
细菌性斑点病	xi jun xing ban dian bing	1
细菌性谷枯病	xi jun xing gu ku bing	1
细菌性褐斑病	xi jun xing he ban bing	1
细菌性褐条病	xi jun xing he tiao bing	1
细菌性黑斑病	xi jun xing hei ban bing	1
细菌性红条病	xi jun xing hong tiao bing	1
细菌性基腐病	xi jun xing ji fu bing	1
细菌性角斑病	xi jun xing jiao ban bing	1
细菌性茎腐病	xi jun xing jing fu bing	1
细菌性枯萎病	xi jun xing ku wei bing	1
细菌性青枯病	xi jun xing qing ku bing	1
细菌性痰病	xi jun xing tan bing	1
细菌性条斑病	xi jun xing tiao ban bing	1
细菌性条纹病	xi jun xing tiao wen bing	1
细菌性叶斑病	xi jun xing ye ban bing	1
希腊拉丁方设计	xi la la ding fang she ji	1
细粒	xi li	1
细粒种	xi li zhong	1
洗麦	xi mai	1
西梅脱	xi mei tuo	1
吸墨纸	xi mo zhi	1
系谱	xi pu	1
系谱法	xi pu fa	1
细弱枝	xi ruo zhi	1
西沙尔麻	xi sha er ma	1
细筛	xi shai	1
细少	xi shao	1
喜湿	xi shi	1
吸湿系数	xi shi xi shu	1
稀释系数	xi shi xi shu	1
吸收剂量	xi shou ji liang	1
吸水势	xi shui shi	1
系统分析员	xi tong fen xi yuan	1
细土	xi tu	1
喜温	xi wen	1
喜温蔬菜	xi wen shu cai	1
烯肟菌胺	xi wo jun an	1
烯肟菌酯	xi wo jun zhi	1
烯酰吗啉	xi xian ma lin	1
细香葱	xi xiang cong	1
烯效唑	xi xiao zuo	1
细胸金针虫	xi xiong jin zhen chong	1
西洋菜	xi yang cai	1
西洋梨	xi yang li	1
细叶芹	xi ye qin	1
细叶益母草	xi ye yi mu cao	1
细茵性茎腐病	xi yin xing jing fu bing	1
稀植	xi zhi	1
西装师傅	xi zhuang shi fu	1
烯唑醇	xi zuo chun	1
夏播	xia bo	1
夏播作物	xia bo zuo wu	1
夏大豆	xia da dou	1
夏剪	xia jian	1
夏收作物	xia shou zuo wu	1
下透雨	xia tou yu	1
下行列车	xia xing lie che	1
狭叶青蒿	xia ye qing hao	1
夏玉米	xia yu mi	1
下扎	xia zha	1
下籽	xia zi	1
酰胺磷	xian an lin	1
酰胺态氮肥	xian an tai dan fei	1
酰胺唑	xian an zuo	1
苋白锈病	xian bai xiu bing	1
苋菜	xian cai	1
鲜采	xian cai	1
县财政局	xian cai zheng ju	1
线虫	xian chong	1
线虫病	xian chong bing	1
线虫磷	xian chong lin	1
闲锄	xian chu	1
现贷价格	xian dai jia ge	1
现代农业	xian dai nong ye	1
现代农业发展	xian dai nong ye fa zhan	1
籼稻	xian dao	1
县地税局	xian di shui ju	1
县地震局	xian di zhen ju	1
限定价格	xian ding jia ge	1
县发改委	xian fa gai wei	1
鲜粉红色	xian fen hong se	1
先锋走廊	xian feng zou lang	1
先锋作物	xian feng zuo wu	1
县供销社	xian gong xiao she	1
县广播电视局	xian guang bo dian shi ju	1
县国土资源局	xian guo tu zi yuan ju	1
县环境保护局	xian huan jing bao hu ju	1
现黄	xian huang	1
酰基脲类	xian ji niao lei	1
县计生委	xian ji sheng wei	1
县纪委办	xian ji wei ban	1
现金出纳簿	xian jin chu na bu	1
现金价格	xian jin jia ge	1
现金配股	xian jin pei gu	1
冼净	xian jing	1
县经济委员会	xian jing ji wei yuan hui	1
籼粳交	xian jing jiao	1
线菌清	xian jun qing	1
县科技局	xian ke ji ju	1
仙客来	xian ke lai	1
县科协	xian ke xie	1
现款结存	xian kuan jie cun	1
现蕾	xian lei	1
现蕾期	xian lei qi	1
线粒体互补	xian li ti hu bu	1
县粮食局	xian liang shi ju	1
县林业局	xian lin ye ju	1
鲜绿色	xian lv se	1
线螨磷	xian man lin	1
纤毛状	xian mao zhuang	1
籼米	xian mi	1
酰嘧磺隆	xian mi huang long	1
县民宗局	xian min zong ju	1
县农广校	xian nong guang xiao	1
闲农禾草拿	xian nong he cao na	1
县农环站	xian nong huan zhan	1
县农机化学校	xian nong ji hua xue xiao	1
县农机监理站	xian nong ji jian li zhan	1
县农机推广站	xian nong ji tui guang zhan	1
县农技中心	xian nong ji zhong xin	1
县农经站	xian nong jing zhan	1
县农业局	xian nong ye ju	1
显热通量	xian re tong liang	1
县人大办	xian ren da ban	1
仙人掌果	xian ren zhang guo	1
县生创办	xian sheng chuang ban	1
鲜食	xian shi	1
显示装置	xian shi zhuang zhi	1
县水电局	xian shui dian ju	1
县水利局	xian shui li ju	1
鲜穗	xian sui	1
险弯	xian wan	1
纤维素	xian wei su	1
纤维植物	xian wei zhi wu	1
纤维作物	xian wei zuo wu	1
县文体局	xian wen ti ju	1
显纹纵卷叶螟	xian wen zong juan ye ming	1
县消防大队	xian xiao fang da dui	1
县信访局	xian xin fang ju	1
县新农办	xian xin nong ban	1
县新农合办	xian xin nong he ban	1
线性回归	xian xing hui gui	1
线性可加模型	xian xing ke jia mo xing	1
线性能量转换	xian xing neng liang zhuan huan	1
线性相关	xian xing xiang guan	1
显性效应	xian xing xiao ying	1
县畜牧局	xian xu mu ju	1
县烟草公司	xian yan cao gong si	1
县医保中心	xian yi bao zhong xin	1
县移民局	xian yi min ju	1
县政策研究室	xian zheng ce yan jiu shi	1
县政协办	xian zheng xie ban	1
仙治	xian zhi	1
县植保站	xian zhi bao zhan	1
限制性内切核酸酶	xian zhi xing nei qie he suan mei	1
鲜重	xian zhong	1
县种子管理站	xian zhong zi guan li zhan	1
显著性测验	xian zhu xing ce yan	1
香草兰	xiang cao lan	1
香椿	xiang chun	1
乡村城市化	xiang cun cheng shi hua	1
乡村人口	xiang cun ren kou	1
镶刀菌穗腐病	xiang dao jun sui fu bing	1
相对生物效应	xiang dui sheng wu xiao ying	1
相对湿度	xiang dui shi du	1
香榧	xiang fei	1
乡风文明	xiang feng wen ming	1
香港莎莉公司	xiang gang sha li gong si	1
厢沟	xiang gou	1
香菇	xiang gu	1
相关系数	xiang guan xi shu	1
相关指数	xiang guan zhi shu	1
橡胶白蚁	xiang jiao bai yi	1
香蕉树	xiang jiao shu	1
橡胶树	xiang jiao shu	1
香蕉园	xiang jiao yuan	1
橡胶作物	xiang jiao zuo wu	1
香菌	xiang jun	1
乡科级	xiang ke ji	1
香料作物	xiang liao zuo wu	1
相邻等级减价	xiang lin deng ji jian jia	1
香柳	xiang liu	1
香茅	xiang mao	1
厢面	xiang mian	1
橡皮树	xiang pi shu	1
香蒲	xiang pu	1
镶嵌图	xiang qian tu	1
向前行驶	xiang qian xing shi	1
香芹菜	xiang qin cai	1
香芹酚	xiang qin fen	1
向日葵	xiang ri kui	1
箱式照相机	xiang shi zhao xiang ji	1
香石竹	xiang shi zhu	1
橡树果	xiang shu guo	1
香豌豆	xiang wan dou	1
香豌豆花	xiang wan dou hua	1
香辛类蔬菜	xiang xin lei shu cai	1
香雪兰	xiang xue lan	1
相映争辉	xiang ying zheng hui	1
象元	xiang yuan	1
香橼	xiang yuan	1
湘杂棉	xiang za mian	1
箱栽	xiang zai	1
香樟	xiang zhang	1
乡镇经济	xiang zhen jing ji	1
小扁豆	xiao bian dou	1
消病灵	xiao bing ling	1
小菜蛾	xiao cai e	1
小蚕	xiao can	1
小苍兰	xiao cang lan	1
硝虫硫磷	xiao chong liu lin	1
小锄头	xiao chu tou	1
小春作物	xiao chun zuo wu	1
小地老虎	xiao di lao hu	1
消毒剂	xiao du ji	1
消毒灭源	xiao du mie yuan	1
小段包工	xiao duan bao gong	1
小额信贷	xiao e xin dai	1
小飞蓬	xiao fei peng	1
小分蘖	xiao fen nie	1
消光系数	xiao guang xi shu	1
小龟甲	xiao gui jia	1
小黑麦	xiao hei mai	1
小红蛱蝶	xiao hong jia die	1
小花鬼针草	xiao hua gui zhen cao	1
硝化抑制剂	xiao hua yi zhi ji	1
硝化作用	xiao hua zuo yong	1
硝基腐殖酸铜	xiao ji fu zhi suan tong	1
小蓟灰斑病	xiao ji hui ban bing	1
小荚	xiao jia	1
小茧蜂	xiao jian feng	1
小井	xiao jing	1
小康住宅建设	xiao kang zhu zhai jian she	1
小喇叭口期	xiao la ba kou qi	1
小莱豆	xiao lai dou	1
小粒	xiao li	1
小礼拜堂	xiao li bai tang	1
小粒豆	xiao li dou	1
肖藜泉蝇	xiao li quan ying	1
小粒种	xiao li zhong	1
小羚羊	xiao ling yang	1
小旅行车	xiao lv xing che	1
小绿叶蝉	xiao lv ye chan	1
小麦	xiao mai	1
小麦赤霉病	xiao mai chi mei bing	1
小麦搭配	xiao mai da pei	1
小麦粉	xiao mai fen	1
小麦高效分子育种技术	xiao mai gao xiao fen zi yu zhong ji shu	1
小麦管蓟马	xiao mai guan ji ma	1
小麦旺长	xiao mai wang chang	1
小麦吸浆虫	xiao mai xi jiang chong	1
小麦研究	xiao mai yan jiu	1
小麦叶蝉	xiao mai ye chan	1
小麦叶锈病	xiao mai ye xiu bing	1
小麦遗传改良	xiao mai yi chuan gai liang	1
小麦遗传转化	xiao mai yi chuan zhuan hua	1
小满	xiao man	1
消螨多	xiao man duo	1
消螨粉	xiao man fen	1
消螨普	xiao man pu	1
消螨通	xiao man tong	1
小米	xiao mi	1
小苗	xiao miao	1
小畦	xiao qi	1
小气候	xiao qi hou	1
小球菌核病	xiao qiu jun he bing	1
小区排列	xiao qu pai lie	1
小墒	xiao shang	1
销售价格	xiao shou jia ge	1
硝酸铵	xiao suan an	1
硝酸钙	xiao suan gai	1
硝酸钾	xiao suan jia	1
硝酸态氮	xiao suan tai dan	1
硝态氮	xiao tai dan	1
硝态氮肥	xiao tai dan fei	1
小土地出租者	xiao tu di chu zu zhe	1
小无须鳕	xiao wu xu xue	1
小香蒲	xiao xiang pu	1
小型巴士	xiao xing ba shi	1
小阉牛	xiao yan niu	1
小羊驼	xiao yang tuo	1
小叶病	xiao ye bing	1
肖叶甲	xiao ye jia	1
小野鸭	xiao ye ya	1
效益突出	xiao yi tu chu	1
小猿叶虫	xiao yuan ye chong	1
小组委员会	xiao zu wei yuan hui	1
歇锄	xie chu	1
协方差	xie fang cha	1
协方差分析	xie fang cha fen xi	1
缬霉威	xie mei wei	1
协同效应	xie tong xiao ying	1
斜纹夜蛾	xie wen ye e	1
斜纹夜娥	xie wen ye e	1
斜纹夜峨	xie wen ye e	1
蟹爪仙人掌	xie zhao xian ren zhang	1
新城疫	xin cheng yi	1
辛敌	xin di	1
辛对氟氯氰	xin dui fu lv qing	1
锌肥	xin fei	1
辛氟菊酯	xin fu ju zhi	1
新根	xin gen	1
辛光一号	xin guang yi hao	1
新机具	xin ji ju	1
辛甲高氯	xin jia gao lv	1
辛甲三氟氯氰	xin jia san fu lv qing	1
新疆菜蝽	xin jiang cai chun	1
新金粒多	xin jin li duo	1
新来特	xin lai te	1
辛硫磷	xin liu lin	1
新陆早	xin lu zao	1
新马歇特	xin ma xie te	1
新年会	xin nian hui	1
新农办	xin nong ban	1
新农合办	xin nong he ban	1
新农药	xin nong yao	1
新品种	xin pin zhong	1
辛氰	xin qing	1
辛三氟	xin san fu	1
新梢	xin shao	1
新生大	xin sheng da	1
信使	xin shi	1
新双草克	xin shuang cao ke	1
薪水册	xin shui ce	1
心土	xin tu	1
心土犁	xin tu li	1
新万生	xin wan sheng	1
新闻编辑室	xin wen bian ji shi	1
新闻管制	xin wen guan zhi	1
新闻来源	xin wen lai yuan	1
新闻评论人	xin wen ping lun ren	1
新闻小说	xin wen xiao shuo	1
新闻用纸	xin wen yong zhi	1
新型农村	xin xing nong cun	1
新型农民	xin xing nong min	1
新芽	xin ya	1
新烟碱	xin yan jian	1
新燕灵	xin yan ling	1
信优灵	xin you ling	1
心脏型	xin zang xing	1
新植霉素	xin zhi mei su	1
新组合	xin zu he	1
辛唑酮	xin zuo tong	1
行比	xing bi	1
性比	xing bi	1
形成层	xing cheng ceng	1
形钉	xing ding	1
腥黑穗病	xing hei sui bing	1
兴黄单	xing huang dan	1
行李夫	xing li fu	1
兴棉宝	xing mian bao	1
性内切核酸	xing nei qie he suan	1
型渠	xing qu	1
行人地下通道	xing ren di xia tong dao	1
行人交叉路	xing ren jiao cha lu	1
杏仁眼	xing ren yan	1
形态素	xing tai su	1
杏塘	xing tang	1
星天牛	xing tian niu	1
性外激素	xing wai ji su	1
性诱剂	xing you ji	1
型种衣剂	xing zhong yi ji	1
性状	xing zhuang	1
雄鹅	xiong e	1
雄狗	xiong gou	1
雄冠	xiong guan	1
雄火鸡	xiong huo ji	1
雄驴	xiong lv	1
雄马	xiong ma	1
雄马驹	xiong ma ju	1
雄绵羊	xiong mian yang	1
雄蕊	xiong rui	1
雄山羊	xiong shan yang	1
雄穗	xiong sui	1
雄天鹅	xiong tian e	1
凶纹毒蛾	xiong wen du e	1
雄性不育	xiong xing bu yu	1
雄性不育技术	xiong xing bu yu ji shu	1
雄性不育基因	xiong xing bu yu ji yin	1
雄性不育系	xiong xing bu yu xi	1
雄蚁	xiong yi	1
雄猪	xiong zhu	1
锈斑	xiu ban	1
溴苯磷	xiu ben lin	1
锈病	xiu bing	1
羞病	xiu bing	1
溴虫腈	xiu chong jing	1
溴敌隆	xiu di long	1
锈豆	xiu dou	1
溴酚肟	xiu fen wo	1
修复错误	xiu fu cuo wu	1
修复过程	xiu fu guo cheng	1
溴氟菊酯	xiu fu ju zhi	1
休耕地	xiu geng di	1
秀谷隆	xiu gu long	1
锈褐色	xiu he se	1
修剪	xiu jian	1
锈菌	xiu jun	1
休菌清	xiu jun qing	1
溴菌清	xiu jun qing	1
修理成本	xiu li cheng ben	1
溴硫	xiu liu	1
溴硫磷	xiu liu lin	1
秀绿	xiu lv	1
溴氯丹	xiu lv dan	1
溴马	xiu ma	1
溴螨酯	xiu man zhi	1
秀美风光	xiu mei feng guang	1
溴灭菊酯	xiu mie ju zhi	1
溴氰菊酯	xiu qing ju zhi	1
溴鼠胺	xiu shu an	1
修通	xiu tong	1
羞萎病	xiu wei bing	1
休闲	xiu xian	1
休闲地	xiu xian di	1
绣线菊蚜	xiu xian ju ya	1
溴硝醇	xiu xiao chun	1
秀夜蛾	xiu ye e	1
修枝刀	xiu zhi dao	1
修枝剪	xiu zhi jian	1
须苞石竹	xu bao shi zhu	1
畜产品商品率	xu chan pin shang pin lv	1
需肥量	xu fei liang	1
畜牧产业	xu mu chan ye	1
畜牧处	xu mu chu	1
畜牧局	xu mu ju	1
畜牧业	xu mu ye	1
畜牧业分区	xu mu ye fen qu	1
畜牧业类型	xu mu ye lei xing	1
畜牧业生产	xu mu ye sheng chan	1
须纳税	xu na shui	1
畜禽	xu qin	1
畜禽产业	xu qin chan ye	1
畜禽防疫体系	xu qin fang yi ti xi	1
畜禽粪	xu qin fen	1
畜禽生产周期	xu qin sheng chan zhou qi	1
畜禽饲养量	xu qin si yang liang	1
畜禽头只数	xu qin tou zhi shu	1
畜禽养殖总量	xu qin yang zhi zong liang	1
畜禽再生产	xu qin zai sheng chan	1
需水	xu shui	1
需水量	xu shui liang	1
需氧	xu yang	1
需氧生物处理	xu yang sheng wu chu li	1
畜种结构	xu zhong jie gou	1
萱草	xuan cao	1
悬胆鼻	xuan dan bi	1
悬浮固体	xuan fu gu ti	1
旋覆花	xuan fu hua	1
旋耕	xuan geng	1
旋耕机	xuan geng ji	1
悬挂式农具	xuan gua shi nong ju	1
悬铃树	xuan ling shu	1
旋毛虫	xuan mao chong	1
选择差	xuan ze cha	1
选择强度	xuan ze qiang du	1
选择响应	xuan ze xiang ying	1
选择性农业机械化	xuan ze xing nong ye ji xie hua	1
选择性杀虫剂	xuan ze xing sha chong ji	1
选择指数	xuan ze zhi shu	1
旋转耙	xuan zhuan ba	1
旋转锄	xuan zhuan chu	1
旋转设计	xuan zhuan she ji	1
雪暴	xue bao	1
穴播	xue bo	1
穴播机	xue bo ji	1
雪腐病	xue fu bing	1
雪害	xue hai	1
学季	xue ji	1
穴间距	xue jian ju	1
血浆车	xue jiang che	1
穴距	xue ju	1
雪莲果	xue lian guo	1
雪霉叶枯病	xue mei ye ku bing	1
雪日	xue ri	1
穴深	xue shen	1
穴施	xue shi	1
雪松	xue song	1
雪松类	xue song lei	1
雪维菜	xue wei cai	1
学习讨论会	xue xi tao lun hui	1
学校工友	xue xiao gong you	1
穴栽	xue zai	1
雪障	xue zhang	1
熏干	xun gan	1
驯化	xun hua	1
循环基金	xun huan ji jin	1
循环农业	xun huan nong ye	1
熏菊酯	xun ju zhi	1
训练样本	xun lian yang ben	1
熏烟	xun yan	1
鲟鱼	xun yu	1
熏蒸	xun zheng	1
熏蒸剂	xun zheng ji	1
亚胺磷	ya an lin	1
亚胺硫磷	ya an liu lin	1
亚胺唑	ya an zuo	1
芽变	ya bian	1
蚜虫	ya chong	1
亚得乐	ya de le	1
芽甘蓝	ya gan lan	1
牙疙瘩	ya ge da	1
轧花机	ya hua ji	1
芽蕉	ya jiao	1
芽接	ya jie	1
芽枯病	ya ku bing	1
芽枯病毒病	ya ku bing du bing	1
蚜蜡敌	ya la di	1
亚磷酸钾	ya lin suan jia	1
亚麻	ya ma	1
蚜螨敌	ya man di	1
芽萌斯	ya meng si	1
蚜灭磷	ya mie lin	1
轧胚	ya pei	1
芽期	ya qi	1
亚热带	ya re dai	1
亚热带雨林气候	ya re dai yu lin qi hou	1
亚热带作物	ya re dai zuo wu	1
芽梢	ya shao	1
鸭舌草	ya she cao	1
蚜狮	ya shi	1
蚜虱净	ya shi jing	1
压条繁殖	ya tiao fan zhi	1
芽选择	ya xuan ze	1
芽叶	ya ye	1
雅玉	ya yu	1
鸭跖草	ya zhi cao	1
芽种	ya zhong	1
亚洲棉	ya zhou mian	1
亚洲玉米螟	ya zhou yu mi ming	1
芽壮	ya zhuang	1
眼斑病	yan ban bing	1
烟草甲	yan cao jia	1
延迟型冷害	yan chi xing leng hai	1
烟粉虱	yan fen shi	1
阉公鸡	yan gong ji	1
盐化	yan hua	1
延缓剂	yan huan ji	1
烟黄隆	yan huang long	1
烟灰碟	yan hui die	1
烟蓟马	yan ji ma	1
烟碱	yan jian	1
艳蓝色	yan lan se	1
严厉查处	yan li cha chu	1
燕麦枯	yan mai ku	1
燕麦片	yan mai pian	1
燕麦酯	yan mai zhi	1
烟盲蝽	yan mang chun	1
烟嘧磺隆	yan mi huang long	1
阉母鸡	yan mu ji	1
烟青虫	yan qing chong	1
烟实夜蛾	yan shi ye e	1
盐酸害	yan suan hai	1
芫荽	yan sui	1
盐土	yan tu	1
烟熏保藏	yan xun bao cang	1
烟蚜	yan ya	1
厌氧发酵	yan yang fa jiao	1
焰夜蛾	yan ye e	1
厌蝇胺	yan ying an	1
腌制	yan zhi	1
烟蛀茎蛾	yan zhu jing e	1
盐渍	yan zi	1
腌渍保藏	yan zi bao cang	1
眼子菜	yan zi cai	1
盐渍化	yan zi hua	1
洋白菜	yang bai cai	1
养虫工厂	yang chong gong chang	1
洋翠雀	yang cui que	1
养地	yang di	1
养地作物	yang di zuo wu	1
羊肝菌	yang gan jun	1
氧化钾	yang hua jia	1
氧化乐果	yang hua le guo	1
扬花期	yang hua qi	1
氧化塘	yang hua tang	1
氧化亚铜	yang hua ya tong	1
洋蓟	yang ji	1
洋姜	yang jiang	1
扬菌胺	yang jun an	1
氧乐果	yang le guo	1
氧乐菊酯	yang le ju zhi	1
氧乐噻	yang le sai	1
阳历	yang li	1
洋李	yang li	1
阳离子	yang li zi	1
阳离子交换量	yang li zi jiao huan liang	1
秧龄	yang ling	1
洋蔓菁	yang man jing	1
杨树蛀干天牛	yang shu zhu gan tian niu	1
阳桃	yang tao	1
秧田	yang tian	1
氧效应	yang xiao ying	1
氧乙炔炬	yang yi que ju	1
羊鱼	yang yu	1
养殖大户	yang zhi da hu	1
养殖示范点	yang zhi shi fan dian	1
养殖小区	yang zhi xiao qu	1
养殖效益	yang zhi xiao yi	1
养猪场	yang zhu chang	1
摇臂收割机	yao bi shou ge ji	1
腰沟	yao gou	1
药害	yao hai	1
药剂拌种	yao ji ban zhong	1
药剂品种	yao ji pin zhong	1
摇镜头	yao jing tou	1
要求发言	yao qiu fa yan	1
药王星	yao wang xing	1
药用作物	yao yong zuo wu	1
鳐鱼	yao yu	1
液氨施肥机	ye an shi fei ji	1
野坝子	ye ba zi	1
野坝子蜜	ye ba zi mi	1
叶斑	ye ban	1
叶斑病	ye ban bing	1
叶背	ye bei	1
叶菜	ye cai	1
叶菜类	ye cai lei	1
叶菜类蔬菜	ye cai lei shu cai	1
叶蝉散	ye chan san	1
叶长	ye chang	1
叶点病	ye dian bing	1
夜蛾	ye e	1
叶飞散	ye fei san	1
叶蜂	ye feng	1
野鸽	ye ge	1
叶黑肿病	ye hei zhong bing	1
叶互生	ye hu sheng	1
野火病	ye huo bing	1
叶尖枯病	ye jian ku bing	1
夜间逆温	ye jian ni wen	1
叶芥菜	ye jie cai	1
冶金学	ye jin xue	1
叶枯病	ye ku bing	1
叶枯净	ye ku jing	1
叶枯灵	ye ku ling	1
叶枯宁	ye ku ning	1
叶枯唑	ye ku zuo	1
叶宽	ye kuan	1
野葵菜	ye kui cai	1
野蛞蝓	ye kuo yu	1
夜来香	ye lai xiang	1
叶龄	ye ling	1
叶绿宝	ye lv bao	1
叶面宝	ye mian bao	1
叶面肥	ye mian fei	1
叶面积	ye mian ji	1
叶面积指数	ye mian ji zhi shu	1
叶面喷施	ye mian pen shi	1
叶面施肥	ye mian shi fei	1
叶苗	ye miao	1
野螟	ye ming	1
野苜蓿	ye mu xu	1
野蔷薇	ye qiang wei	1
叶鞘	ye qiao	1
叶鞘腐败病	ye qiao fu bai bing	1
叶鞘网斑病	ye qiao wang ban bing	1
叶鞘紫班病	ye qiao zi ban bing	1
叶青双	ye qing shuang	1
叶色	ye se	1
叶色淡	ye se dan	1
叶色深	ye se shen	1
野生大豆	ye sheng da dou	1
野生稻	ye sheng dao	1
野生近缘种	ye sheng jin yuan zhong	1
野生菌	ye sheng jun	1
野生麦	ye sheng mai	1
野生种	ye sheng zhong	1
液体肥料	ye ti fei liao	1
液体闪烁计数器	ye ti shan shuo ji shu qi	1
叶甜菜	ye tian cai	1
叶萎病	ye wei bing	1
叶形	ye xing	1
叶锈病	ye xiu bing	1
叶锈特	ye xiu te	1
野燕枯	ye yan ku	1
野燕麦	ye yan mai	1
叶夜娥	ye ye e	1
野蛹蝓	ye yong yu	1
椰圆蚧	ye yuan jie	1
叶灼病	ye zhuo bing	1
叶子花	ye zi hua	1
异艾剂	yi ai ji	1
一把锄	yi ba chu	1
乙拌磷	yi ban lin	1
异拌磷	yi ban lin	1
一般配合力	yi ban pei he li	1
一般消息栏	yi ban xiao xi lan	1
伊比磷	yi bi lin	1
一遍净	yi bian jing	1
依变量	yi bian liang	1
疫病	yi bing	1
异丙胺磷	yi bing an lin	1
异丙草胺	yi bing cao an	1
异丙定	yi bing ding	1
异丙甲草胺	yi bing jia cao an	1
异丙磷	yi bing lin	1
异丙硫环	yi bing liu huan	1
异丙隆	yi bing long	1
异丙噻	yi bing sai	1
异丙三唑磷	yi bing san zuo lin	1
异丙威	yi bing wei	1
乙草胺	yi cao an	1
乙草丁	yi cao ding	1
抑草磷	yi cao lin	1
以产定工	yi chan ding gong	1
宜昌橙	yi chang cheng	1
异常型种子	yi chang xing zhong zi	1
议程项目	yi cheng xiang mu	1
翼翅丽金龟	yi chi li jin gui	1
一池三改	yi chi san gai	1
乙虫腈	yi chong jing	1
抑虫肼	yi chong jing	1
抑虫灵	yi chong ling	1
遗传冲刷	yi chuan chong shua	1
遗传工程	yi chuan gong cheng	1
一串红	yi chuan hong	1
遗传获得量	yi chuan huo de liang	1
遗传力	yi chuan li	1
遗传率	yi chuan lv	1
遗传漂变	yi chuan piao bian	1
遗传侵蚀	yi chuan qin shi	1
遗传完整性	yi chuan wan zheng xing	1
遗传性条纹	yi chuan xing tiao wen	1
遗传与发育研究所	yi chuan yu fa yu yan jiu suo	1
遗传转化	yi chuan zhuan hua	1
遗传资源	yi chuan zi yuan	1
一村一品	yi cun yi pin	1
易倒伏	yi dao fu	1
异稻瘟净	yi dao wen jing	1
异地保存	yi di bao cun	1
乙滴涕	yi di ti	1
移动辐照器	yi dong fu zhao qi	1
翼豆	yi dou	1
抑毒唑	yi du zuo	1
异噁草酮	yi e cao tong	1
异恶隆	yi e long	1
益尔散	yi er san	1
异跗萤叶甲	yi fu ying ye jia	1
易感虫性	yi gan chong xing	1
刈割	yi ge	1
益果	yi guo	1
异核现象	yi he xian xiang	1
异花授粉	yi hua shou fen	1
已婚有偶	yi hun you ou	1
一季稻	yi ji dao	1
乙基托布津	yi ji tuo bu jin	1
乙基异柳磷	yi ji yi liu lin	1
彝家	yi jia	1
异交	yi jiao	1
亿斤	yi jin	1
乙菌利	yi jun li	1
异菌脲	yi jun niao	1
异喹丹	yi kui dan	1
宜良绿叶豆	yi liang lv ye dou	1
乙磷铝	yi lin lv	1
乙磷铝锰锌	yi lin lv meng xin	1
乙膦酸	yi lin suan	1
乙硫苯威	yi liu ben wei	1
溢流孔	yi liu kong	1
乙硫磷	yi liu lin	1
宜麦	yi mai	1
义卖场	yi mai chang	1
乙螨唑	yi man zuo	1
抑霉胺	yi mei an	1
疫霉根腐病	yi mei gen fu bing	1
疫霉菌	yi mei jun	1
疫霉灵	yi mei ling	1
乙霉威	yi mei wei	1
抑霉威	yi mei wei	1
抑霉唑	yi mei zuo	1
乙嘧酚	yi mi fen	1
益棉磷	yi mian lin	1
异灭威	yi mie wei	1
一年生	yi nian sheng	1
一年生蔬菜作物	yi nian sheng shu cai zuo wu	1
一年生作物	yi nian sheng zuo wu	1
乙氰菊酯	yi qing ju zhi	1
乙炔吹嘴	yi que chui zui	1
乙塞昂	yi sai ang	1
易赛昂	yi sai ang	1
益赛昂	yi sai ang	1
彝山	yi shan	1
抑食肼	yi shi jing	1
益收丰	yi shou feng	1
役收割机	yi shou ge ji	1
一熟	yi shu	1
移数	yi shu	1
益舒宝	yi shu bao	1
疫霜灵	yi shuang ling	1
乙蒜素	yi suan su	1
抑太保	yi tai bao	1
意外开支	yi wai kai zhi	1
易位	yi wei	1
依维菌素	yi wei jun su	1
易卫杀	yi wei sha	1
易位系	yi wei xi	1
彝文	yi wen	1
伊蚊避	yi wen bi	1
乙肟威	yi wo wei	1
异戊氰酸酯	yi wu qing suan zhi	1
乙烯硅	yi xi gui	1
乙烯菌核利	yi xi jun he li	1
乙烯利	yi xi li	1
异吸磷	yi xi lin	1
乙酰甲胺磷	yi xian jia an lin	1
彝乡	yi xiang	1
蚁象甲	yi xiang jia	1
异形词	yi xing ci	1
异型莎草	yi xing suo cao	1
抑芽丹	yi ya dan	1
抑芽唑	yi ya zuo	1
异羊角扭甙	yi yang jiao niu dai	1
乙氧隆	yi yang long	1
宜油	yi you	1
异源	yi yuan	1
异源多倍体	yi yuan duo bei ti	1
异源六倍体	yi yuan liu bei ti	1
异源四倍体	yi yuan si bei ti	1
移栽	yi zai	1
彝寨	yi zhai	1
抑制发芽	yi zhi fa ya	1
异质性	yi zhi xing	1
彝州	yi zhou	1
一柱香病	yi zhu xiang bing	1
一字型农业	yi zi xing nong ye	1
异唑磷	yi zuo lin	1
荫蔽	yin bi	1
茚虫威	yin chong wei	1
银川油葫芦	yin chuan you hu lu	1
引导性培训	yin dao xing pei xun	1
银锭夜蛾	yin ding ye e	1
印度鳄	yin du e	1
印度谷螟	yin du gu ming	1
印度楝	yin du lian	1
印度南瓜	yin du nan gua	1
引发酶	yin fa mei	1
银环蛇	yin huan she	1
银灰膜	yin hui mo	1
银胶菊	yin jiao ju	1
引进品种	yin jin pin zhong	1
阴离子	yin li zi	1
银莲花	yin lian hua	1
印楝素	yin lian su	1
吲熟酯	yin shu zhi	1
银泰暂定	yin tai zan ding	1
隐纹谷弄蝶	yin wen gu nong die	1
银纹夜蛾	yin wen ye e	1
银杏大蚕蛾	yin xing da can e	1
银杏酚	yin xing fen	1
音乐片	yin yue pian	1
隐症	yin zheng	1
印制电路	yin zhi dian lu	1
鹰鼻	ying bi	1
迎茬	ying cha	1
蝇毒磷	ying du lin	1
荧光	ying guang	1
英国洛桑实验站	ying guo luo sang shi yan zhan	1
英国研究理事会	ying guo yan jiu li shi hui	1
颖花	ying hua	1
硬花甘蓝	ying hua gan lan	1
颖枯病	ying ku bing	1
硬粒	ying li	1
赢利率	ying li lv	1
硬粒小麦	ying li xiao mai	1
硬粒型	ying li xing	1
硬粒玉米	ying li yu mi	1
瘿瘤	ying liu	1
硬盘机	ying pan ji	1
影片长度	ying pian chang du	1
影片类型	ying pian lei xing	1
罂粟	ying su	1
樱桃椒	ying tao jiao	1
营养钵	ying yang bo	1
营养袋	ying yang dai	1
营养土	ying yang tu	1
营养枝	ying yang zhi	1
营业间接成本	ying ye jian jie cheng ben	1
影印机	ying yin ji	1
营造商	ying zao shang	1
硬质小麦	ying zhi xiao mai	1
鹰嘴豆	ying zui dou	1
涌浪	yong lang	1
用苗	yong miao	1
用种	yong zhong	1
用种量	yong zhong liang	1
诱变剂	you bian ji	1
诱变效应	you bian xiao ying	1
诱变育种	you bian yu zhong	1
莠不生	you bu sheng	1
油菜双低育种	you cai shuang di yu zhong	1
油菜籽	you cai zi	1
油草双克	you cao shuang ke	1
诱虫灯	you chong deng	1
诱虫剂	you chong ji	1
诱虫烯	you chong xi	1
幼鹅	you e	1
幼儿学校	you er xue xiao	1
诱发放射性	you fa fang she xing	1
有稃毛	you fu mao	1
油柑	you gan	1
油橄榄	you gan lan	1
油橄榄树	you gan lan shu	1
油橄榄栽培	you gan lan zai pei	1
幼菇	you gu	1
有害副作用	you hai fu zuo yong	1
有害生物	you hai sheng wu	1
有害生物综合治理	you hai sheng wu zong he zhi li	1
油壶菌火肿病	you hu jun huo zhong bing	1
油葫芦	you hu lu	1
优化农业结构	you hua nong ye jie gou	1
油磺隆	you huang long	1
有机氮	you ji dan	1
有机肥	you ji fei	1
有机肥料	you ji fei liao	1
有机废水	you ji fei shui	1
有机硅	you ji gui	1
有机磷	you ji lin	1
有机硫	you ji liu	1
有机农业	you ji nong ye	1
有机酸	you ji suan	1
有机杂环	you ji za huan	1
优佳安	you jia an	1
有结构土壤	you jie gou tu rang	1
邮局服务处	you ju fu wu chu	1
优克稗	you ke bai	1
优乐得	you le de	1
油梨	you li	1
疣粒	you li	1
优良品种	you liang pin zhong	1
油料	you liao	1
油料剥壳	you liao bo ke	1
油料脱皮	you liao tuo pi	1
油料预处理	you liao yu chu li	1
油料植物	you liao zhi wu	1
油料作物	you liao zuo wu	1
幼马	you ma	1
莜麦	you mai	1
莜麦粉	you mai fen	1
幼苗期	you miao qi	1
柚木树	you mu shu	1
幼嫩	you nen	1
优能芬	you neng fen	1
幼年谷	you nian gu	1
油柒	you qi	1
莠去津	you qu jin	1
诱杀	you sha	1
油杉	you shan	1
优势产业带	you shi chan ye dai	1
优势农产品	you shi nong chan pin	1
油松	you song	1
幼穗	you sui	1
幼穗分化期	you sui fen hua qi	1
油桃	you tao	1
油桐	you tong	1
有限生长	you xian sheng zhang	1
有效成分	you xiao cheng fen	1
有效分蘖	you xiao fen nie	1
有效辐射	you xiao fu she	1
有效花	you xiao hua	1
有效积温	you xiao ji wen	1
有效降水量	you xiao jiang shui liang	1
有效生理辐射	you xiao sheng li fu she	1
有效穗	you xiao sui	1
有效温度	you xiao wen du	1
有效雨量	you xiao yu liang	1
右旋炔咪菊酯	you xuan que mi ju zhi	1
诱蝇酮	you ying tong	1
优质稻	you zhi dao	1
优质高产	you zhi gao chan	1
油脂精炼	you zhi jing lian	1
优质米	you zhi mi	1
优质农产品	you zhi nong chan pin	1
优质小麦	you zhi xiao mai	1
油棕	you zong	1
油棕榈树	you zong lv shu	1
郁蔽	yu bi	1
预测	yu ce	1
预测预报	yu ce yu bao	1
誉称	yu cheng	1
玉带凤蝶	yu dai feng die	1
豫单	yu dan	1
渝单	yu dan	1
玉豆汇收	yu dou hui shou	1
榆毒蛾	yu du e	1
育肥猪舍	yu fei zhu she	1
淤溉	yu gai	1
余甘子	yu gan zi	1
羽化孔	yu hua kong	1
芋蝗	yu huang	1
榆黄金花虫	yu huang jin hua chong	1
雨季	yu ji	1
郁金香	yu jin xiang	1
雨久花	yu jiu hua	1
雨量	yu liang	1
雨量分布	yu liang fen bu	1
虞美人	yu mei ren	1
育霉颖枯病	yu mei ying ku bing	1
玉米棒子	yu mi bang zi	1
玉米大斑病	yu mi da ban bing	1
玉米二等品	yu mi er deng pin	1
玉米粉	yu mi fen	1
玉米联合收割机	yu mi lian he shou ge ji	1
玉米苗	yu mi miao	1
玉米螟	yu mi ming	1
玉米糁	yu mi shen	1
玉米收割机	yu mi shou ge ji	1
玉米笋	yu mi sun	1
玉米铁甲	yu mi tie jia	1
玉米脱粒机	yu mi tuo li ji	1
玉米象	yu mi xiang	1
玉米小斑病	yu mi xiao ban bing	1
玉米蚜	yu mi ya	1
玉米渣	yu mi zha	1
玉米摘穗机	yu mi zhai sui ji	1
玉米制种	yu mi zhi zhong	1
豫棉	yu mian	1
育苗	yu miao	1
育苗袋	yu miao dai	1
育苗移栽	yu miao yi zai	1
榆木树	yu mu shu	1
芋艿	yu nai	1
玉农乐	yu nong yue	1
浴盆帘	yu pen lian	1
与人握手	yu ren wo shou	1
雨日	yu ri	1
羽扇豆	yu shan dou	1
雨蚀	yu shi	1
雨水	yu shui	1
渔税	yu shui	1
榆四脉绵蚜	yu si mai mian ya	1
雨凇	yu song	1
预算委员会	yu suan wei yuan hui	1
鱼藤酮	yu teng tong	1
玉笑	yu xiao	1
育性	yu xing	1
雨养农业	yu yang nong ye	1
渔业处	yu ye chu	1
渔业科学院	yu ye ke xue yuan	1
榆叶梅	yu ye mei	1
羽叶茑萝	yu ye niao luo	1
羽衣甘蓝	yu yi gan lan	1
予以注册	yu yi zhu ce	1
豫玉	yu yu	1
遇雨	yu yu	1
玉簪	yu zan	1
浴皂盒	yu zao he	1
育种圃	yu zhong pu	1
宇宙志	yu zhou zhi	1
羽状	yu zhuang	1
羽状复叶	yu zhuang fu ye	1
圆白菜地	yuan bai cai di	1
圆斑病	yuan ban bing	1
原地保存	yuan di bao cun	1
圆盾蚧	yuan dun jie	1
原基	yuan ji	1
远交	yuan jiao	1
圆金柑	yuan jin gan	1
园林设计	yuan lin she ji	1
元麦	yuan mai	1
元谋细豆	yuan mou xi dou	1
圆盘耙	yuan pan ba	1
圆盘犁	yuan pan li	1
原球茎	yuan qiu jing	1
圆球形	yuan qiu xing	1
远摄镜头	yuan she jing tou	1
原生污染物	yuan sheng wu ran wu	1
原生质体培养	yuan sheng zhi ti pei yang	1
原始农业	yuan shi nong ye	1
原驼	yuan tuo	1
鸢尾	yuan wei	1
原位分子杂交	yuan wei fen zi za jiao	1
院心	yuan xin	1
圆叶牵牛	yuan ye qian niu	1
园艺	yuan yi	1
园艺剪刀	yuan yi jian dao	1
园艺师	yuan yi shi	1
园艺学	yuan yi xue	1
园艺作物	yuan yi zuo wu	1
远缘	yuan yuan	1
远缘嫁接	yuan yuan jia jie	1
远缘杂种	yuan yuan za zhong	1
原原种	yuan yuan zhong	1
原种	yuan zhong	1
原种圃	yuan zhong pu	1
原种猪场	yuan zhong zhu chang	1
原子能学	yuan zi neng xue	1
越代	yue dai	1
越冬防治	yue dong fang zhi	1
越冬期	yue dong qi	1
越冬死苗	yue dong si miao	1
越冬性	yue dong xing	1
越冬作物	yue dong zuo wu	1
月度付款	yue du fu kuan	1
越瓜	yue gua	1
阅件	yue jian	1
越桔	yue ju	1
月平均温度	yue ping jun wen du	1
月台票	yue tai piao	1
越夏	yue xia	1
云斑粉蝶	yun ban fen die	1
云斑天牛	yun ban tian niu	1
匀播	yun bo	1
允草平	yun cao ping	1
云尺蠖	yun chi huo	1
运动栏	yun dong lan	1
云二天	yun er tian	1
云粳优	yun jing you	1
云量	yun liang	1
云路牌	yun lu pai	1
云麦	yun mai	1
匀苗	yun miao	1
云南菜蝽	yun nan cai chun	1
云南农大	yun nan nong da	1
云南农业	yun nan nong ye	1
云南农业大学	yun nan nong ye da xue	1
云南农业科技	yun nan nong ye ke ji	1
云南省农科院	yun nan sheng nong ke yuan	1
云南省农业厅	yun nan sheng nong ye ting	1
云南松	yun nan song	1
云杉	yun shan	1
运输费用	yun shu fei yong	1
孕穗	yun sui	1
孕穗期	yun sui qi	1
芸苔	yun tai	1
芸薹	yun tai	1
芸苔素	yun tai su	1
芸苔素内脂	yun tai su nei zhi	1
云苔素内酯	yun tai su nei zhi	1
云纹病	yun wen bing	1
运销大户	yun xiao da hu	1
云形病	yun xing bing	1
允许浓度	yun xu nong du	1
允许日摄入量	yun xu ri she ru liang	1
云烟迷障	yun yan mi zhang	1
云优	yun you	1
云油	yun you	1
云杂	yun za	1
匀栽	yun zai	1
运转不畅	yun zhuan bu chang	1
杂草	za cao	1
杂草锁	za cao suo	1
杂交不亲和性	za jiao bu qin he xing	1
杂交稻	za jiao dao	1
杂交高粱	za jiao gao liang	1
杂交可育	za jiao ke yu	1
杂交良种	za jiao liang zhong	1
杂交亲和性	za jiao qin he xing	1
杂交玉米	za jiao yu mi	1
杂交育种	za jiao yu zhong	1
杂交种	za jiao zhong	1
杂交组合	za jiao zu he	1
杂粳	za jing	1
杂粮田粘虫	za liang tian nian chong	1
杂木屑	za mu xie	1
杂项费用	za xiang fei yong	1
杂种	za zhong	1
杂种不育性	za zhong bu yu xing	1
杂种第二代	za zhong di er dai	1
杂种第一代	za zhong di yi dai	1
杂种优势	za zhong you shi	1
栽插	zai cha	1
栽后	zai hou	1
栽培防治	zai pei fang zhi	1
栽培面积	zai pei mian ji	1
栽培品种	zai pei pin zhong	1
再侵染	zai qin ran	1
再侵染源	zai qin ran yuan	1
再生稻	zai sheng dao	1
再生苗	zai sheng miao	1
载体	zai ti	1
在业人口	zai ye ren kou	1
栽植	zai zhi	1
栽植沟	zai zhi gou	1
錾式犁	zan shi li	1
早播	zao bo	1
早茬	zao cha	1
枣尺蠖	zao chi huo	1
早春	zao chun	1
早代测验	zao dai ce yan	1
早稻	zao dao	1
早发	zao fa	1
燥红土	zao hong tu	1
早花	zao hua	1
早季	zao ji	1
造林绿化	zao lin lv hua	1
造林学	zao lin xue	1
枣粘虫	zao nian chong	1
早青蚕豆	zao qing can dou	1
早青豌豆	zao qing wan dou	1
早生快发	zao sheng kuai fa	1
早施	zao shi	1
早收	zao shou	1
早熟禾	zao shu he	1
早熟性	zao shu xing	1
早霜	zao shuang	1
早死病	zao si bing	1
藻酸丙二醇酯	zao suan bing er chun zhi	1
澡酸丙二醇酯	zao suan bing er chun zhi	1
早苔	zao tai	1
蚤跳甲	zao tiao jia	1
枣椰树	zao ye shu	1
早疫病	zao yi bing	1
造园	zao yuan	1
早栽	zao zai	1
藻状菌	zao zhuang jun	1
糟渍	zao zi	1
泽泻科	ze xie ke	1
增产胺	zeng chan an	1
增产灵	zeng chan ling	1
增甘磷	zeng gan lin	1
增钾	zeng jia	1
增蘖	zeng nie	1
增强发展后劲	zeng qiang fa zhan hou jin	1
增强后劲	zeng qiang hou jin	1
增生	zeng sheng	1
增施	zeng shi	1
增湿作用	zeng shi zuo yong	1
增丝素	zeng si su	1
增糖胺	zeng tang an	1
增糖酯	zeng tang zhi	1
增温	zeng wen	1
增温保湿	zeng wen bao shi	1
增效胺	zeng xiao an	1
增效丁	zeng xiao ding	1
增效环	zeng xiao huan	1
增效剂	zeng xiao ji	1
增效机油乳剂	zeng xiao ji you ru ji	1
增效甲胺磷	zeng xiao jia an lin	1
增效磷	zeng xiao lin	1
增效氰马	zeng xiao qing ma	1
增效醛	zeng xiao quan	1
增效散	zeng xiao san	1
增效特	zeng xiao te	1
增效酯	zeng xiao zhi	1
扎单	zha dan	1
炸土豆片	zha tu dou pian	1
榨油机	zha you ji	1
摘棉机	zhai mian ji	1
窄条斑病	zhai tiao ban bing	1
摘心	zhai xin	1
窄行	zhai xing	1
摘要纪录	zhai yao ji lu	1
展叶	zhan ye	1
站员	zhan yuan	1
展着剂	zhan zhe ji	1
粘重土壤	zhan zhong tu rang	1
障碍型冷害	zhang ai xing leng hai	1
掌鸠河	zhang jiu he	1
帐目表	zhang mu biao	1
长势弱	zhang shi ruo	1
樟树	zhang shu	1
长叶	zhang ye	1
掌叶大黄	zhang ye da huang	1
沼地热	zhao di re	1
赵光文	zhao guang wen	1
照明技术	zhao ming ji shu	1
照明师	zhao ming shi	1
沼气	zhao qi	1
沼气池	zhao qi chi	1
沼气肥	zhao qi fei	1
着水	zhao shui	1
蔗扁蛾	zhe bian e	1
折带黄毒蛾	zhe dai huang du e	1
蛰伏	zhe fu	1
遮光黑纸	zhe guang hei zhi	1
着粒数	zhe li shu	1
遮檐	zhe yan	1
遮阴	zhe yin	1
镇草宁	zhen cao ning	1
真诚友爱	zhen cheng you ai	1
针刺状	zhen ci zhuang	1
真菌	zhen jun	1
砧木	zhen mu	1
砧穗相互作用	zhen sui xiang hu zuo yong	1
砧穗组合	zhen sui zu he	1
针锈病	zhen xiu bing	1
镇蚜	zhen ya	1
镇压	zhen ya	1
镇压器	zhen ya qi	1
真叶	zhen ye	1
镇议会	zhen yi hui	1
镇议会议员	zhen yi hui yi yuan	1
珍珠鸡	zhen zhu ji	1
珍珠粟	zhen zhu su	1
整倍体	zheng bei ti	1
正菜	zheng cai	1
正餐前	zheng can qian	1
政策引导	zheng ce yin dao	1
正常型种子	zheng chang xing zhong zi	1
蒸炒	zheng chao	1
郑单	zheng dan	1
整地	zheng di	1
蒸发潜力	zheng fa qian li	1
蒸发抑制剂	zheng fa yi zhi ji	1
蒸发指数	zheng fa zhi shu	1
正反交	zheng fan jiao	1
整改提高	zheng gai ti gao	1
蒸谷米	zheng gu mi	1
正交多项式	zheng jiao duo xiang shi	1
正交试验	zheng jiao shi yan	1
正交系数	zheng jiao xi shu	1
整批销售	zheng pi xiao shou	1
整齐度	zheng qi du	1
蒸汽蒸馏	zheng qi zheng liu	1
蒸青	zheng qing	1
正确词	zheng que ci	1
蒸散	zheng san	1
蒸散势	zheng san shi	1
正式登记证	zheng shi deng ji zheng	1
正态分布	zheng tai fen bu	1
正态曲线	zheng tai qu xian	1
蒸腾	zheng teng	1
蒸腾速率	zheng teng su lv	1
蒸腾系数	zheng teng xi shu	1
蒸腾效率	zheng teng xiao lv	1
整田	zheng tian	1
整厢	zheng xiang	1
正形素	zheng xing su	1
整枝	zheng zhi	1
政治报纸	zheng zhi bao zhi	1
政治鉴别力	zheng zhi jian bie li	1
致癌效应	zhi ai xiao ying	1
致癌源	zhi ai yuan	1
值班服务员	zhi ban fu wu yuan	1
枝孢穗腐病	zhi bao sui fu bing	1
植保站	zhi bao zhan	1
植保植检站	zhi bao zhi jian zhan	1
植被	zhi bei	1
植被指数	zhi bei zhi shu	1
制表机	zhi biao ji	1
致病力	zhi bing li	1
植病灵	zhi bing ling	1
致病性	zhi bing xing	1
直播稻草克	zhi bo dao cao ke	1
制钵机	zhi bo ji	1
直播净	zhi bo jing	1
支岔	zhi cha	1
直翅	zhi chi	1
直翅目	zhi chi mu	1
支持农业发展	zhi chi nong ye fa zhan	1
智锄	zhi chu	1
枝顶	zhi ding	1
执法大队	zhi fa da dui	1
脂肪酸	zhi fang suan	1
制粉	zhi fen	1
枝梗瘟	zhi geng wen	1
指管蚜	zhi guan ya	1
制剂	zhi ji	1
致畸性	zhi ji xing	1
制假售假	zhi jia shou jia	1
枝接	zhi jie	1
酯菌胺	zhi jun an	1
栉叩头虫	zhi kou tou chong	1
智利草莓	zhi li cao mei	1
直立型花生	zhi li xing hua sheng	1
直立压条	zhi li ya tiao	1
质量标准	zhi liang biao zhun	1
质量遗传	zhi liang yi chuan	1
芝麻酱	zhi ma jiang	1
芝麻灵	zhi ma ling	1
芝麻油	zhi ma you	1
致密	zhi mi	1
殖民政策	zhi min zheng ce	1
治螟磷	zhi ming lin	1
支木柱	zhi mu zhu	1
支农惠农政策	zhi nong hui nong zheng ce	1
支票簿	zhi piao bu	1
支票帐户	zhi piao zhang hu	1
质谱法	zhi pu fa	1
支渠	zhi qu	1
枝梢黑点病	zhi shao hei dian bing	1
指示生物	zhi shi sheng wu	1
植食性	zhi shi xing	1
枝数	zhi shu	1
致死剂量	zhi si ji liang	1
致死温度	zhi si wen du	1
治萎灵	zhi wei ling	1
直纹稻弄蝶	zhi wen dao nong die	1
植物保护	zhi wu bao hu	1
植物病害	zhi wu bing hai	1
植物病害流行预测	zhi wu bing hai liu xing yu ce	1
植物病理学	zhi wu bing li xue	1
植物检疫	zhi wu jian yi	1
植物流行病学	zhi wu liu xing bing xue	1
植物群落	zhi wu qun luo	1
植物生长	zhi wu sheng zhang	1
植物学家	zhi wu xue jia	1
植物研究所	zhi wu yan jiu suo	1
植物疫情	zhi wu yi qing	1
植物引种	zhi wu yin zhong	1
植物种类	zhi wu zhong lei	1
植物种类识别	zhi wu zhong lei shi bie	1
直系家庭	zhi xi jia ting	1
直线回归	zhi xian hui gui	1
治线磷	zhi xian lin	1
直线相关	zhi xian xiang guan	1
止血马唐	zhi xue ma tang	1
制蚜菌素	zhi ya jun su	1
治莠灵	zhi you ling	1
滞育	zhi yu	1
制约因子	zhi yue yin zi	1
值指示剂	zhi zhi shi ji	1
制种	zhi zhong	1
制种产业	zhi zhong chan ye	1
制种面积	zhi zhong mian ji	1
蜘蛛花	zhi zhu hua	1
栀子	zhi zi	1
中保一号	zhong bao yi hao	1
中层肥	zhong ceng fei	1
种畜场	zhong chu chang	1
种传病害	zhong chuan bing hai	1
重大动物疫情	zhong da dong wu yi qing	1
中稻	zhong dao	1
中低产田改造	zhong di chan tian gai zao	1
仲丁灵	zhong ding ling	1
仲丁通	zhong ding tong	1
仲丁威	zhong ding wei	1
中肥	zhong fei	1
种肥	zhong fei	1
中肥力	zhong fei li	1
中分蘖	zhong fen nie	1
中感光性	zhong gan guang xing	1
中耕	zhong geng	1
中耕管理	zhong geng guan li	1
中耕机	zhong geng ji	1
中耕培土机	zhong geng pei tu ji	1
中耕作物	zhong geng zuo wu	1
中国科协	zhong guo ke xie	1
中国科学院	zhong guo ke xue yuan	1
中国南瓜	zhong guo nan gua	1
中国农科院	zhong guo nong ke yuan	1
中国农业科学院	zhong guo nong ye ke xue yuan	1
中国农业信息网	zhong guo nong ye xin xi wang	1
中海拔	zhong hai ba	1
中红麻	zhong hong ma	1
中华稻蝗	zhong hua dao huang	1
中华虎凤蝶	zhong hua hu feng die	1
中华金带蛾	zhong hua jin dai e	1
中华锯花天牛	zhong hua ju hua tian niu	1
中化克苇	zhong hua ke wei	1
终花期	zhong hua qi	1
中华人民共和国农业部	zhong hua ren min gong he guo nong ye bu	1
中季	zhong ji	1
种鸡场	zhong ji chang	1
中间型	zhong jian xing	1
中间型大麦	zhong jian xing da mai	1
种间杂交	zhong jian za jiao	1
中间砧	zhong jian zhen	1
中筋	zhong jin	1
中粳	zhong jing	1
中抗	zhong kang	1
重力分级	zhong li fen ji	1
中粒种	zhong li zhong	1
中期贷款	zhong qi dai kuan	1
种球	zhong qiu	1
终身成员	zhong shen cheng yuan	1
中生菌素	zhong sheng jun su	1
中生霉素	zhong sheng mei su	1
中熟	zhong shu	1
众数	zhong shu	1
种薯	zhong shu	1
种薯繁育	zhong shu fan yu	1
终霜	zhong shuang	1
重穗	zhong sui	1
中文报纸	zhong wen bao zhi	1
中温型	zhong wen xing	1
中西除虫菊酯	zhong xi chu chong ju zhi	1
中西杀灭菊酯	zhong xi sha mie ju zhi	1
中籼	zhong xian	1
中性土	zhong xing tu	1
终雪	zhong xue	1
中学毕业生	zhong xue bi ye sheng	1
中学毕业证书	zhong xue bi ye zheng shu	1
种芽	zhong ya	1
中央补贴资金	zhong yang bu tie zi jin	1
种羊场	zhong yang chang	1
中央国家部委	zhong yang guo jia bu wei	1
重要研究内容	zhong yao yan jiu nei rong	1
种业	zhong ye	1
种衣剂	zhong yi ji	1
种衣剂号	zhong yi ji hao	1
种衣酯	zhong yi zhi	1
种蝇	zhong ying	1
重栽	zhong zai	1
中早	zhong zao	1
中早熟	zhong zao shu	1
种质	zhong zhi	1
种质长期保存材料	zhong zhi chang qi bao cun cai liao	1
种质储存	zhong zhi chu cun	1
种质短期保存材料	zhong zhi duan qi bao cun cai liao	1
种植沟	zhong zhi gou	1
种植机	zhong zhi ji	1
种质基本资料	zhong zhi ji ben zi liao	1
种植密度	zhong zhi mi du	1
种植面积	zhong zhi mian ji	1
种质圃	zhong zhi pu	1
种植区	zhong zhi qu	1
种植区域	zhong zhi qu yu	1
种植业	zhong zhi ye	1
种植业管理处	zhong zhi ye guan li chu	1
种植业管理司	zhong zhi ye guan li si	1
种植业科	zhong zhi ye ke	1
种质应用材料	zhong zhi ying yong cai liao	1
种植制度	zhong zhi zhi du	1
种质资源	zhong zhi zi yuan	1
种猪	zhong zhu	1
种子饱满度	zhong zi bao man du	1
种子比重	zhong zi bi zhong	1
种子仓库	zhong zi cang ku	1
种子测定	zhong zi ce ding	1
种子储备	zhong zi chu bei	1
种子管理	zhong zi guan li	1
种子管理站	zhong zi guan li zhan	1
种子含水量	zhong zi han shui liang	1
种子混杂物	zhong zi hun za wu	1
种子活力	zhong zi huo li	1
种子鉴定	zhong zi jian ding	1
种子检验	zhong zi jian yan	1
种子检疫	zhong zi jian yi	1
种子清选	zhong zi qing xuan	1
种子容重	zhong zi rong zhong	1
中子湿度测量仪	zhong zi shi du ce liang yi	1
种子寿命	zhong zi shou ming	1
种子提纯	zhong zi ti chun	1
种子消毒	zhong zi xiao du	1
种子休眠	zhong zi xiu mian	1
种子站	zhong zi zhan	1
种子整齐度	zhong zi zheng qi du	1
种子贮藏	zhong zi zhu cang	1
周斑水虹	zhou ban shui hong	1
州茶桑站	zhou cha sang zhan	1
周工资	zhou gong zi	1
州农广校	zhou nong guang xiao	1
州农机监理所	zhou nong ji jian li suo	1
州农机研究所	zhou nong ji yan jiu suo	1
州农经站	zhou nong jing zhan	1
州农科所	zhou nong ke suo	1
州农业局	zhou nong ye ju	1
绉片	zhou pian	1
周期性症状	zhou qi xing zheng zhuang	1
周日特刊	zhou ri te kan	1
州土肥站	zhou tu fei zhan	1
皱叶冬寒菜	zhou ye dong han cai	1
皱叶甘蓝	zhou ye gan lan	1
昼夜节律	zhou ye jie lv	1
州植保站	zhou zhi bao zhan	1
州种子管理站	zhou zhong zi guan li zhan	1
周转基金	zhou zhuan ji jin	1
周转性基金	zhou zhuan xing ji jin	1
逐步回归	zhu bu hui gui	1
贮藏期	zhu cang qi	1
猪产房	zhu chan fang	1
主导产业	zhu dao chan ye	1
主动式太阳能加热	zhu dong shi tai yang neng jia re	1
竹杆	zhu gan	1
株高	zhu gao	1
主根	zhu gen	1
筑埂	zhu geng	1
主管团体	zhu guan tuan ti	1
株行法	zhu hang fa	1
株行距	zhu hang ju	1
株行试验	zhu hang shi yan	1
柱黑穗病	zhu hei sui bing	1
株间距	zhu jian ju	1
竹节虫	zhu jie chong	1
主茎	zhu jing	1
蛀茎夜娥	zhu jing ye e	1
株距	zhu ju	1
柱列	zhu lie	1
注硫磷	zhu liu lin	1
主蔓	zhu man	1
猪毛菜	zhu mao cai	1
株苗	zhu miao	1
朱砂叶螨	zhu sha ye man	1
朱砂叶瞒	zhu sha ye man	1
蛀食	zhu shi	1
株数	zhu shu	1
主水道	zhu shui dao	1
贮水量	zhu shui liang	1
竹荪	zhu sun	1
主效基因抗	zhu xiao ji yin kang	1
主效基因抗病性	zhu xiao ji yin kang bing xing	1
主效应	zhu xiao ying	1
株型	zhu xing	1
柱形图	zhu xing tu	1
注油枪	zhu you qiang	1
竹蔗	zhu zhe	1
逐字纪录	zhu zi ji lu	1
砖茶	zhuan cha	1
转导	zhuan dao	1
转化	zhuan hua	1
转换系数	zhuan huan xi shu	1
转基因技术	zhuan ji yin ji shu	1
专栏记者	zhuan lan ji zhe	1
转色期	zhuan se qi	1
转弯指示灯	zhuan wan zhi shi deng	1
转向标	zhuan xiang biao	1
专性寄生物	zhuan xing ji sheng wu	1
专业合作社	zhuan ye he zuo she	1
专业协会	zhuan ye xie hui	1
专用肥	zhuan yong fei	1
转主寄生	zhuan zhu ji sheng	1
转主寄主	zhuan zhu ji zhu	1
装草机	zhuang cao ji	1
庄房	zhuang fang	1
壮根	zhuang gen	1
壮果	zhuang guo	1
壮鸡	zhuang ji	1
壮鸡加工厂	zhuang ji jia gong chang	1
撞击杀虫	zhuang ji sha chong	1
装胶卷	zhuang jiao juan	1
壮苗肥	zhuang miao fei	1
壮年谷	zhuang nian gu	1
壮蘖	zhuang nie	1
壮蘖肥	zhuang nie fei	1
壮秧	zhuang yang	1
追肥枪	zhui fei qiang	1
追施	zhui shi	1
锥状花序	zhui zhuang hua xu	1
准锄	zhun chu	1
准性杂交	zhun xing za jiao	1
灼伤	zhuo shang	1
紫斑病	zi ban bing	1
紫斑谷螟	zi ban gu ming	1
资本货物	zi ben huo wu	1
资本外逃	zi ben wai tao	1
资本主义经济	zi ben zhu yi jing ji	1
自变量	zi bian liang	1
紫菜莉	zi cai li	1
紫菜薹	zi cai tai	1
紫菜头	zi cai tou	1
资产平稳表	zi chan ping wen biao	1
自筹经费	zi chou jing fei	1
子代	zi dai	1
自发气调贮藏	zi fa qi tiao zhu cang	1
子房	zi fang	1
紫秆病	zi gan bing	1
渍害	zi hai	1
自花授粉	zi hua shou fen	1
自花受精	zi hua shou jing	1
紫花豌豆	zi hua wan dou	1
自交	zi jiao	1
自交不亲和系	zi jiao bu qin he xi	1
自交不亲和性	zi jiao bu qin he xing	1
自交不育性	zi jiao bu yu xing	1
自交可育性	zi jiao ke yu xing	1
自交亲和系	zi jiao qin he xi	1
自交亲和性	zi jiao qin he xing	1
自交系	zi jiao xi	1
自交系间	zi jiao xi jian	1
自交种子	zi jiao zhong zi	1
资金捐献	zi jin juan xian	1
紫金杉	zi jin shan	1
紫茎泽兰	zi jing ze lan	1
自净作用	zi jing zuo yong	1
兹克威	zi ke wei	1
紫轮病	zi lun bing	1
紫罗兰	zi luo lan	1
子蔓	zi man	1
籽棉	zi mian	1
紫茉莉	zi mo li	1
自南	zi nan	1
子囊菌	zi nang jun	1
紫皮	zi pi	1
紫皮柳树	zi pi liu shu	1
紫鞘病	zi qiao bing	1
自然保护区	zi ran bao hu qu	1
自然肥力	zi ran fei li	1
自然季节	zi ran ji jie	1
自然历	zi ran li	1
孜然芹	zi ran qin	1
自然通风干燥	zi ran tong feng gan zao	1
自然选择	zi ran xuan ze	1
紫色土	zi se tu	1
紫杉	zi shan	1
子实	zi shi	1
子实体	zi shi ti	1
渍水	zi shui	1
紫苏	zi su	1
紫穗槐	zi sui huai	1
自锁螺母	zi suo luo mu	1
紫藤	zi teng	1
紫外线辐照	zi wai xian fu zhao	1
紫菀	zi wan	1
紫纹羽病	zi wen yu bing	1
自西	zi xi	1
咨询服务系统	zi xun fu wu xi tong	1
自由度	zi you du	1
自由汇兑市场	zi you hui dui shi chang	1
自由授粉	zi you shou fen	1
自由招待会	zi you zhao dai hui	1
紫玉兰	zi yu lan	1
资源保护	zi yuan bao hu	1
姿韵	zi yun	1
紫云英	zi yun ying	1
紫竹	zi zhu	1
自走底盘	zi zou di pan	1
总苞数	zong bao shu	1
总丛数	zong cong shu	1
总根数	zong gen shu	1
总果数	zong guo shu	1
综合防治	zong he fang zhi	1
综合利用	zong he li yong	1
综合种	zong he zhong	1
总荚数	zong jia shu	1
宗教意识	zong jiao yi shi	1
总棵数	zong ke shu	1
总粒数	zong li shu	1
棕榈油	zong lv you	1
总枚数	zong mei shu	1
总苗数	zong miao shu	1
总蘖数	zong nie shu	1
棕壤	zong rang	1
总收获量	zong shou huo liang	1
总收入	zong shou ru	1
总穗数	zong sui shu	1
总塘数	zong tang shu	1
总体	zong ti	1
总头数	zong tou shu	1
总务委员会	zong wu wei yuan hui	1
总需氧量	zong xu yang liang	1
总有机碳	zong you ji tan	1
棕枣	zong zao	1
总枝数	zong zhi shu	1
棕竹	zong zhu	1
总主笔	zong zhu bi	1
总株数	zong zhu shu	1
走读学生	zou du xue sheng	1
走读学校	zou du xue xiao	1
祖代肉种鸡场	zu dai rou zhong ji chang	1
组阁制	zu ge zhi	1
足穗	zu sui	1
组织培养	zu zhi pei yang	1
最大吸湿度	zui da xi shi du	1
最大吸湿水	zui da xi shi shui	1
最低车费	zui di che fei	1
最低致死量	zui di zhi si liang	1
醉蝶花	zui die hua	1
最高耐受剂量	zui gao nai shou ji liang	1
最高生长温度	zui gao sheng zhang wen du	1
最高速度	zui gao su du	1
最高允许浓度	zui gao yun xu nong du	1
最后新闻	zui hou xin wen	1
最适	zui shi	1
最适温度	zui shi wen du	1
最小显著差数	zui xiao xian zhu cha shu	1
唑虫酰胺	zuo chong xian an	1
坐瓜	zuo gua	1
座果	zuo guo	1
座果磷	zuo guo lin	1
唑菌腈	zuo jun jing	1
唑菌灵	zuo jun ling	1
唑菌清	zuo jun qing	1
唑菌酯	zuo jun zhi	1
佐罗纳	zuo luo na	1
唑螨酯	zuo man zhi	1
做青	zuo qing	1
左荣贵	zuo rong gui	1
唑瘟酮	zuo wen tong	1
作物	zuo wu	1
作物布局	zuo wu bu ju	1
作物分子育种	zuo wu fen zi yu zhong	1
作物科学	zuo wu ke xue	1
作物科学研究所	zuo wu ke xue yan jiu suo	1
作物气候生态型	zuo wu qi hou sheng tai xing	1
作物气候适应性	zuo wu qi hou shi ying xing	1
作物气象	zuo wu qi xiang	1
作物起源	zuo wu qi yuan	1
作物起源中心	zuo wu qi yuan zhong xin	1
作物清查	zuo wu qing cha	1
作物生理	zuo wu sheng li	1
作物生理学	zuo wu sheng li xue	1
作物形态	zuo wu xing tai	1
作物遗传	zuo wu yi chuan	1
作物育种	zuo wu yu zhong	1
作物育种学	zuo wu yu zhong xue	1
作物栽培	zuo wu zai pei	1
唑蚜威	zuo ya wei	1
作种	zuo zhong	1
