爱尔施	ai er shi	1
爱克塞尔药物涂层支架系统	ai ke sai er yao wu tu ceng zhi jia xi tong	1
癌胚抗原	ai pei kang yuan	1
癌胚抗原试剂盒	ai pei kang yuan shi ji he	1
艾滋病测定试剂	ai zi bing ce ding shi ji	1
艾滋病测定试剂血站用	ai zi bing ce ding shi ji xue zhan yong	1
艾滋病抗体	ai zi bing kang ti	1
爱滋病抗体	ai zi bing kang ti	1
艾滋病试剂盒	ai zi bing shi ji he	1
按摩床	an mo chuang	1
安全细菌过滤器	an quan xi jun guo lv qi	1
凹槽形股骨带锁髓内钉不锈钢	ao cao xing gu gu dai suo sui nei ding bu xiu gang	1
凹槽形股骨带锁髓内钉纯钛	ao cao xing gu gu dai suo sui nei ding chun tai	1
凹槽形股骨带锁髓内钉锁钉	ao cao xing gu gu dai suo sui nei ding suo ding	1
凹槽形股骨带锁髓内钉钛合金	ao cao xing gu gu dai suo sui nei ding tai he jin	1
凹槽形股骨带锁髓内钉尾钉	ao cao xing gu gu dai suo sui nei ding wei ding	1
凹槽形股骨带锁髓内钉主钉	ao cao xing gu gu dai suo sui nei ding zhu ding	1
凹槽形胫骨带锁髓内钉不锈钢	ao cao xing jing gu dai suo sui nei ding bu xiu gang	1
凹槽形胫骨带锁髓内钉纯钛	ao cao xing jing gu dai suo sui nei ding chun tai	1
凹槽形胫骨带锁髓内钉锁钉	ao cao xing jing gu dai suo sui nei ding suo ding	1
凹槽形胫骨带锁髓内钉钛合金	ao cao xing jing gu dai suo sui nei ding tai he jin	1
凹槽形胫骨带锁髓内钉尾钉	ao cao xing jing gu dai suo sui nei ding wei ding	1
凹槽形胫骨带锁髓内钉主钉	ao cao xing jing gu dai suo sui nei ding zhu ding	1
凹槽形髁上带锁髓内钉不锈钢	ao cao xing ke shang dai suo sui nei ding bu xiu gang	1
凹槽形髁上带锁髓内钉纯钛	ao cao xing ke shang dai suo sui nei ding chun tai	1
凹槽形髁上带锁髓内钉锁钉	ao cao xing ke shang dai suo sui nei ding suo ding	1
凹槽形髁上带锁髓内钉钛合金	ao cao xing ke shang dai suo sui nei ding tai he jin	1
凹槽形髁上带锁髓内钉尾钉	ao cao xing ke shang dai suo sui nei ding wei ding	1
凹槽形髁上带锁髓内钉主钉	ao cao xing ke shang dai suo sui nei ding zhu ding	1
奥桑喷雾机	ao sang pen wu ji	1
澳丝	ao si	1
巴斯德吸管	ba si de xi guan	1
拔髓针	ba sui zhen	1
八项尿试纸	ba xiang niao shi zhi	1
白带染色试剂	bai dai ran se shi ji	1
白带染色试剂盒	bai dai ran se shi ji he	1
白蛋白	bai dan bai	1
白蛋白测定试剂盒	bai dan bai ce ding shi ji he	1
白蛋白液体试剂盒	bai dan bai ye ti shi ji he	1
白石膏	bai shi gao	1
白细胞滤器	bai xi bao lv qi	1
半侧颗牙阴膜	ban ce ke ya yin mo	1
半侧颗牙龈膜	ban ce ke ya yin mo	1
半测下额筒环模型	ban ce xia e tong huan mo xing	1
半侧下颌骨踽环模型	ban ce xia he gu ju huan mo xing	1
半骨盆假体	ban gu pen jia ti	1
半管型钢板	ban guan xing gang ban	1
半管型钢板不锈钢	ban guan xing gang ban bu xiu gang	1
半管型钢板纯钛	ban guan xing gang ban chun tai	1
半管型钢板钛合金	ban guan xing gang ban tai he jin	1
半环形外固定支架	ban huan xing wai gu ding zhi jia	1
半髋单动头	ban kuan dan dong tou	1
半髋双动头	ban kuan shuang dong tou	1
斑马导丝	ban ma dao si	1
瓣膜成形环	ban mo cheng xing huan	1
棒状杆菌鉴定试剂条	bang zhuang gan jun jian ding shi ji tiao	1
保康灵皮肤消毒液	bao kang ling pi fu xiao du ye	1
保留后交叉韧带关节	bao liu hou jiao cha ren dai guan jie	1
保留后交叉韧带膝关节	bao liu hou jiao cha ren dai xi guan jie	1
包埋盒	bao mai he	1
包皮圈套	bao pi quan tao	1
包皮套	bao pi tao	1
被动固定起搏电极导线	bei dong gu ding qi bo dian ji dao xian	1
贝克曼专用生化试剂	bei ke man zhuan yong sheng hua shi ji	1
贝郎留置针	bei lang liu zhi zhen	1
备皮刀	bei pi dao	1
钡石灰	bei shi hui	1
背姿矫正带	bei zi jiao zheng dai	1
苯巴比妥检测试剂	ben ba bi tuo jian ce shi ji	1
苯丙氨酸试剂盒	ben bing an suan shi ji he	1
本周氏蛋白电泳检验试剂	ben zhou shi dan bai dian yong jian yan shi ji	1
绷带	beng dai	1
鼻护圈	bi hu quan	1
鼻咽胆汁外引流管	bi yan dan zhi wai yin liu guan	1
鼻咽通气管	bi yan tong qi guan	1
避孕套	bi yun tao	1
便盆	bian pen	1
变色龙	bian se long	1
扁桃体钢丝	bian tao ti gang si	1
扁桃注射器	bian tao zhu she qi	1
便携式投影仪	bian xie shi tou ying yi	1
便携式血气分析仪测试卡	bian xie shi xue qi fen xi yi ce shi ka	1
变异株检测	bian yi zhu jian ce	1
标本柜	biao ben gui	1
标测导管	biao ce dao guan	1
标测电极八极	biao ce dian ji ba ji	1
标测电极导管	biao ce dian ji dao guan	1
标测电极十极	biao ce dian ji shi ji	1
标测电极十极固定弯	biao ce dian ji shi ji gu ding wan	1
标测电极双极	biao ce dian ji shuang ji	1
标测电极四极	biao ce dian ji si ji	1
标测电极四极固定弯	biao ce dian ji si ji gu ding wan	1
标记导管	biao ji dao guan	1
表面轨道式人工膝关节	biao mian gui dao shi ren gong xi guan jie	1
表面抗原试纸条	biao mian kang yuan shi zhi tiao	1
表面生长因子海绵	biao mian sheng zhang yin zi hai mian	1
表面置换柄	biao mian zhi huan bing	1
表面置换股骨假体	biao mian zhi huan gu gu jia ti	1
表面置换髋臼	biao mian zhi huan kuan jiu	1
标准陶瓷臼衬	biao zhun tao ci jiu chen	1
髌骨型抓髌器	bin gu xing zhua bin qi	1
丙氨酸氨基转移酶	bing an suan an ji zhuan yi mei	1
丙氨酸氨基转移酶试剂盒	bing an suan an ji zhuan yi mei shi ji he	1
丙氨酸氨基转移酶血站用	bing an suan an ji zhuan yi mei xue zhan yong	1
病毒	bing du	1
病毒检测试剂	bing du jian ce shi ji	1
病毒抗体	bing du kang ti	1
丙肝病毒	bing gan bing du	1
丙肝抗体	bing gan kang ti	1
丙肝抗体抗	bing gan kang ti kang	1
丙肝试剂盒	bing gan shi ji he	1
病历车	bing li che	1
病历夹	bing li jia	1
冰爽帖	bing shuang tie	1
丙酮	bing tong	1
丙酮酸激酶同功酶	bing tong suan ji mei tong gong mei	1
丙烯酸树脂骨水泥	bing xi suan shu zhi gu shui ni	1
冰箱	bing xiang	1
丙型肝炎检测试剂盒	bing xing gan yan jian ce shi ji he	1
丙型肝炎检测试剂盒血站用	bing xing gan yan jian ce shi ji he xue zhan yong	1
冰乙酸	bing yi suan	1
薄蜡片	bo la pian	1
玻璃拔火罐	bo li ba huo guan	1
玻璃柜	bo li gui	1
玻璃离子	bo li li zi	1
玻璃量杯	bo li liang bei	1
玻璃培养皿	bo li pei yang min	1
玻璃平板	bo li ping ban	1
剥离钳	bo li qian	1
玻璃试管	bo li shi guan	1
玻离子	bo li zi	1
薄膜手套	bo mo shou tao	1
玻切头	bo qie tou	1
玻形蛋白	bo xing dan bai	1
部分凝血酶原时间	bu fen ning xue mei yuan shi jian	1
部分凝血酶原时间硅土	bu fen ning xue mei yuan shi jian gui tu	1
不干胶标签	bu gan jiao biao qian	1
布巾钳	bu jin qian	1
不可吸收性缝合线	bu ke xi shou xing feng he xian	1
不可吸收硬脑膜补片	bu ke xi shou ying nao mo bu pian	1
布朗氏架	bu lang shi jia	1
布帕钳	bu pa qian	1
补片心脏外科	bu pian xin zang wai ke	1
补体	bu ti	1
补体测定试剂	bu ti ce ding shi ji	1
不锈钢标本柜	bu xiu gang biao ben gui	1
不锈钢冠脉支架	bu xiu gang guan mai zhi jia	1
不锈钢球头	bu xiu gang qiu tou	1
不锈钢诊床	bu xiu gang zhen chuang	1
不锈钢治疗车	bu xiu gang zhi liao che	1
不粘敷料	bu zhan fu liao	1
参比液	can bi ye	1
残疾护理液	can ji hu li ye	1
残疾袜套	can ji wa tao	1
操作台	cao zuo tai	1
测深器	ce shen qi	1
测试纸	ce shi zhi	1
侧向型股骨柄	ce xiang xing gu gu bing	1
层粘蛋白	ceng zhan dan bai	1
茶碱	cha jian	1
茶碱定标液	cha jian ding biao ye	1
茶碱质控	cha jian zhi kong	1
查理股骨柄	cha li gu gu bing	1
拆线剪	chai xian jian	1
产品名称	chan pin ming cheng	1
肠道冲洗器	chang dao chong xi qi	1
肠杆菌科生化	chang gan jun ke sheng hua	1
长效抗菌材料	chang xiao kang jun cai liao	1
超薄球囊	chao bao qiu nang	1
超大球囊	chao da qiu nang	1
超高分子垫层	chao gao fen zi dian ceng	1
超高分子聚乙烯髋臼杯	chao gao fen zi ju yi xi kuan jiu bei	1
超滑毕加索球囊扩张导管	chao hua bi jia suo qiu nang kuo zhang dao guan	1
超滑导丝	chao hua dao si	1
超滑短交换导丝	chao hua duan jiao huan dao si	1
超滑绿泥鳅交换导丝	chao hua lv ni qiu jiao huan dao si	1
超滑微导丝	chao hua wei dao si	1
超记录纸	chao ji lu zhi	1
超敏促甲状腺素	chao min cu jia zhuang xian su	1
超敏反应蛋白	chao min fan ying dan bai	1
超敏反应蛋白生化仪专用	chao min fan ying dan bai sheng hua yi zhuan yong	1
超扭控交换硬导丝导引导丝	chao niu kong jiao huan ying dao si dao yin dao si	1
超藕合剂	chao ou he ji	1
超声波诊断仪	chao sheng bo zhen duan yi	1
超声多普勒胎音仪	chao sheng duo pu le tai yin yi	1
超声耦合剂	chao sheng ou he ji	1
超声雾化器	chao sheng wu hua qi	1
超声像图软件	chao sheng xiang tu ruan jian	1
超图像记录纸	chao tu xiang ji lu zhi	1
超显微镜	chao xian wei jing	1
超显影剂	chao xian ying ji	1
超显影仪	chao xian ying yi	1
超小球囊	chao xiao qiu nang	1
超选择造影导管	chao xuan ze zao ying dao guan	1
超硬导丝	chao ying dao si	1
超硬交换导丝	chao ying jiao huan dao si	1
超硬石膏	chao ying shi gao	1
车针	che zhen	1
衬垫加强型全膝关节	chen dian jia qiang xing quan xi guan jie	1
成人病态牙模型	cheng ren bing tai ya mo xing	1
成人血培养瓶	cheng ren xue pei yang ping	1
齿分解模型	chi fen jie mo xing	1
尺骨鹰嘴钩型板	chi gu ying zui gou xing ban	1
尺骨鹰嘴钩型板不锈钢	chi gu ying zui gou xing ban bu xiu gang	1
尺骨鹰嘴钩型板纯钛	chi gu ying zui gou xing ban chun tai	1
尺骨鹰嘴钩型板钛合金	chi gu ying zui gou xing ban tai he jin	1
齿科技工桌	chi ke ji gong zhuo	1
齿科种植系统及材料	chi ke zhong zhi xi tong ji cai liao	1
持卵针	chi luan zhen	1
持物桶	chi wu tong	1
持针器	chi zhen qi	1
重建钢板	chong jian gang ban	1
冲洗肠袋	chong xi chang dai	1
冲吸器	chong xi qi	1
抽真空测试纸包	chou zhen kong ce shi zhi bao	1
除颤电极导线	chu chan dian ji dao xian	1
除颤器	chu chan qi	1
初次置换骨水泥型柄含股骨头	chu ci zhi huan gu shui ni xing bing han gu gu tou	1
初次置换骨水泥直柄	chu ci zhi huan gu shui ni zhi bing	1
初次置换生物固定髋臼内衬	chu ci zhi huan sheng wu gu ding kuan jiu nei chen	1
初次置换生物型固定髋臼杯	chu ci zhi huan sheng wu xing gu ding kuan jiu bei	1
初次置换生物型髋臼杯	chu ci zhi huan sheng wu xing kuan jiu bei	1
初次置换生物型髋臼杯微孔	chu ci zhi huan sheng wu xing kuan jiu bei wei kong	1
储气罐	chu qi guan	1
出诊箱	chu zhen xiang	1
穿刺包	chuan ci bao	1
穿刺器	chuan ci qi	1
穿刺套装	chuan ci tao zhuang	1
穿刺针	chuan ci zhen	1
床单位消毒机用床罩	chuang dan wei xiao du ji yong chuang zhao	1
创伤清洗系统及清洗头	chuang shang qing xi xi tong ji qing xi tou	1
创伤用骶骨板	chuang shang yong di gu ban	1
创伤用骶骨棒	chuang shang yong di gu bang	1
床刷	chuang shua	1
床刷套	chuang shua tao	1
床套	chuang tao	1
床头柜	chuang tou gui	1
窗头柜	chuang tou gui	1
垂体泌乳素	chui ti mi ru su	1
雌二醇	ci er chun	1
雌激素检测试剂	ci ji su jian ce shi ji	1
雌激素受体	ci ji su shou ti	1
次氯酸钠	ci lv suan na	1
次氯酸钠消毒剂	ci lv suan na xiao du ji	1
雌三醇	ci san chun	1
瓷牙	ci ya	1
促红细胞生成素	cu hong xi bao sheng cheng su	1
促黄体生成素	cu huang ti sheng cheng su	1
促黄体生成素检测试剂	cu huang ti sheng cheng su jian ce shi ji	1
促甲状腺激素	cu jia zhuang xian ji su	1
促甲状腺素	cu jia zhuang xian su	1
促卵泡生成激素	cu luan pao sheng cheng ji su	1
促卵泡生成素	cu luan pao sheng cheng su	1
促卵泡素检测试剂	cu luan pao su jian ce shi ji	1
促肾上腺皮质激素	cu shen shang xian pi zhi ji su	1
催乳素检测试剂	cui ru su jian ce shi ji	1
大肠杆菌检测试剂盒	da chang gan jun jian ce shi ji he	1
大动脉覆膜支架	da dong mai fu mo zhi jia	1
大钢托	da gang tuo	1
大力剪	da li jian	1
大麻检测试剂	da ma jian ce shi ji	1
搭桥固定器	da qiao gu ding qi	1
大腿假肢成人型	da tui jia zhi cheng ren xing	1
大腿假肢儿童型	da tui jia zhi er tong xing	1
大腿矫形器	da tui jiao xing qi	1
打针垂	da zhen chui	1
大直径股骨头	da zhi jing gu gu tou	1
打桩套装	da zhuang tao zhuang	1
带钩方丝弓托槽	dai gou fang si gong tuo cao	1
带假头牙科临床模拟实习桌	dai jia tou ya ke lin chuang mo ni shi xi zhuo	1
带屏风边柜	dai ping feng bian gui	1
带线缝合针	dai xian feng he zhen	1
带有亲水涂层的导丝	dai you qin shui tu ceng de dao si	1
带有亲水涂层的可控导丝	dai you qin shui tu ceng de ke kong dao si	1
带有亲水涂层的漂浮导管	dai you qin shui tu ceng de piao fu dao guan	1
带有推送系统的髂动脉支架	dai you tui song xi tong de qia dong mai zhi jia	1
带有推送系统的人造血管支架	dai you tui song xi tong de ren zao xue guan zhi jia	1
带止血阀导管鞘	dai zhi xue fa dao guan qiao	1
带止血阀动脉鞘	dai zhi xue fa dong mai qiao	1
蛋白代用品	dan bai dai yong pin	1
单边外固定支架	dan bian wai gu ding zhi jia	1
单边外固定支架不带关节	dan bian wai gu ding zhi jia bu dai guan jie	1
单边外固定支架带关节	dan bian wai gu ding zhi jia dai guan jie	1
单纯庖疹病毒	dan chun pao zhen bing du	1
单纯庖疹病毒抗体	dan chun pao zhen bing du kang ti	1
单纯疱疹病毒型	dan chun pao zhen bing du xing	1
胆道气囊扩张导管	dan dao qi nang kuo zhang dao guan	1
胆道支架	dan dao zhi jia	1
胆道支架镍钛合金支架	dan dao zhi jia nie tai he jin zhi jia	1
单放机	dan fang ji	1
胆红素标准品	dan hong su biao zhun pin	1
单极半髋	dan ji ban kuan	1
单极半髋单极股骨头	dan ji ban kuan dan ji gu gu tou	1
单极半髋钴铬钼合金单极股骨头	dan ji ban kuan gu ge mu he jin dan ji gu gu tou	1
单极股骨头	dan ji gu gu tou	1
单极经皮下除颤电极	dan ji jing pi xia chu chan dian ji	1
单极球头	dan ji qiu tou	1
单极心房导线	dan ji xin fang dao xian	1
单极心房电极	dan ji xin fang dian ji	1
单极心室导线	dan ji xin shi dao xian	1
单极心室电极	dan ji xin shi dian ji	1
单极心室细电极	dan ji xin shi xi dian ji	1
单极左室电极	dan ji zuo shi dian ji	1
担架	dan jia	1
担架急救推车	dan jia ji jiu tui che	1
担架救护车用	dan jia jiu hu che yong	1
胆碱酯酶	dan jian zhi mei	1
胆碱脂酶试剂盒	dan jian zhi mei shi ji he	1
胆碱酯酶试纸	dan jian zhi mei shi zhi	1
单精注射针	dan jing zhu she zhen	1
单髁	dan ke	1
单颗膝关节系统	dan ke xi guan jie xi tong	1
单髁型膝关节置换系统	dan ke xing xi guan jie zhi huan xi tong	1
单髁置换型	dan ke zhi huan xing	1
胆囊造瘘管	dan nang zao lou guan	1
单腔取卵针	dan qiang qu luan zhen	1
单腔型	dan qiang xing	1
单腔中心静脉导管	dan qiang zhong xin jing mai dao guan	1
导管	dao guan	1
导管传送系统	dao guan chuan song xi tong	1
导管护套导入器及套件	dao guan hu tao dao ru qi ji tao jian	1
导管血管内超声导管	dao guan xue guan nei chao sheng dao guan	1
导尿管	dao niao guan	1
导丝	dao si	1
导丝调节器	dao si tiao jie qi	1
导向器	dao xiang qi	1
导引导管	dao yin dao guan	1
导引导丝	dao yin dao si	1
等离子喷涂股骨柄	deng li zi pen tu gu gu bing	1
登士柏光固树脂	deng shi bai guang gu shu zhi	1
登士柏树脂	deng shi bai shu zhi	1
地灯	di deng	1
地高辛检测试剂	di gao xin jian ce shi ji	1
骶骨板棒系统不锈钢	di gu ban bang xi tong bu xiu gang	1
骶骨板棒系统钛合金	di gu ban bang xi tong tai he jin	1
骶骨板骶骨连接器	di gu ban di gu lian jie qi	1
骶骨钉含附件	di gu ding han fu jian	1
骶骨钢板不锈钢	di gu gang ban bu xiu gang	1
骶骨钢板纯钛	di gu gang ban chun tai	1
骶骨钢板钛合金	di gu gang ban tai he jin	1
滴管	di guan	1
涤纶补片心脏外科	di lun bu pian xin zang wai ke	1
低密度脂蛋白	di mi du zhi dan bai	1
低密度脂蛋白胆固醇	di mi du zhi dan bai dan gu chun	1
低密度脂蛋白胆固醇试剂盒	di mi du zhi dan bai dan gu chun shi ji he	1
低切迹内衬	di qie ji nei chen	1
底物片	di wu pian	1
低压吸引器	di ya xi yin qi	1
低粘骨水泥注入器	di zhan gu shui ni zhu ru qi	1
地中海贫血基因诊断试剂	di zhong hai pin xue ji yin zhen duan shi ji	1
电池	dian chi	1
电磁波谱治疗器	dian ci bo pu zhi liao qi	1
电刀保套	dian dao bao tao	1
碘酊	dian ding	1
电动流产吸引器	dian dong liu chan xi yin qi	1
碘仿	dian fang	1
淀粉酶	dian fen mei	1
淀粉酶试剂盒	dian fen mei shi ji he	1
碘伏	dian fu	1
碘伏类消毒剂	dian fu lei xiao du ji	1
碘伏帽	dian fu mao	1
电钩	dian gou	1
电极	dian ji	1
电极片	dian ji pian	1
电极贴	dian ji tie	1
电极心内膜除颤电极	dian ji xin nei mo chu chan dian ji	1
电解抛光机	dian jie pao guang ji	1
电解弹簧圈	dian jie tan huang quan	1
电脑	dian nao	1
电脑桌	dian nao zhuo	1
电凝	dian ning	1
垫片	dian pian	1
电热水器	dian re shui qi	1
电生理临时起搏电极	dian sheng li lin shi qi bo dian ji	1
电视	dian shi	1
电视机	dian shi ji	1
电视力表	dian shi li biao	1
电子听诊仪	dian zi ting zhen yi	1
电子血压计	dian zi xue ya ji	1
电子振荡器	dian zi zhen dang qi	1
钓肩锁关节钢板	diao jian suo guan jie gang ban	1
丁肝抗体	ding gan kang ti	1
丁肝抗原	ding gan kang yuan	1
丁硼漱口液	ding peng shu kou ye	1
丁香油	ding xiang you	1
丁型肝炎抗体	ding xing gan yan kang ti	1
丁型肝炎抗体检测试剂盒	ding xing gan yan kang ti jian ce shi ji he	1
丁型肝炎抗原	ding xing gan yan kang yuan	1
定型卡	ding xing ka	1
洞巾	dong jin	1
动静脉穿刺针	dong jing mai chuan ci zhen	1
动静脉留置针	dong jing mai liu zhi zhen	1
动力加压不锈钢板	dong li jia ya bu xiu gang ban	1
动力加压钢板	dong li jia ya gang ban	1
动力髁加压板	dong li ke jia ya ban	1
动力髁加压系统	dong li ke jia ya xi tong	1
动力髁加压系统不锈钢	dong li ke jia ya xi tong bu xiu gang	1
动力髁加压系统纯钛	dong li ke jia ya xi tong chun tai	1
动力髁加压系统钛合金	dong li ke jia ya xi tong tai he jin	1
动力髁螺钉	dong li ke luo ding	1
动力髋	dong li kuan	1
动力髋加压板	dong li kuan jia ya ban	1
动力髋加压系统	dong li kuan jia ya xi tong	1
动力髋加压系统不锈钢	dong li kuan jia ya xi tong bu xiu gang	1
动力髋加压系统纯钛	dong li kuan jia ya xi tong chun tai	1
动力髋加压系统钛合金	dong li kuan jia ya xi tong tai he jin	1
动力髋螺钉	dong li kuan luo ding	1
动脉插管	dong mai cha guan	1
动脉瘤夹	dong mai liu jia	1
动脉瘤夹神经外科	dong mai liu jia shen jing wai ke	1
动脉鞘长鞘组	dong mai qiao chang qiao zu	1
动脉鞘普通鞘组	dong mai qiao pu tong qiao zu	1
动脉微栓过滤器	dong mai wei shuan guo lv qi	1
动脉血管长鞘	dong mai xue guan chang qiao	1
动脉血管鞘管	dong mai xue guan qiao guan	1
动脉血管鞘组	dong mai xue guan qiao zu	1
动脉血管鞘组导管鞘套装	dong mai xue guan qiao zu dao guan qiao tao zhuang	1
短鞘	duan qiao	1
钝头穿刺器	dun tou chuan ci qi	1
多层色树脂牙	duo ceng se shu zhi ya	1
多层色树脂牙贴面	duo ceng se shu zhi ya tie mian	1
多功能肝脏牵开器	duo gong neng gan zang qian kai qi	1
多功能引流管	duo gong neng yin liu guan	1
多孔层人工髋关节	duo kong ceng ren gong kuan guan jie	1
多孔层人工髋关节柄	duo kong ceng ren gong kuan guan jie bing	1
多孔层人工髋关节髋臼内衬	duo kong ceng ren gong kuan guan jie kuan jiu nei chen	1
多米诺连接头	duo mi nuo lian jie tou	1
多项标准血清	duo xiang biao zhun xue qing	1
多用车	duo yong che	1
多用启瓶器	duo yong qi ping qi	1
额带反光镜镜面	e dai fan guang jing jing mian	1
腭弓	e gong	1
额镜	e jing	1
鹅颈灯	e jing deng	1
二甲苯	er jia ben	1
二尖瓣球囊	er jian ban qiu nang	1
二尖瓣球囊及配件	er jian ban qiu nang ji pei jian	1
二聚体测定试剂盒	er ju ti ce ding shi ji he	1
二聚体测试盒	er ju ti ce shi he	1
二硫苏糖醇	er liu su tang chun	1
耳膜测温仪	er mo ce wen yi	1
儿童型管路	er tong xing guan lu	1
二氧化碳	er yang hua tan	1
二氧化碳测定试剂盒	er yang hua tan ce ding shi ji he	1
二氧化碳试剂盒	er yang hua tan shi ji he	1
二医用卫生材料及敷料	er yi yong wei sheng cai liao ji fu liao	1
饭盒	fan he	1
凡士林纱布	fan shi lin sha bu	1
凡士林纱条	fan shi lin sha tiao	1
翻修股骨柄	fan xiu gu gu bing	1
翻修髋臼杯	fan xiu kuan jiu bei	1
翻修髋臼杯专用螺钉	fan xiu kuan jiu bei zhuan yong luo ding	1
翻修髋臼外杯	fan xiu kuan jiu wai bei	1
翻修全膝关节	fan xiu quan xi guan jie	1
翻修全膝关节带延长柄	fan xiu quan xi guan jie dai yan chang bing	1
翻修钛帽	fan xiu tai mao	1
翻修膝关节	fan xiu xi guan jie	1
翻修膝关节假体	fan xiu xi guan jie jia ti	1
翻修型股骨柄	fan xiu xing gu gu bing	1
翻修型股骨柄骨水泥	fan xiu xing gu gu bing gu shui ni	1
翻修型股骨直柄	fan xiu xing gu gu zhi bing	1
反应蛋白	fan ying dan bai	1
反应蛋白检测试剂盒	fan ying dan bai jian ce shi ji he	1
反应蛋白生化仪专用	fan ying dan bai sheng hua yi zhuan yong	1
方弓丝	fang gong si	1
方块纱布	fang kuai sha bu	1
方盘	fang pan	1
放射治疗皮肤防护剂	fang she zhi liao pi fu fang hu ji	1
房室顺序双心室同步三腔起搏器	fang shi shun xu shuang xin shi tong bu san qiang qi bo qi	1
方丝弓成形器	fang si gong cheng xing qi	1
方丝弓带环	fang si gong dai huan	1
方丝弓颊面管	fang si gong jia mian guan	1
方丝弓托槽	fang si gong tuo cao	1
防脱位臼	fang tuo wei jiu	1
仿真离体模型	fang zhen li ti mo xing	1
非编织增强造影导管	fei bian zhi zeng qiang zao ying dao guan	1
肺补片	fei bu pian	1
非不锈钢支架	fei bu xiu gang zhi jia	1
肥达氏菌液	fei da shi jun ye	1
肥达氏试剂	fei da shi shi ji	1
肺动脉球囊	fei dong mai qiu nang	1
非发酵菌定卡	fei fa jiao jun ding ka	1
非发酵菌生化	fei fa jiao jun sheng hua	1
腓骨钢板	fei gu gang ban	1
腓骨钢板不锈钢	fei gu gang ban bu xiu gang	1
腓骨钢板纯钛	fei gu gang ban chun tai	1
腓骨钢板钛合金	fei gu gang ban tai he jin	1
非骨水泥标准柄	fei gu shui ni biao zhun bing	1
非骨水泥柄	fei gu shui ni bing	1
非骨水泥翻修	fei gu shui ni fan xiu	1
非骨水泥加长柄	fei gu shui ni jia chang bing	1
非骨水泥压配型股骨柄	fei gu shui ni ya pei xing gu gu bing	1
腓骨远端异型解剖钢板	fei gu yuan duan yi xing jie pou gang ban	1
腓骨远端异型解剖钢板不锈钢	fei gu yuan duan yi xing jie pou gang ban bu xiu gang	1
腓骨远端异型解剖钢板纯钛	fei gu yuan duan yi xing jie pou gang ban chun tai	1
腓骨远端异型解剖钢板钛合金	fei gu yuan duan yi xing jie pou gang ban tai he jin	1
肥厚性心肌病消蚀专用球囊导管	fei hou xing xin ji bing xiao shi zhuan yong qiu nang dao guan	1
非金属肠道支架	fei jin shu chang dao zhi jia	1
非金属胆道支架	fei jin shu dan dao zhi jia	1
非金属捆绑支架	fei jin shu kun bang zhi jia	1
非金属食道支架	fei jin shu shi dao zhi jia	1
非可吸收缝合线	fei ke xi shou feng he xian	1
非灭菌普通棉签	fei mie jun pu tong mian qian	1
非灭菌医用脱脂棉花	fei mie jun yi yong tuo zhi mian hua	1
非温控射频消融导管加硬可调弯	fei wen kong she pin xiao rong dao guan jia ying ke tiao wan	1
非温控射频消融导管可调弯	fei wen kong she pin xiao rong dao guan ke tiao wan	1
肺吸虫抗体检测试剂	fei xi chong kang ti jian ce shi ji	1
非血管金属支架肠道支架	fei xue guan jin shu zhi jia chang dao zhi jia	1
非血管金属支架胆道支架	fei xue guan jin shu zhi jia dan dao zhi jia	1
非血管金属支架捆绑支架	fei xue guan jin shu zhi jia kun bang zhi jia	1
非血管金属支架气管支架	fei xue guan jin shu zhi jia qi guan zhi jia	1
非血管金属支架前列腺支架	fei xue guan jin shu zhi jia qian lie xian zhi jia	1
非血管金属支架食道支架	fei xue guan jin shu zhi jia shi dao zhi jia	1
肺炎衣原体检测试剂	fei yan yi yuan ti jian ce shi ji	1
肺炎支原体	fei yan zhi yuan ti	1
肺炎支原体抗体检测试剂	fei yan zhi yuan ti kang ti jian ce shi ji	1
分离剂	fen li ji	1
分析天平	fen xi tian ping	1
分型试剂盒	fen xing shi ji he	1
封堵器及输送系统	feng du qi ji shu song xi tong	1
封堵球囊导管和系统	feng du qiu nang dao guan he xi tong	1
缝合线	feng he xian	1
缝合线束	feng he xian shu	1
缝合针	feng he zhen	1
风疹病毒	feng zhen bing du	1
腹部带	fu bu dai	1
妇产科中单	fu chan ke zhong dan	1
福尔马林指示卡	fu er ma lin zhi shi ka	1
复合体	fu he ti	1
妇检垫	fu jian dian	1
敷料贴	fu liao tie	1
覆膜胆道支架含输送系统	fu mo dan dao zhi jia han shu song xi tong	1
覆膜防反流食道支架含输送系统	fu mo fang fan liu shi dao zhi jia han shu song xi tong	1
覆膜食道支架含输送系统	fu mo shi dao zhi jia han shu song xi tong	1
腹膜透析管	fu mo tou xi guan	1
腹膜透析管用接头	fu mo tou xi guan yong jie tou	1
腹膜透析用蓝夹子	fu mo tou xi yong lan jia zi	1
腹膜透析用排液空袋	fu mo tou xi yong pai ye kong dai	1
妇女外用抗菌器	fu nv wai yong kang jun qi	1
腹腔引流管	fu qiang yin liu guan	1
腹透连接短管	fu tou lian jie duan guan	1
负压引流袋	fu ya yin liu dai	1
负压引流瓶	fu ya yin liu ping	1
负压引流瓶塞	fu ya yin liu ping sai	1
负压引流器	fu ya yin liu qi	1
负压引流球	fu ya yin liu qiu	1
腹主动脉瘤支架系统	fu zhu dong mai liu zhi jia xi tong	1
盖玻片	gai bo pian	1
钙测定试剂盒	gai ce ding shi ji he	1
钙石灰	gai shi hui	1
甘氨酸脯氨酸二肽转移酶	gan an suan fu an suan er tai zhuan yi mei	1
肝管	gan guan	1
干热化学指示卡	gan re hua xue zhi shi ka	1
干式激光胶片	gan shi ji guang jiao pian	1
肝素帽	gan su mao	1
肝吸虫抗体检测试剂	gan xi chong kang ti jian ce shi ji	1
甘油三酯	gan you san zhi	1
甘油三酯试剂盒	gan you san zhi shi ji he	1
甘油三酯液体试剂盒	gan you san zhi ye ti shi ji he	1
肛表	gang biao	1
肛管	gang guan	1
肛门袋	gang men dai	1
肛门管	gang men guan	1
肛门镜	gang men jing	1
肛门卷	gang men juan	1
钢丝	gang si	1
钢牙	gang ya	1
高尔夫球棒形骨钢板	gao er fu qiu bang xing gu gang ban	1
高分子聚乙烯内衬标准型	gao fen zi ju yi xi nei chen biao zhun xing	1
高分子聚乙烯内衬防脱位型	gao fen zi ju yi xi nei chen fang tuo wei xing	1
高分子树脂绷带	gao fen zi shu zhi beng dai	1
膏剂用外敷纸	gao ji yong wai fu zhi	1
高交联骨水泥髋臼杯	gao jiao lian gu shui ni kuan jiu bei	1
高交联内衬	gao jiao lian nei chen	1
高灵敏人促甲状腺素	gao ling min ren cu jia zhuang xian su	1
高密度脂蛋白	gao mi du zhi dan bai	1
高密度脂蛋白胆固醇	gao mi du zhi dan bai dan gu chun	1
高密度脂蛋白胆固醇试剂盒	gao mi du zhi dan bai dan gu chun shi ji he	1
高粘度抗生素骨水泥	gao nian du kang sheng su gu shui ni	1
高屈曲度全膝关节	gao qu qu du quan xi guan jie	1
高屈曲人工膝关节	gao qu qu ren gong xi guan jie	1
高屈曲旋转平台型全膝	gao qu qu xuan zhuan ping tai xing quan xi	1
睾酮	gao tong	1
睾酮检测试剂	gao tong jian ce shi ji	1
高通量透析器合成膜透析器膜	gao tong liang tou xi qi he cheng mo tou xi qi mo	1
高通量透析器三醋酸膜透析器膜	gao tong liang tou xi qi san cu suan mo tou xi qi mo	1
高通量透析器双醋酸膜透析器膜	gao tong liang tou xi qi shuang cu suan mo tou xi qi mo	1
高通量透析器血仿膜透析器膜	gao tong liang tou xi qi xue fang mo tou xi qi mo	1
高温指示胶带	gao wen zhi shi jiao dai	1
高压球囊扩张导管球囊扩张导管	gao ya qiu nang kuo zhang dao guan qiu nang kuo zhang dao guan	1
高压蒸汽灭菌指示胶带	gao ya zheng qi mie jun zhi shi jiao dai	1
高压注射器针筒	gao ya zhu she qi zhen tong	1
高阻抗导线	gao zu kang dao xian	1
革兰氏染色液	ge lan shi ran se ye	1
革兰氏染液	ge lan shi ran ye	1
革兰阳性菌鉴定卡	ge lan yang xing jun jian ding ka	1
革兰阴性菌鉴定卡	ge lan yin xing jun jian ding ka	1
哥伦比亚琼脂干粉	ge lun bi ya qiong zhi gan fen	1
各种尿沉渣系列试剂含标准质控	ge zhong niao chen zha xi lie shi ji han biao zhun zhi kong	1
各种生化分析仪样品杯	ge zhong sheng hua fen xi yi yang pin bei	1
跟骨钢板	gen gu gang ban	1
跟骨钢板不锈钢	gen gu gang ban bu xiu gang	1
跟骨钢板纯钛	gen gu gang ban chun tai	1
跟骨钢板钛合金	gen gu gang ban tai he jin	1
跟骨锁定钢板	gen gu suo ding gang ban	1
跟骨锁定钢板不锈钢	gen gu suo ding gang ban bu xiu gang	1
跟骨锁定钢板纯钛	gen gu suo ding gang ban chun tai	1
跟骨锁定钢板钛合金	gen gu suo ding gang ban tai he jin	1
跟骨型接骨板	gen gu xing jie gu ban	1
根管侧压针	gen guan ce ya zhen	1
根管充填剂	gen guan chong tian ji	1
根管扩挫针	gen guan kuo cuo zhen	1
根管填充器	gen guan tian chong qi	1
庚肝抗体	geng gan kang ti	1
庚型肝炎抗体	geng xing gan yan kang ti	1
肱骨近端锁定异型解剖钢板纯钛	gong gu jin duan suo ding yi xing jie pou gang ban chun tai	1
肱骨近端异型解剖钢板	gong gu jin duan yi xing jie pou gang ban	1
肱骨近端异型解剖钢板不锈钢	gong gu jin duan yi xing jie pou gang ban bu xiu gang	1
肱骨近端异型解剖钢板纯钛	gong gu jin duan yi xing jie pou gang ban chun tai	1
肱骨近端异型解剖钢板钛合金	gong gu jin duan yi xing jie pou gang ban tai he jin	1
肱骨近端异型解剖锁定钢板	gong gu jin duan yi xing jie pou suo ding gang ban	1
肱骨远端锁定异型解剖钢板纯钛	gong gu yuan duan suo ding yi xing jie pou gang ban chun tai	1
肱骨远端异型解剖钢板	gong gu yuan duan yi xing jie pou gang ban	1
肱骨远端异型解剖钢板不锈钢	gong gu yuan duan yi xing jie pou gang ban bu xiu gang	1
肱骨远端异型解剖钢板纯钛	gong gu yuan duan yi xing jie pou gang ban chun tai	1
肱骨远端异型解剖钢板钛合金	gong gu yuan duan yi xing jie pou gang ban tai he jin	1
肱骨远端异型解剖锁定钢板	gong gu yuan duan yi xing jie pou suo ding gang ban	1
宫颈刮片	gong jing gua pian	1
宫颈活检钳	gong jing huo jian qian	1
宫颈钳	gong jing qian	1
共聚体骨水泥	gong ju ti gu shui ni	1
宫腔内人工授精导管	gong qiang nei ren gong shou jing dao guan	1
弓形体抗体	gong xing ti kang ti	1
谷氨酰基转移酶	gu an xian ji zhuan yi mei	1
谷氨酰转肽酶	gu an xian zhuan tai mei	1
谷氨酰转移酶	gu an xian zhuan yi mei	1
谷氨酰转移酶试剂盒	gu an xian zhuan yi mei shi ji he	1
谷草转氨酶	gu cao zhuan an mei	1
固定矫正模型	gu ding jiao zheng mo xing	1
固定螺钉	gu ding luo ding	1
骨钙素	gu gai su	1
骨骼	gu ge	1
钴铬钼股骨头	gu ge mu gu gu tou	1
钴铬钼关节头	gu ge mu guan jie tou	1
钴铬钼合金股骨柄	gu ge mu he jin gu gu bing	1
钴铬钼合金股骨头	gu ge mu he jin gu gu tou	1
钴铬钼合金人工股骨柄	gu ge mu he jin ren gong gu gu bing	1
钴铬钼合金人工股骨头	gu ge mu he jin ren gong gu gu tou	1
钴铬钼金属球头	gu ge mu jin shu qiu tou	1
钴铬钼头	gu ge mu tou	1
股骨柄	gu gu bing	1
股骨柄定制	gu gu bing ding zhi	1
股骨柄直柄	gu gu bing zhi bing	1
股骨柄直柄羟基磷灰石	gu gu bing zhi bing qiang ji lin hui shi	1
股骨柄直柄微孔	gu gu bing zhi bing wei kong	1
股骨干	gu gu gan	1
股骨近端锁定异型解剖钢板纯钛	gu gu jin duan suo ding yi xing jie pou gang ban chun tai	1
股骨近端异型解剖钢板	gu gu jin duan yi xing jie pou gang ban	1
股骨近端异型解剖钢板不锈钢	gu gu jin duan yi xing jie pou gang ban bu xiu gang	1
股骨近端异型解剖钢板纯钛	gu gu jin duan yi xing jie pou gang ban chun tai	1
股骨近端异型解剖钢板钛合金	gu gu jin duan yi xing jie pou gang ban tai he jin	1
股骨近端异型解剖锁定钢板	gu gu jin duan yi xing jie pou suo ding gang ban	1
股骨髁骨支持纯钛钢板	gu gu ke gu zhi chi chun tai gang ban	1
股骨髁骨支持医用钢板	gu gu ke gu zhi chi yi yong gang ban	1
股骨刷	gu gu shua	1
股骨锁定螺钉	gu gu suo ding luo ding	1
股骨头	gu gu tou	1
股骨头钴铬钼	gu gu tou gu ge mu	1
股骨头陶瓷	gu gu tou tao ci	1
股骨远端锁定异型解剖钢板纯钛	gu gu yuan duan suo ding yi xing jie pou gang ban chun tai	1
股骨远端微创板	gu gu yuan duan wei chuang ban	1
股骨远端微创钢板不锈钢	gu gu yuan duan wei chuang gang ban bu xiu gang	1
股骨远端微创钢板纯钛	gu gu yuan duan wei chuang gang ban chun tai	1
股骨远端微创钢板钛合金	gu gu yuan duan wei chuang gang ban tai he jin	1
股骨远端异型解剖钢板	gu gu yuan duan yi xing jie pou gang ban	1
股骨远端异型解剖钢板不锈钢	gu gu yuan duan yi xing jie pou gang ban bu xiu gang	1
股骨远端异型解剖钢板纯钛	gu gu yuan duan yi xing jie pou gang ban chun tai	1
股骨远端异型解剖钢板钛合金	gu gu yuan duan yi xing jie pou gang ban tai he jin	1
股骨远端异型解剖锁定钢板	gu gu yuan duan yi xing jie pou suo ding gang ban	1
股骨重度缺损型	gu gu zhong du que sun xing	1
股关节	gu guan jie	1
骨碱性磷酸酶试剂	gu jian xing lin suan mei shi ji	1
股静脉用中记静脉导管	gu jing mai yong zhong ji jing mai dao guan	1
骨科钻头	gu ke zuan tou	1
骨蜡	gu la	1
骨螺钉	gu luo ding	1
骨螺丝	gu luo si	1
骨膜剥离器	gu mo bo li qi	1
骨盆纯钛钢板	gu pen chun tai gang ban	1
骨盆钢板	gu pen gang ban	1
骨栓	gu shuan	1
骨水泥	gu shui ni	1
骨水泥标准柄	gu shui ni biao zhun bing	1
骨水泥标准柄带中置器	gu shui ni biao zhun bing dai zhong zhi qi	1
骨水泥柄	gu shui ni bing	1
骨水泥长股骨柄	gu shui ni chang gu gu bing	1
骨水泥翻修柄	gu shui ni fan xiu bing	1
骨水泥固定初次置换	gu shui ni gu ding chu ci zhi huan	1
骨水泥固定初次置换关节柄	gu shui ni gu ding chu ci zhi huan guan jie bing	1
骨水泥固定初次置换聚乙烯髋臼	gu shui ni gu ding chu ci zhi huan ju yi xi kuan jiu	1
骨水泥固定翻修关节柄	gu shui ni gu ding fan xiu guan jie bing	1
骨水泥固定翻修解剖柄	gu shui ni gu ding fan xiu jie pou bing	1
骨水泥固定翻修型髋臼杯衬	gu shui ni gu ding fan xiu xing kuan jiu bei chen	1
骨水泥固定聚乙烯髋臼	gu shui ni gu ding ju yi xi kuan jiu	1
骨水泥固定配件	gu shui ni gu ding pei jian	1
骨水泥股骨柄	gu shui ni gu gu bing	1
骨水泥关节柄	gu shui ni guan jie bing	1
骨水泥加长柄	gu shui ni jia chang bing	1
骨水泥加长翻修柄	gu shui ni jia chang fan xiu bing	1
骨水泥搅拌器	gu shui ni jiao ban qi	1
骨水泥聚乙烯髋臼	gu shui ni ju yi xi kuan jiu	1
骨水泥髋臼	gu shui ni kuan jiu	1
骨水泥髋臼杯	gu shui ni kuan jiu bei	1
骨水泥枪	gu shui ni qiang	1
骨水泥式股骨柄	gu shui ni shi gu gu bing	1
骨水泥髓腔塞	gu shui ni sui qiang sai	1
骨水泥套管组件	gu shui ni tao guan zu jian	1
骨水泥套筒	gu shui ni tao tong	1
骨水泥特殊	gu shui ni te shu	1
骨水泥型股骨柄	gu shui ni xing gu gu bing	1
骨水泥型股骨柄标准型	gu shui ni xing gu gu bing biao zhun xing	1
骨水泥型股骨柄加长股骨距型	gu shui ni xing gu gu bing jia chang gu gu ju xing	1
骨水泥一体化	gu shui ni yi ti hua	1
骨水泥注射筒	gu shui ni zhu she tong	1
骨条	gu tiao	1
股小球	gu xiao qiu	1
骨园钉	gu yuan ding	1
骨折环抱式接骨器	gu zhe huan bao shi jie gu qi	1
骨折外固定器单侧	gu zhe wai gu ding qi dan ce	1
骨折型股骨柄	gu zhe xing gu gu bing	1
刮宫板	gua gong ban	1
刮治器	gua zhi qi	1
拐杖	guai zhang	1
灌肠袋	guan chang dai	1
灌肠桶	guan chang tong	1
关节	guan jie	1
关节柄	guan jie bing	1
关节假体	guan jie jia ti	1
关节臼	guan jie jiu	1
关节臼带翼髋臼杯	guan jie jiu dai yi kuan jiu bei	1
关节臼螺旋杯	guan jie jiu luo xuan bei	1
关节臼十字筋面全髋臼罩	guan jie jiu shi zi jin mian quan kuan jiu zhao	1
关节头	guan jie tou	1
冠脉导丝	guan mai dao si	1
冠脉覆膜支架	guan mai fu mo zhi jia	1
冠脉雷帕霉素洗脱支架系统	guan mai lei pa mei su xi tuo zhi jia xi tong	1
冠脉内旋磨装置及配件	guan mai nei xuan mo zhuang zhi ji pei jian	1
冠脉内旋切装置及配件	guan mai nei xuan qie zhuang zhi ji pei jian	1
冠脉球囊	guan mai qiu nang	1
冠脉远端保护装置	guan mai yuan duan bao hu zhuang zhi	1
冠脉支架	guan mai zhi jia	1
冠脉支架不锈钢支架	guan mai zhi jia bu xiu gang zhi jia	1
冠脉支架非不锈钢支架	guan mai zhi jia fei bu xiu gang zhi jia	1
管腔吻合器	guan qiang wen he qi	1
管探宫条	guan tan gong tiao	1
灌洗管	guan xi guan	1
管型钢板	guan xing gang ban	1
管型钢板不锈钢	guan xing gang ban bu xiu gang	1
管型钢板纯钛	guan xing gang ban chun tai	1
管型钢板钛合金	guan xing gang ban tai he jin	1
灌注系统	guan zhu xi tong	1
冠状动脉吹吸装置	guan zhuang dong mai chui xi zhuang zhi	1
冠状动脉分流器	guan zhuang dong mai fen liu qi	1
冠状动脉金属支架输送系统	guan zhuang dong mai jin shu zhi jia shu song xi tong	1
冠状动脉切割球囊	guan zhuang dong mai qie ge qiu nang	1
冠状动脉球囊	guan zhuang dong mai qiu nang	1
冠状动脉血管支架	guan zhuang dong mai xue guan zhi jia	1
冠状动脉支架输送系统	guan zhuang dong mai zhi jia shu song xi tong	1
冠状动脉支架系统	guan zhuang dong mai zhi jia xi tong	1
冠状窦标测电极	guan zhuang dou biao ce dian ji	1
冠状窦标测电极十极固定弯	guan zhuang dou biao ce dian ji shi ji gu ding wan	1
冠状窦标测电极十极可调弯	guan zhuang dou biao ce dian ji shi ji ke tiao wan	1
冠状窦标测电极四极可调弯	guan zhuang dou biao ce dian ji si ji ke tiao wan	1
冠状窦电极	guan zhuang dou dian ji	1
光感绿片	guang gan lv pian	1
光固化机	guang gu hua ji	1
光固化树脂	guang gu hua shu zhi	1
光滑髓针	guang hua sui zhen	1
光胶片	guang jiao pian	1
光胶片观察灯	guang jiao pian guan cha deng	1
光面标准柄	guang mian biao zhun bing	1
光面带环	guang mian dai huan	1
胱抑素	guang yi su	1
硅胶颅骨修补板	gui jiao lu gu xiu bu ban	1
硅胶塞	gui jiao sai	1
硅胶胃管	gui jiao wei guan	1
硅橡胶印模材全套装	gui xiang jiao yin mo cai quan tao zhuang	1
辊轴植皮刀	gun zhou zhi pi dao	1
国产内固定钢丝	guo chan nei gu ding gang si	1
腘动脉小球囊	guo dong mai xiao qiu nang	1
过敏原检验试剂	guo min yuan jian yan shi ji	1
过氧化氢消毒仪用耗材	guo yang hua qing xiao du yi yong hao cai	1
过氧乙酸	guo yang yi suan	1
海尔洗衣机	hai er xi yi ji	1
海咯因检测试剂	hai ge yin jian ce shi ji	1
氦管激光胶片	hai guan ji guang jiao pian	1
氦氖激光胶片	hai nai ji guang jiao pian	1
氦氖激光胶片定影套药	hai nai ji guang jiao pian ding ying tao yao	1
氦氖激光胶片显影套药	hai nai ji guang jiao pian xian ying tao yao	1
焊枪	han qiang	1
豪华型手与腕	hao hua xing shou yu wan	1
毫米螺钉	hao mi luo ding	1
毫米消融导管	hao mi xiao rong dao guan	1
核苷酸	he gan suan	1
核苷酸酶试剂盒	he gan suan mei shi ji he	1
贺利氏窝沟封闭剂	he li shi wo gou feng bi ji	1
颌面部钉板系统	he mian bu ding ban xi tong	1
颌面部硅胶植入材料	he mian bu gui jiao zhi ru cai liao	1
颌面部修补固定材料	he mian bu xiu bu gu ding cai liao	1
颌面接骨板	he mian jie gu ban	1
核心抗体试剂	he xin kang ti shi ji	1
核心抗体试剂抗	he xin kang ti shi ji kang	1
黑白干式片	hei bai gan shi pian	1
黑缝线	hei feng xian	1
黑晶股骨头	hei jing gu gu tou	1
黑色记号笔	hei se ji hao bi	1
横连器固定长度	heng lian qi gu ding chang du	1
横连器可调长度	heng lian qi ke tiao chang du	1
恒温水箱	heng wen shui xiang	1
红蜡笔	hong la bi	1
红蜡片	hong la pian	1
红色打样膏	hong se da yang gao	1
红外激光胶片	hong wai ji guang jiao pian	1
红细胞	hong xi bao	1
红叶印模材	hong ye yin mo cai	1
后方稳定型表面全膝	hou fang wen ding xing biao mian quan xi	1
后方稳定型表面膝关节假体	hou fang wen ding xing biao mian xi guan jie jia ti	1
后房型软晶体	hou fang xing ruan jing ti	1
后房型硬晶体	hou fang xing ying jing ti	1
猴肝间接免疫荧光法检测试剂盒	hou gan jian jie mian yi ying guang fa jian ce shi ji he	1
后交叉韧带保留型关节表面膝	hou jiao cha ren dai bao liu xing guan jie biao mian xi	1
后交叉韧带保留型膝关节	hou jiao cha ren dai bao liu xing xi guan jie	1
喉头喷雾器	hou tou pen wu qi	1
后稳定型膝关节	hou wen ding xing xi guan jie	1
后牙根管钉	hou ya gen guan ding	1
护踝	hu huai	1
护肩	hu jian	1
护理车	hu li che	1
护理牙刷海棉棒	hu li ya shua hai mian bang	1
胡萝卜素	hu luo bo su	1
护脐带	hu qi dai	1
护腕	hu wan	1
护膝	hu xi	1
呼吸复苏囊	hu xi fu su nang	1
呼吸复苏囊袋	hu xi fu su nang dai	1
呼吸机	hu xi ji	1
呼吸器	hu xi qi	1
呼吸气囊	hu xi qi nang	1
呼吸通路滤器	hu xi tong lu lv qi	1
弧形重建钢板不锈钢	hu xing chong jian gang ban bu xiu gang	1
弧形重建钢板纯钛	hu xing chong jian gang ban chun tai	1
弧形重建钢板钛合金	hu xing chong jian gang ban tai he jin	1
护阴器	hu yin qi	1
护肘	hu zhou	1
化疗泵	hua liao beng	1
化学合成骨	hua xue he cheng gu	1
化学指示标签	hua xue zhi shi biao qian	1
化学指示卡	hua xue zhi shi ka	1
踝关节矫形器	huai guan jie jiao xing qi	1
踝螺钉	huai luo ding	1
环抱钢板	huan bao gang ban	1
环抱钢板记忆合金	huan bao gang ban ji yi he jin	1
环孢素浓度检测试剂	huan bao su nong du jian ce shi ji	1
幻灯机	huan deng ji	1
寰枢椎钉板系统不锈钢	huan shu zhui ding ban xi tong bu xiu gang	1
寰枢椎钉板系统纯钛	huan shu zhui ding ban xi tong chun tai	1
寰枢椎钉板系统钛合金	huan shu zhui ding ban xi tong tai he jin	1
寰枢椎固定系统	huan shu zhui gu ding xi tong	1
寰枢椎固定系统抱钩系统不锈钢	huan shu zhui gu ding xi tong bao gou xi tong bu xiu gang	1
寰枢椎固定系统抱钩系统纯钛	huan shu zhui gu ding xi tong bao gou xi tong chun tai	1
寰枢椎固定系统抱钩系统钛合金	huan shu zhui gu ding xi tong bao gou xi tong tai he jin	1
寰枢椎系统	huan shu zhui xi tong	1
环形全涂层髋关节柄	huan xing quan tu ceng kuan guan jie bing	1
环氧乙烷生物指示剂	huan yang yi wan sheng wu zhi shi ji	1
环氧乙烷消毒剂	huan yang yi wan xiao du ji	1
环氧乙烷指示条	huan yang yi wan zhi shi tiao	1
换药车	huan yao che	1
换药碗	huan yao wan	1
环状标测电极	huan zhuang biao ce dian ji	1
环状标测电极二十极	huan zhuang biao ce dian ji er shi ji	1
环状标测电极二十极可变直径	huan zhuang biao ce dian ji er shi ji ke bian zhi jing	1
环状标测电极十极	huan zhuang biao ce dian ji shi ji	1
环状标测电极十极可变直径	huan zhuang biao ce dian ji shi ji ke bian zhi jing	1
磺柳酸	huang liu suan	1
回收器	hui shou qi	1
会阴剪	hui yin jian	1
混合式外固定支架	hun he shi wai gu ding zhi jia	1
混和外固定支架	hun he wai gu ding zhi jia	1
活化凝血酶	huo hua ning xue mei	1
霍乱弧菌快速检测试纸	huo luan hu jun kuai su jian ce shi zhi	1
活头	huo tou	1
机采管路	ji cai guan lu	1
肌钙蛋白定量检测试剂	ji gai dan bai ding liang jian ce shi ji	1
肌钙蛋白肌红蛋白二联卡条	ji gai dan bai ji hong dan bai er lian ka tiao	1
肌钙蛋白肌红蛋白三联卡条	ji gai dan bai ji hong dan bai san lian ka tiao	1
肌钙蛋白检测卡条	ji gai dan bai jian ce ka tiao	1
肌酐	ji gan	1
肌酐测定试剂盒	ji gan ce ding shi ji he	1
技工打磨机	ji gong da mo ji	1
技工腊型雕刻刀	ji gong la xing diao ke dao	1
激光成像胶片	ji guang cheng xiang jiao pian	1
记号笔	ji hao bi	1
肌红蛋白定量检测试剂	ji hong dan bai ding liang jian ce shi ji	1
肌红蛋白检测卡条	ji hong dan bai jian ce ka tiao	1
肌腱套针	ji jian tao zhen	1
姬姆萨染色剂	ji mu sa ran se ji	1
肌酸激酶	ji suan ji mei	1
肌酸激酶试剂盒	ji suan ji mei shi ji he	1
肌酸激酶同工酶	ji suan ji mei tong gong mei	1
肌酸激酶同工酶试剂盒	ji suan ji mei tong gong mei shi ji he	1
计血量产妇纸	ji xue liang chan fu zhi	1
基质金属蛋白酶试剂	ji zhi jin shu dan bai mei shi ji	1
脊柱	ji zhu	1
脊柱侧弯矫形钉棒系统	ji zhu ce wan jiao xing ding bang xi tong	1
脊柱侧弯矫形钉棒系统不锈钢	ji zhu ce wan jiao xing ding bang xi tong bu xiu gang	1
脊柱侧弯矫形钉棒系统钛合金	ji zhu ce wan jiao xing ding bang xi tong tai he jin	1
脊柱侧弯矫形钉系统	ji zhu ce wan jiao xing ding xi tong	1
脊柱侧弯矫形钩棒系统	ji zhu ce wan jiao xing gou bang xi tong	1
脊柱侧弯矫形钩棒系统不锈钢	ji zhu ce wan jiao xing gou bang xi tong bu xiu gang	1
脊柱侧弯矫形钩棒系统钛合金	ji zhu ce wan jiao xing gou bang xi tong tai he jin	1
脊柱侧弯矫形钩系统	ji zhu ce wan jiao xing gou xi tong	1
脊柱固定器	ji zhu gu ding qi	1
脊柱矫正固定器	ji zhu jiao zheng gu ding qi	1
脊柱接骨板	ji zhu jie gu ban	1
脊柱内固定棒	ji zhu nei gu ding bang	1
脊柱内固定钉	ji zhu nei gu ding ding	1
脊柱配件或组件	ji zhu pei jian huo zu jian	1
脊柱前路钢板	ji zhu qian lu gang ban	1
脊柱瘫痪矫形器	ji zhu tan huan jiao xing qi	1
脊椎骨	ji zhui gu	1
脊椎骨腰椎骨	ji zhui gu yao zhui gu	1
钾测定试剂盒	jia ce ding shi ji he	1
甲醇	jia chun	1
甲肝	jia gan	1
甲肝抗	jia gan kang	1
甲基苯丙胺冰毒检测试剂	jia ji ben bing an bing du jian ce shi ji	1
加强杯	jia qiang bei	1
甲醛	jia quan	1
夹石针	jia shi zhen	1
甲胎蛋白	jia tai dan bai	1
甲胎蛋白试剂盒	jia tai dan bai shi ji he	1
甲型肝炎检测试剂盒	jia xing gan yan jian ce shi ji he	1
甲型肝炎抗体	jia xing gan yan kang ti	1
假性尿袋	jia xing niao dai	1
加压空心钉	jia ya kong xin ding	1
加压空心钉不锈钢	jia ya kong xin ding bu xiu gang	1
加压空心钉纯钛	jia ya kong xin ding chun tai	1
加压空心钉钛合金	jia ya kong xin ding tai he jin	1
加压螺钉	jia ya luo ding	1
家用手套	jia yong shou tao	1
甲状旁腺素	jia zhuang pang xian su	1
甲状腺过氧化物酶抗体	jia zhuang xian guo yang hua wu mei kang ti	1
甲状腺球蛋白	jia zhuang xian qiu dan bai	1
甲状腺球蛋白抗体	jia zhuang xian qiu dan bai kang ti	1
甲状腺素	jia zhuang xian su	1
检测卡条	jian ce ka tiao	1
检测试剂	jian ce shi ji	1
肩关节	jian guan jie	1
监护记录纸	jian hu ji lu zhi	1
间接免疫荧光法检测试剂盒	jian jie mian yi ying guang fa jian ce shi ji he	1
健康体重称	jian kang ti zhong cheng	1
肩离断假肢	jian li duan jia zhi	1
肩锁关节钢板	jian suo guan jie gang ban	1
肩锁关节钩钢板左右侧	jian suo guan jie gou gang ban zuo you ce	1
肩锁关节钩钢板左右侧不锈钢	jian suo guan jie gou gang ban zuo you ce bu xiu gang	1
肩锁关节钩钢板左右侧纯钛	jian suo guan jie gou gang ban zuo you ce chun tai	1
肩锁关节钩钢板左右侧钛合金	jian suo guan jie gou gang ban zuo you ce tai he jin	1
肩锁接骨板	jian suo jie gu ban	1
碱性磷酸酶	jian xing lin suan mei	1
碱性磷酸酶试剂盒	jian xing lin suan mei shi ji he	1
检眼镜灯泡	jian yan jing deng pao	1
肩肘膝关节架	jian zhou xi guan jie jia	1
搅拌器	jiao ban qi	1
胶布	jiao bu	1
角蛋白	jiao dan bai	1
交换导丝	jiao huan dao si	1
交联型超高分子聚乙烯衬垫	jiao lian xing chao gao fen zi ju yi xi chen dian	1
角膜剪	jiao mo jian	1
酵母菌鉴定卡	jiao mu jun jian ding ka	1
交锁型尺桡骨髓内钉	jiao suo xing chi rao gu sui nei ding	1
交锁型尺桡骨髓内钉不锈钢	jiao suo xing chi rao gu sui nei ding bu xiu gang	1
交锁型尺桡骨髓内钉纯钛	jiao suo xing chi rao gu sui nei ding chun tai	1
交锁型尺桡骨髓内钉近端锁钉	jiao suo xing chi rao gu sui nei ding jin duan suo ding	1
交锁型尺桡骨髓内钉钛合金	jiao suo xing chi rao gu sui nei ding tai he jin	1
交锁型尺桡骨髓内钉尾钉	jiao suo xing chi rao gu sui nei ding wei ding	1
交锁型尺桡骨髓内钉远端锁钉	jiao suo xing chi rao gu sui nei ding yuan duan suo ding	1
交锁型尺桡骨髓内钉主钉	jiao suo xing chi rao gu sui nei ding zhu ding	1
交锁型肱骨髓内钉	jiao suo xing gong gu sui nei ding	1
交锁型肱骨髓内钉不锈钢	jiao suo xing gong gu sui nei ding bu xiu gang	1
交锁型肱骨髓内钉纯钛	jiao suo xing gong gu sui nei ding chun tai	1
交锁型肱骨髓内钉近端锁钉	jiao suo xing gong gu sui nei ding jin duan suo ding	1
交锁型肱骨髓内钉钛合金	jiao suo xing gong gu sui nei ding tai he jin	1
交锁型肱骨髓内钉尾钉	jiao suo xing gong gu sui nei ding wei ding	1
交锁型肱骨髓内钉远端锁钉	jiao suo xing gong gu sui nei ding yuan duan suo ding	1
交锁型肱骨髓内钉主钉	jiao suo xing gong gu sui nei ding zhu ding	1
交锁型股骨重建钉	jiao suo xing gu gu chong jian ding	1
交锁型股骨重建钉不锈钢	jiao suo xing gu gu chong jian ding bu xiu gang	1
交锁型股骨重建钉纯钛	jiao suo xing gu gu chong jian ding chun tai	1
交锁型股骨重建钉近端锁钉	jiao suo xing gu gu chong jian ding jin duan suo ding	1
交锁型股骨重建钉钛合金	jiao suo xing gu gu chong jian ding tai he jin	1
交锁型股骨重建钉尾钉	jiao suo xing gu gu chong jian ding wei ding	1
交锁型股骨重建钉远端锁钉	jiao suo xing gu gu chong jian ding yuan duan suo ding	1
交锁型股骨重建钉主钉	jiao suo xing gu gu chong jian ding zhu ding	1
交锁型股骨近端重建钉不锈钢	jiao suo xing gu gu jin duan chong jian ding bu xiu gang	1
交锁型股骨近端重建钉纯钛	jiao suo xing gu gu jin duan chong jian ding chun tai	1
交锁型股骨近端重建钉近端锁钉	jiao suo xing gu gu jin duan chong jian ding jin duan suo ding	1
交锁型股骨近端重建钉钛合金	jiao suo xing gu gu jin duan chong jian ding tai he jin	1
交锁型股骨近端重建钉尾钉	jiao suo xing gu gu jin duan chong jian ding wei ding	1
交锁型股骨近端重建钉远端锁钉	jiao suo xing gu gu jin duan chong jian ding yuan duan suo ding	1
交锁型股骨近端重建钉主钉	jiao suo xing gu gu jin duan chong jian ding zhu ding	1
交锁型股骨髁上钉	jiao suo xing gu gu ke shang ding	1
交锁型股骨髁上钉不锈钢	jiao suo xing gu gu ke shang ding bu xiu gang	1
交锁型股骨髁上钉纯钛	jiao suo xing gu gu ke shang ding chun tai	1
交锁型股骨髁上钉近端锁钉	jiao suo xing gu gu ke shang ding jin duan suo ding	1
交锁型股骨髁上钉钛合金	jiao suo xing gu gu ke shang ding tai he jin	1
交锁型股骨髁上钉尾钉	jiao suo xing gu gu ke shang ding wei ding	1
交锁型股骨髁上钉远端锁钉	jiao suo xing gu gu ke shang ding yuan duan suo ding	1
交锁型股骨髁上钉主钉	jiao suo xing gu gu ke shang ding zhu ding	1
交锁型股骨髓内钉	jiao suo xing gu gu sui nei ding	1
交锁型股骨髓内钉不锈钢	jiao suo xing gu gu sui nei ding bu xiu gang	1
交锁型股骨髓内钉纯钛	jiao suo xing gu gu sui nei ding chun tai	1
交锁型股骨髓内钉锁钉	jiao suo xing gu gu sui nei ding suo ding	1
交锁型股骨髓内钉钛合金	jiao suo xing gu gu sui nei ding tai he jin	1
交锁型股骨髓内钉尾钉	jiao suo xing gu gu sui nei ding wei ding	1
交锁型股骨髓内钉主钉	jiao suo xing gu gu sui nei ding zhu ding	1
交锁型胫骨髓内钉	jiao suo xing jing gu sui nei ding	1
交锁型胫骨髓内钉不锈钢	jiao suo xing jing gu sui nei ding bu xiu gang	1
交锁型胫骨髓内钉纯钛	jiao suo xing jing gu sui nei ding chun tai	1
交锁型胫骨髓内钉钛合金	jiao suo xing jing gu sui nei ding tai he jin	1
交锁型胫骨髓内钉尾钉	jiao suo xing jing gu sui nei ding wei ding	1
交锁型胫骨髓内钉主钉	jiao suo xing jing gu sui nei ding zhu ding	1
交锁型胫骨髓内锁钉	jiao suo xing jing gu sui nei suo ding	1
脚套	jiao tao	1
胶托排牙	jiao tuo pai ya	1
胶原	jiao yuan	1
胶原蛋白海绵	jiao yuan dan bai hai mian	1
胶原海绵	jiao yuan hai mian	1
揭盖颊面管	jie gai jia mian guan	1
接骨钢板	jie gu gang ban	1
接骨螺钉	jie gu luo ding	1
接骨螺钉金属	jie gu luo ding jin shu	1
接骨皮质螺钉	jie gu pi zhi luo ding	1
接骨全齿螺钉	jie gu quan chi luo ding	1
结核杆菌	jie he gan jun	1
结核杆菌抗体测定试剂	jie he gan jun kang ti ce ding shi ji	1
结核杆菌特异性抗体	jie he gan jun te yi xing kang ti	1
结核抗体	jie he kang ti	1
节能电阻炉	jie neng dian zu lu	1
解脲脲原体检测试剂	jie niao niao yuan ti jian ce shi ji	1
解脲支原体	jie niao zhi yuan ti	1
解剖型钢板	jie pou xing gang ban	1
解剖型股骨柄	jie pou xing gu gu bing	1
接受腔辅助拉带	jie shou qiang fu zhu la dai	1
洁牙机	jie ya ji	1
洁牙抛光膏	jie ya pao guang gao	1
洁牙喷砂粉	jie ya pen sha fen	1
结扎钉夹	jie za ding jia	1
结扎镊	jie za nie	1
洁治器	jie zhi qi	1
金刚磨面股骨柄	jin gang mo mian gu gu bing	1
金刚砂车针	jin gang sha che zhen	1
金钢砂磨头	jin gang sha mo tou	1
金刚石磨面金属杯	jin gang shi mo mian jin shu bei	1
金冠剪	jin guan jian	1
进口灯炮	jin kou deng pao	1
进口骨水泥	jin kou gu shui ni	1
进口骨水泥特殊型号	jin kou gu shui ni te shu xing hao	1
进口骨水泥特殊型号克	jin kou gu shui ni te shu xing hao ke	1
进口普通骨水泥	jin kou pu tong gu shui ni	1
进口树脂	jin kou shu zhi	1
金属肠道支架	jin shu chang dao zhi jia	1
金属衬	jin shu chen	1
金属胆道支架	jin shu dan dao zhi jia	1
金属对金属防脱位臼衬	jin shu dui jin shu fang tuo wei jiu chen	1
金属股骨头	jin shu gu gu tou	1
金属接骨板加压钢板	jin shu jie gu ban jia ya gang ban	1
金属接骨钢板	jin shu jie gu gang ban	1
金属捆绑支架	jin shu kun bang zhi jia	1
金属内衬	jin shu nei chen	1
金属内衬骨水泥型	jin shu nei chen gu shui ni xing	1
金属球头	jin shu qiu tou	1
金属食道支架	jin shu shi dao zhi jia	1
金属丝锥形髋关节柄	jin shu si zhui xing kuan guan jie bing	1
金属异形接骨钢板	jin shu yi xing jie gu gang ban	1
颈带	jing dai	1
颈动脉支架	jing dong mai zhi jia	1
颈动脉支架保护伞	jing dong mai zhi jia bao hu san	1
颈动脉支架单轨型	jing dong mai zhi jia dan gui xing	1
颈动脉支架镍钛合金支架	jing dong mai zhi jia nie tai he jin zhi jia	1
颈动脉转流管	jing dong mai zhuan liu guan	1
胫腓骨夹板	jing fei gu jia ban	1
胫骨加强型	jing gu jia qiang xing	1
胫骨交锁钉	jing gu jiao suo ding	1
胫骨解剖型人工膝关节	jing gu jie pou xing ren gong xi guan jie	1
胫骨近端锁定异型解剖钢板纯钛	jing gu jin duan suo ding yi xing jie pou gang ban chun tai	1
胫骨近端微创钢板	jing gu jin duan wei chuang gang ban	1
胫骨近端微创钢板不锈钢	jing gu jin duan wei chuang gang ban bu xiu gang	1
胫骨近端微创钢板纯钛	jing gu jin duan wei chuang gang ban chun tai	1
胫骨近端微创钢板钛合金	jing gu jin duan wei chuang gang ban tai he jin	1
胫骨近端异型解剖钢板	jing gu jin duan yi xing jie pou gang ban	1
胫骨近端异型解剖钢板不锈钢	jing gu jin duan yi xing jie pou gang ban bu xiu gang	1
胫骨近端异型解剖钢板纯钛	jing gu jin duan yi xing jie pou gang ban chun tai	1
胫骨近端异型解剖钢板钛合金	jing gu jin duan yi xing jie pou gang ban tai he jin	1
胫骨近端异型解剖锁定钢板	jing gu jin duan yi xing jie pou suo ding gang ban	1
胫骨远端锁定异型解剖钢板纯钛	jing gu yuan duan suo ding yi xing jie pou gang ban chun tai	1
胫骨远端异型解剖钢板	jing gu yuan duan yi xing jie pou gang ban	1
胫骨远端异型解剖钢板不锈钢	jing gu yuan duan yi xing jie pou gang ban bu xiu gang	1
胫骨远端异型解剖钢板纯钛	jing gu yuan duan yi xing jie pou gang ban chun tai	1
胫骨远端异型解剖钢板钛合金	jing gu yuan duan yi xing jie pou gang ban tai he jin	1
胫骨远端异型解剖锁定钢板	jing gu yuan duan yi xing jie pou suo ding gang ban	1
精浆顶体酶检测试剂	jing jiang ding ti mei jian ce shi ji	1
精浆果糖测定	jing jiang guo tang ce ding	1
精浆酸性磷酸酶试剂	jing jiang suan xing lin suan mei shi ji	1
精浆锌检测试剂	jing jiang xin jian ce shi ji	1
颈静脉用中心静脉导管	jing jing mai yong zhong xin jing mai dao guan	1
静脉插管	jing mai cha guan	1
静脉留置针	jing mai liu zhi zhen	1
静脉三通	jing mai san tong	1
静脉压测定管	jing mai ya ce ding guan	1
静脉营养袋	jing mai ying yang dai	1
精密过滤器	jing mi guo lv qi	1
经皮气切插管	jing pi qi qie cha guan	1
经皮鞘穿刺组钢丝加强鞘	jing pi qiao chuan ci zu gang si jia qiang qiao	1
经皮下电极传送鞘管系统	jing pi xia dian ji chuan song qiao guan xi tong	1
经皮椎体成形器全套	jing pi zhui ti cheng xing qi quan tao	1
晶碳烤瓷冠脉支架系统药物洗脱	jing tan kao ci guan mai zhi jia xi tong yao wu xi tuo	1
晶体植入镊	jing ti zhi ru nie	1
颈托	jing tuo	1
经外周静脉用中心静脉导管	jing wai zhou jing mai yong zhong xin jing mai dao guan	1
颈围	jing wei	1
精液白细胞过氧化物酶试剂盒	jing ye bai xi bao guo yang hua wu mei shi ji he	1
精液冷冻液	jing ye leng dong ye	1
颈椎后路板	jing zhui hou lu ban	1
颈椎后路棒	jing zhui hou lu bang	1
颈椎后路侧块螺钉	jing zhui hou lu ce kuai luo ding	1
颈椎后路侧块自攻螺钉	jing zhui hou lu ce kuai zi gong luo ding	1
颈椎后路钉板系统	jing zhui hou lu ding ban xi tong	1
颈椎后路钉板系统不锈钢	jing zhui hou lu ding ban xi tong bu xiu gang	1
颈椎后路钉板系统纯钛	jing zhui hou lu ding ban xi tong chun tai	1
颈椎后路钉板系统钛合金	jing zhui hou lu ding ban xi tong tai he jin	1
颈椎后路钉棒系统	jing zhui hou lu ding bang xi tong	1
颈椎后路钉棒系统不锈钢	jing zhui hou lu ding bang xi tong bu xiu gang	1
颈椎后路钉棒系统纯钛	jing zhui hou lu ding bang xi tong chun tai	1
颈椎后路钉棒系统钛合金	jing zhui hou lu ding bang xi tong tai he jin	1
颈椎后路上椎板钩含附件	jing zhui hou lu shang zhui ban gou han fu jian	1
颈椎后路下椎板钩含附件	jing zhui hou lu xia zhui ban gou han fu jian	1
颈椎后路线缆系统	jing zhui hou lu xian lan xi tong	1
颈椎后路椎板夹	jing zhui hou lu zhui ban jia	1
颈椎后路椎弓根钉含附件	jing zhui hou lu zhui gong gen ding han fu jian	1
颈椎后路椎弓根自攻钉含附件	jing zhui hou lu zhui gong gen zi gong ding han fu jian	1
颈椎前路薄型板厚度小于	jing zhui qian lu bao xing ban hou du xiao yu	1
颈椎前路纯钛板	jing zhui qian lu chun tai ban	1
颈椎前路钉板系统	jing zhui qian lu ding ban xi tong	1
颈椎前路钉板系统不锈钢	jing zhui qian lu ding ban xi tong bu xiu gang	1
颈椎前路钉板系统纯钛	jing zhui qian lu ding ban xi tong chun tai	1
颈椎前路钉板系统钛合金	jing zhui qian lu ding ban xi tong tai he jin	1
颈椎前路动态加压板	jing zhui qian lu dong tai jia ya ban	1
颈椎前路辅助锁定板	jing zhui qian lu fu zhu suo ding ban	1
颈椎前路金属旋入式融合器	jing zhui qian lu jin shu xuan ru shi rong he qi	1
颈椎前路金属置入式融合器	jing zhui qian lu jin shu zhi ru shi rong he qi	1
颈椎前路普通板	jing zhui qian lu pu tong ban	1
颈椎前路人工骨旋入式融合器	jing zhui qian lu ren gong gu xuan ru shi rong he qi	1
颈椎前路人工骨置入式融合器	jing zhui qian lu ren gong gu zhi ru shi rong he qi	1
颈椎前路碳纤维旋入式融合器	jing zhui qian lu tan xian wei xuan ru shi rong he qi	1
颈椎前路碳纤维置入式融合器	jing zhui qian lu tan xian wei zhi ru shi rong he qi	1
颈椎前路旋入式融合器	jing zhui qian lu xuan ru shi rong he qi	1
颈椎前路置入式融合器	jing zhui qian lu zhi ru shi rong he qi	1
颈椎前路椎间融合器	jing zhui qian lu zhui jian rong he qi	1
颈椎前路自动锁定板	jing zhui qian lu zi dong suo ding ban	1
颈椎椎间融合器	jing zhui zhui jian rong he qi	1
颈椎椎体锁定螺钉含附件	jing zhui zhui ti suo ding luo ding han fu jian	1
颈椎椎体自攻螺钉含附件	jing zhui zhui ti zi gong luo ding han fu jian	1
颈椎椎体自攻锁定螺钉含附件	jing zhui zhui ti zi gong suo ding luo ding han fu jian	1
颈椎自攻植骨螺钉含附件	jing zhui zi gong zhi gu luo ding han fu jian	1
精子分离液	jing zi fen li ye	1
精子形态学快速染色试剂	jing zi xing tai xue kuai su ran se shi ji	1
精子制动液	jing zi zhi dong ye	1
臼杯	jiu bei	1
酒精	jiu jing	1
酒精灯	jiu jing deng	1
九岁恒牙交替解剖模型	jiu sui heng ya jiao ti jie pou mo xing	1
聚砜膜透析器	ju feng mo tou xi qi	1
举宫器	ju gong qi	1
聚凝胺试剂	ju ning an shi ji	1
聚羧酸粘合剂水门汀	ju suo suan nian he ji shui men ting	1
聚羧酸锌	ju suo suan xin	1
巨细胞病毒	ju xi bao bing du	1
巨细胞病毒抗体	ju xi bao bing du kang ti	1
聚酰氨膜透析器	ju xian an mo tou xi qi	1
聚血器	ju xue qi	1
聚乙烯臼	ju yi xi jiu	1
聚乙烯髋关节臼	ju yi xi kuan guan jie jiu	1
聚乙烯髋臼	ju yi xi kuan jiu	1
聚乙烯髋臼杯	ju yi xi kuan jiu bei	1
聚乙烯内衬	ju yi xi nei chen	1
聚乙烯人工双动头	ju yi xi ren gong shuang dong tou	1
枸橼酸钠抗凝剂	ju yuan suan na kang ning ji	1
枸橼酸盐琼脂干粉	ju yuan suan yan qiong zhi gan fen	1
菌种保存管	jun zhong bao cun guan	1
菌状导尿管	jun zhuang dao niao guan	1
卡马西平检测试剂	ka ma xi ping jian ce shi ji	1
卡式双动头	ka shi shuang dong tou	1
卡式双动外杯	ka shi shuang dong wai bei	1
开睑器	kai jian qi	1
开口器	kai kou qi	1
开水瓶推车	kai shui ping tui che	1
看片灯	kan pian deng	1
看片机	kan pian ji	1
抗单纯庖疹病毒	kang dan chun pao zhen bing du	1
抗风疹病毒	kang feng zhen bing du	1
抗感腔	kang gan qiang	1
抗弓形虫	kang gong xing chong	1
抗核周因子抗体	kang he zhou yin zi kang ti	1
抗环瓜氨酸肽抗体	kang huan gua an suan tai kang ti	1
抗角蛋白抗体	kang jiao dan bai kang ti	1
抗精子抗体	kang jing zi kang ti	1
抗精子抗体测定试剂	kang jing zi kang ti ce ding shi ji	1
抗抗血型定型试剂	kang kang xue xing ding xing shi ji	1
抗抗血型定型试剂血站用	kang kang xue xing ding xing shi ji xue zhan yong	1
抗链球菌	kang lian qiu jun	1
抗链球菌溶血	kang lian qiu jun rong xue	1
抗链球菌溶血素	kang lian qiu jun rong xue su	1
抗人球蛋白试剂	kang ren qiu dan bai shi ji	1
抗生素低粘度骨水泥	kang sheng su di nian du gu shui ni	1
抗生素骨水泥	kang sheng su gu shui ni	1
抗体检测试剂盒	kang ti jian ce shi ji he	1
抗体试剂盒	kang ti shi ji he	1
抗心磷脂抗体定量试剂	kang xin lin zhi kang ti ding liang shi ji	1
抗心磷脂抗体试剂	kang xin lin zhi kang ti shi ji	1
抗血型定型试剂	kang xue xing ding xing shi ji	1
抗胰岛谷氨脱羧酶抗体试剂	kang yi dao gu an tuo suo mei kang ti shi ji	1
抗子宫内膜抗体试剂	kang zi gong nei mo kang ti shi ji	1
烤瓷修补材料套装	kao ci xiu bu cai liao tao zhuang	1
可操纵导引钢丝	ke cao zong dao yin gang si	1
刻度吸管	ke du xi guan	1
髁骨钢板	ke gu gang ban	1
可换小球头	ke huan xiao qiu tou	1
可卡因检测试剂	ke ka yin jian ce shi ji	1
可乐丽菲粘结剂	ke le li fei nian jie ji	1
可乐丽树脂	ke le li shu zhi	1
可溶性转铁蛋白受体检测试剂	ke rong xing zhuan tie dan bai shou ti jian ce shi ji	1
克氏针	ke shi zhen	1
可撕开鞘组	ke si kai qiao zu	1
可调负压吸痰管	ke tiao fu ya xi tan guan	1
可调颈生物型柄	ke tiao jing sheng wu xing bing	1
可调控型传送导管系统	ke tiao kong xing chuan song dao guan xi tong	1
可调整式翻修柄	ke tiao zheng shi fan xiu bing	1
可脱金球囊	ke tuo jin qiu nang	1
可吸收棒	ke xi shou bang	1
可吸收钉	ke xi shou ding	1
可吸收缝合线	ke xi shou feng he xian	1
可吸收夹	ke xi shou jia	1
可吸收接骨板	ke xi shou jie gu ban	1
可吸收肋骨钉	ke xi shou lei gu ding	1
可吸收螺钉	ke xi shou luo ding	1
可吸收内固定螺钉	ke xi shou nei gu ding luo ding	1
可吸收线	ke xi shou xian	1
可吸收硬脑膜补片	ke xi shou ying nao mo bu pian	1
可吸收远端塞	ke xi shou yuan duan sai	1
可吸收止血纱布	ke xi shou zhi xue sha bu	1
空肠造瘘管	kong chang zao lou guan	1
空心螺钉	kong xin luo ding	1
空心螺钉垫片	kong xin luo ding dian pian	1
空心钛钉	kong xin tai ding	1
空心弹力线	kong xin tan li xian	1
空压机	kong ya ji	1
孔医用胶带	kong yi yong jiao dai	1
孔粘贴伤口敷料	kong zhan tie shang kou fu liao	1
口表	kou biao	1
口垫	kou dian	1
口镜柄及镜头	kou jing bing ji jing tou	1
口腔联体牙科治疗机	kou qiang lian ti ya ke zhi liao ji	1
口腔连体牙科治疗机	kou qiang lian ti ya ke zhi liao ji	1
口腔麻醉注射器	kou qiang ma zui zhu she qi	1
口外弓	kou wai gong	1
口咽通气道	kou yan tong qi dao	1
口咽通气管	kou yan tong qi guan	1
口罩	kou zhao	1
快放钳	kuai fang qian	1
快速多酶清洗液	kuai su duo mei qing xi ye	1
快速交换球囊	kuai su jiao huan qiu nang	1
快速交换球囊导管	kuai su jiao huan qiu nang dao guan	1
快速交换球囊扩张导管	kuai su jiao huan qiu nang kuo zhang dao guan	1
快速交换支架传输系统	kuai su jiao huan zhi jia chuan shu xi tong	1
快速交换支架系统	kuai su jiao huan zhi jia xi tong	1
快速血浆反应素试验	kuai su xue jiang fan ying su shi yan	1
髋骨重建钉	kuan gu chong jian ding	1
髋关节表面置换股骨部件	kuan guan jie biao mian zhi huan gu gu bu jian	1
髋关节表面置换髋臼部件	kuan guan jie biao mian zhi huan kuan jiu bu jian	1
髋关节假体	kuan guan jie jia ti	1
髋关节假体柄	kuan guan jie jia ti bing	1
髋关节假体股骨柄	kuan guan jie jia ti gu gu bing	1
髋关节假体股骨头	kuan guan jie jia ti gu gu tou	1
髋关节假体喷涂髋臼内衬	kuan guan jie jia ti pen tu kuan jiu nei chen	1
髋关节假体喷涂髋臼外杯	kuan guan jie jia ti pen tu kuan jiu wai bei	1
髋关节矫形器	kuan guan jie jiao xing qi	1
髋关节抛光假体长柄	kuan guan jie pao guang jia ti chang bing	1
髋臼	kuan jiu	1
髋臼杯	kuan jiu bei	1
髋臼杯粗糙面	kuan jiu bei cu cao mian	1
髋臼重建杯	kuan jiu chong jian bei	1
髋臼重建系统	kuan jiu chong jian xi tong	1
髋臼顶部重建环	kuan jiu ding bu chong jian huan	1
髋臼顶部重建笼架	kuan jiu ding bu chong jian long jia	1
髋臼加强环	kuan jiu jia qiang huan	1
髋臼加强支架	kuan jiu jia qiang zhi jia	1
髋臼拉钩	kuan jiu la gou	1
髋臼螺钉	kuan jiu luo ding	1
髋臼内衬	kuan jiu nei chen	1
髋臼系统	kuan jiu xi tong	1
髋臼系统臼杯	kuan jiu xi tong jiu bei	1
髋离断假肢成人型	kuan li duan jia zhi cheng ren xing	1
髋离断假肢儿童型	kuan li duan jia zhi er tong xing	1
捆绑带钛合金	kun bang dai tai he jin	1
扩阴道镜	kuo yin dao jing	1
扩阴器	kuo yin qi	1
扩张球囊	kuo zhang qiu nang	1
扩张球囊导管	kuo zhang qiu nang dao guan	1
拉力螺钉含附件	la li luo ding han fu jian	1
拉链式无针缝合器	la lian shi wu zhen feng he qi	1
狼疮抗凝因子测定试剂	lang chuang kang ning yin zi ce ding shi ji	1
泪道冲洗针	lei dao chong xi zhen	1
泪道栓子	lei dao shuan zi	1
泪道引流管	lei dao yin liu guan	1
类风湿因子	lei feng shi yin zi	1
类固醇洗脱	lei gu chun xi tuo	1
类兔补体	lei tu bu ti	1
冷冻管	leng dong guan	1
冷冻灭菌麦管	leng dong mie jun mai guan	1
冷冻塑料管	leng dong su liao guan	1
冷冻铁架	leng dong tie jia	1
冷冻组织包埋剂	leng dong zu zhi bao mai ji	1
冷反射卤钨灯	leng fan she lu wu deng	1
冷干机	leng gan ji	1
冷光源	leng guang yuan	1
冷凝阀	leng ning fa	1
冷凝泄水器	leng ning xie shui qi	1
冷盐水灌注消融导管	leng yan shui guan zhu xiao rong dao guan	1
利尿钠肽	li niao na tai	1
立式血压计	li shi xue ya ji	1
立式紫外线灯	li shi zi wai xian deng	1
李斯特氏菌属鉴定试条	li si te shi jun shu jian ding shi tiao	1
粒细胞马赛克间免荧光试剂盒	li xi bao ma sai ke jian mian ying guang shi ji he	1
离心管	li xin guan	1
离心机	li xin ji	1
离子选择电极分析仪试剂及洗液	li zi xuan ze dian ji fen xi yi shi ji ji xi ye	1
连发施夹器钛夹	lian fa shi jia qi tai jia	1
连发钛夹	lian fa tai jia	1
连续性肾脏替代治疗滤过器	lian xu xing shen zang ti dai zhi liao lv guo qi	1
裂隙灯	lie xi deng	1
裂隙灯泡	lie xi deng pao	1
裂钻	lie zuan	1
鳞癌相关抗原肿瘤试剂	lin ai xiang guan kang yuan zhong liu shi ji	1
淋巴细胞分离液	lin ba xi bao fen li ye	1
磷测定试剂盒	lin ce ding shi ji he	1
淋球菌	lin qiu jun	1
淋球菌检测试剂	lin qiu jun jian ce shi ji	1
淋球菌培养皿	lin qiu jun pei yang min	1
临时冠桥树脂	lin shi guan qiao shu zhi	1
临时起搏器及电极	lin shi qi bo qi ji dian ji	1
临时牙粘结材料	lin shi ya nian jie cai liao	1
磷酸锌	lin suan xin	1
流感病毒抗原	liu gan bing du kang yuan	1
六检验试剂类	liu jian yan shi ji lei	1
流式细胞检测试剂	liu shi xi bao jian ce shi ji	1
硫酸脱氢表雄酮	liu suan tuo qing biao xiong tong	1
颅骨定制体	lu gu ding zhi ti	1
颅骨固定材料	lu gu gu ding cai liao	1
颅骨牵引器	lu gu qian yin qi	1
颅骨锁	lu gu suo	1
颅骨修补材料	lu gu xiu bu cai liao	1
颅骨修复用钛网板及配套螺钉	lu gu xiu fu yong tai wang ban ji pei tao luo ding	1
颅内血肿粉碎穿刺针	lu nei xue zhong fen sui chuan ci zhen	1
颅内支架系统	lu nei zhi jia xi tong	1
录象一体机	lu xiang yi ti ji	1
录像一体机	lu xiang yi ti ji	1
卵泡冲洗液	luan pao chong xi ye	1
卵圆钳不锈钢	luan yuan qian bu xiu gang	1
卵子体外成熟液	luan zi ti wai cheng shu ye	1
轮腺病毒检测试纸	lun xian bing du jian ce shi zhi	1
轮椅	lun yi	1
轮状病毒抗原	lun zhuang bing du kang yuan	1
裸胆道支架含输送器	luo dan dao zhi jia han shu song qi	1
螺钉	luo ding	1
锣钉	luo ding	1
螺钉垫片	luo ding dian pian	1
螺钉翻修螺钉	luo ding fan xiu luo ding	1
螺钉螺帽	luo ding luo mao	1
裸食道支架含输送器	luo shi dao zhi jia han shu song qi	1
螺旋导线	luo xuan dao xian	1
螺旋止水夹	luo xuan zhi shui jia	1
氯测定试剂盒	lv ce ding shi ji he	1
铝合金拐杖	lv he jin guai zhang	1
氯化钙	lv hua gai	1
氯化钙试剂	lv hua gai shi ji	1
氯化树脂	lv hua shu zhi	1
绿蝇短膜虫	lv ying duan mo chong	1
铝针盒	lv zhen he	1
吗啡检测试剂	ma fei jian ce shi ji	1
麻黄检测试剂	ma huang jian ce shi ji	1
马尼车针	ma ni che zhen	1
麻醉包	ma zui bao	1
麻醉柜	ma zui gui	1
麻醉机缧纹管	ma zui ji lei wen guan	1
麻醉机气囊	ma zui ji qi nang	1
麻醉螺纹管	ma zui luo wen guan	1
麻醉咽喉镜	ma zui yan hou jing	1
麻醉咽喉镜灯泡	ma zui yan hou jing deng pao	1
麻醉仪器车	ma zui yi qi che	1
脉冲冲洗泵及附件	mai chong chong xi beng ji fu jian	1
脉冲冲洗泵及其附件	mai chong chong xi beng ji qi fu jian	1
脉冲冲洗器	mai chong chong xi qi	1
麦康凯平板	mai kang kai ping ban	1
麦康凯琼脂干粉	mai kang kai qiong zhi gan fen	1
帽子	mao zi	1
镁测定试剂盒	mei ce ding shi ji he	1
梅毒	mei du	1
梅毒非特异性类脂质抗原试验	mei du fei te yi xing lei zhi zhi kang yuan shi yan	1
梅毒抗体测定	mei du kang ti ce ding	1
梅毒抗体测定试剂	mei du kang ti ce ding shi ji	1
梅毒抗体测定试剂盒血站用	mei du kang ti ce ding shi ji he xue zhan yong	1
梅毒抗体乳胶试剂	mei du kang ti ru jiao shi ji	1
梅毒螺旋体	mei du luo xuan ti	1
梅毒螺旋体抗体检测试纸条	mei du luo xuan ti kang ti jian ce shi zhi tiao	1
梅毒试剂盒	mei du shi ji he	1
梅花针	mei hua zhen	1
梅里埃药敏鉴定试剂	mei li ai yao min jian ding shi ji	1
美容车	mei rong che	1
美容床	mei rong chuang	1
美容化妆台	mei rong hua zhuang tai	1
门冬氨酸氨基转移酶	men dong an suan an ji zhuan yi mei	1
门冬酰胺酶	men dong xian an mei	1
密封帽	mi feng mao	1
面部假体唇部	mian bu jia ti chun bu	1
面部假体耳部	mian bu jia ti er bu	1
面部假体面部	mian bu jia ti mian bu	1
面部假体前额	mian bu jia ti qian e	1
面部假体太阳穴	mian bu jia ti tai yang xue	1
面部假体下额	mian bu jia ti xia e	1
面部假体眼部	mian bu jia ti yan bu	1
棉垫	mian dian	1
棉花	mian hua	1
棉签	mian qian	1
棉球	mian qiu	1
免酸蚀粘接系统	mian suan shi zhan jie xi tong	1
免疫固定蛋白电泳检验试剂	mian yi gu ding dan bai dian yong jian yan shi ji	1
免疫球蛋白	mian yi qiu dan bai	1
免疫吸附柱	mian yi xi fu zhu	1
灭菌碘仿纱布叠片	mie jun dian fang sha bu die pian	1
灭菌凡士林纱布	mie jun fan shi lin sha bu	1
灭菌普通棉签	mie jun pu tong mian qian	1
灭菌乳胶检查手套	mie jun ru jiao jian cha shou tao	1
灭菌乳胶手套	mie jun ru jiao shou tao	1
灭菌纱布块	mie jun sha bu kuai	1
灭菌丝线	mie jun si xian	1
灭菌线困	mie jun xian kun	1
灭菌羊肠线	mie jun yang chang xian	1
灭菌医用脱脂棉花	mie jun yi yong tuo zhi mian hua	1
灭菌医用脱脂棉球	mie jun yi yong tuo zhi mian qiu	1
灭菌医用橡胶手套	mie jun yi yong xiang jiao shou tao	1
灭菌真丝编织黑线团	mie jun zhen si bian zhi hei xian tuan	1
灭菌真丝编织线束	mie jun zhen si bian zhi xian shu	1
膜肺	mo fei	1
膜基材透气胶带	mo ji cai tou qi jiao dai	1
膜胶带	mo jiao dai	1
磨口瓶	mo kou ping	1
磨砂	mo sha	1
末梢血采血针	mo shao xue cai xue zhen	1
末梢血抗凝管	mo shao xue kang ning guan	1
磨头	mo tou	1
磨牙推	mo ya tui	1
模压型直柄	mo ya xing zhi bing	1
慕丝线	mu si xian	1
母婴识别带病人识别带	mu ying shi bie dai bing ren shi bie dai	1
钠测定试剂盒	na ce ding shi ji he	1
钠石灰	na shi hui	1
耐高压球囊	nai gao ya qiu nang	1
耐高压球囊扩张导管	nai gao ya qiu nang kuo zhang dao guan	1
耐高压乳突球囊扩张导管	nai gao ya ru tu qiu nang kuo zhang dao guan	1
奈瑟菌嗜血杆菌鉴定卡	nai se jun shi xue gan jun jian ding ka	1
耐酸染色液	nai suan ran se ye	1
男性尿液贮存	nan xing niao ye zhu cun	1
男性拭子	nan xing shi zi	1
囊虫抗体	nang chong kang ti	1
囊袋支持环	nang dai zhi chi huan	1
脑部手术敷料包	nao bu shou shu fu liao bao	1
脑电波记录纸	nao dian bo ji lu zhi	1
脑电图记录纸	nao dian tu ji lu zhi	1
脑脊液体外引流管	nao ji ye ti wai yin liu guan	1
脑科手术巾	nao ke shou shu jin	1
脑棉片	nao mian pian	1
脑室穿刺脑脊液外引流装置	nao shi chuan ci nao ji ye wai yin liu zhuang zhi	1
脑室分流泵	nao shi fen liu beng	1
脑室腹腔分流管	nao shi fu qiang fen liu guan	1
脑室腹腔分流管神经外科	nao shi fu qiang fen liu guan shen jing wai ke	1
脑室外引流管	nao shi wai yin liu guan	1
脑室引流阀	nao shi yin liu fa	1
脑室引流管	nao shi yin liu guan	1
脑外科袋式手术粘贴薄膜	nao wai ke dai shi shou shu zhan tie bo mo	1
脑心浸液琼脂干粉	nao xin jin ye qiong zhi gan fen	1
内衬	nei chen	1
内衬套及锁具	nei chen tao ji suo ju	1
内窥镜活检钳	nei kui jing huo jian qian	1
内窥镜摄像头缆线隔巾	nei kui jing she xiang tou lan xian ge jin	1
内六角螺丝刀	nei liu jiao luo si dao	1
内瘘穿刺针	nei lou chuan ci zhen	1
内球头	nei qiu tou	1
内引流胆道引流管	nei yin liu dan dao yin liu guan	1
内源性凝血因子	nei yuan xing ning xue yin zi	1
粘膜注射针	nian mo zhu she zhen	1
念珠菌显色培养基	nian zhu jun xian se pei yang ji	1
尿沉渣专用试剂包	niao chen zha zhuan yong shi ji bao	1
尿蛋白电泳检验试剂	niao dan bai dian yong jian yan shi ji	1
尿壶	niao hu	1
尿试板	niao shi ban	1
尿试带	niao shi dai	1
尿试纸	niao shi zhi	1
尿素	niao su	1
尿素氮	niao su dan	1
尿素氮测定试剂盒	niao su dan ce ding shi ji he	1
尿素氮试剂盒	niao su dan shi ji he	1
尿素琼脂干粉	niao su qiong zhi gan fen	1
尿酸	niao suan	1
尿酸试剂盒	niao suan shi ji he	1
尿糖试纸	niao tang shi zhi	1
尿糖试纸条	niao tang shi zhi tiao	1
尿微量白蛋白试剂	niao wei liang bai dan bai shi ji	1
尿液及脑脊液蛋白检测试剂	niao ye ji nao ji ye dan bai jian ce shi ji	1
尿液通用质控液	niao ye tong yong zhi kong ye	1
尿液引流袋	niao ye yin liu dai	1
尿游离脱氧嘧啶	niao you li tuo yang mi ding	1
镍钛方丝	nie tai fang si	1
镍钛合金血管内支架系统	nie tai he jin xue guan nei zhi jia xi tong	1
镍钛拉簧	nie tai la huang	1
镍钛推簧	nie tai tui huang	1
镍钛微导丝	nie tai wei dao si	1
镍钛圆丝	nie tai yuan si	1
镍钛支架系统	nie tai zhi jia xi tong	1
镊子	nie zi	1
凝聚胺配血试剂	ning ju an pei xue shi ji	1
凝血定标血浆正常	ning xue ding biao xue jiang zheng chang	1
凝血酶时间	ning xue mei shi jian	1
凝血酶原	ning xue mei yuan	1
凝血酶原时间	ning xue mei yuan shi jian	1
牛心包补片	niu xin bao bu pian	1
牛心包补片心脏外科	niu xin bao bu pian xin zang wai ke	1
牛血清	niu xue qing	1
女性拭子	nv xing shi zi	1
排卵试纸	pai luan shi zhi	1
排牙	pai ya	1
排龈线排龈膏	pai yin xian pai yin gao	1
膀胱穿刺针灭菌	pang guang chuan ci zhen mie jun	1
抛光杯	pao guang bei	1
抛光机	pao guang ji	1
抛光刷	pao guang shua	1
泡镊桶	pao nie tong	1
泡镊筒	pao nie tong	1
胚胎解冻液	pei tai jie dong ye	1
胚胎冷冻液	pei tai leng dong ye	1
胚胎培养液	pei tai pei yang ye	1
胚胎移植管	pei tai yi zhi guan	1
培养剂	pei yang ji	1
培养皿	pei yang min	1
培养瓶	pei yang ping	1
盆骨接骨板	pen gu jie gu ban	1
喷雾器	pen wu qi	1
膨胀式髓内钉	peng zhang shi sui nei ding	1
皮肤点刺变应原系列试剂	pi fu dian ci bian ying yuan xi lie shi ji	1
皮肤粘合剂	pi fu nian he ji	1
皮肤消毒液	pi fu xiao du ye	1
皮质醇检测试剂	pi zhi chun jian ce shi ji	1
皮质骨螺钉	pi zhi gu luo ding	1
漂浮起搏导管	piao fu qi bo dao guan	1
漂浮微导管	piao fu wei dao guan	1
平板	ping ban	1
屏风	ping feng	1
破囊针头	po nang zhen tou	1
葡萄球菌鉴定试剂条	pu tao qiu jun jian ding shi ji tiao	1
葡萄球菌凝集试剂	pu tao qiu jun ning ji shi ji	1
葡萄糖	pu tao tang	1
葡萄糖测定试剂盒	pu tao tang ce ding shi ji he	1
葡萄糖磷酸脱氢酶试剂盒	pu tao tang lin suan tuo qing mei shi ji he	1
普通不锈钢板	pu tong bu xiu gang ban	1
普通超滑造影导丝	pu tong chao hua zao ying dao si	1
普通导丝	pu tong dao si	1
普通缝合针	pu tong feng he zhen	1
普通钢板	pu tong gang ban	1
普通骨水泥	pu tong gu shui ni	1
普通换药车	pu tong huan yao che	1
普通颈椎植骨螺钉含附件	pu tong jing zhui zhi gu luo ding han fu jian	1
普通颈椎椎体螺钉含附件	pu tong jing zhui zhui ti luo ding han fu jian	1
普通棉签	pu tong mian qian	1
普通鞘组	pu tong qiao zu	1
普通球囊	pu tong qiu nang	1
普通双杯半髋	pu tong shuang bei ban kuan	1
普通透析器合成膜透析器膜	pu tong tou xi qi he cheng mo tou xi qi mo	1
普通透析器三醋酸膜透析器膜	pu tong tou xi qi san cu suan mo tou xi qi mo	1
普通透析器双醋酸膜透析器	pu tong tou xi qi shuang cu suan mo tou xi qi	1
普通透析器双醋酸膜透析器膜	pu tong tou xi qi shuang cu suan mo tou xi qi mo	1
普通透析器铜仿膜透析器膜	pu tong tou xi qi tong fang mo tou xi qi mo	1
普通透析器血仿膜透析器膜	pu tong tou xi qi xue fang mo tou xi qi mo	1
普通型股骨柄	pu tong xing gu gu bing	1
普通型股骨柄骨水泥	pu tong xing gu gu bing gu shui ni	1
普通一次性使用无菌输液器	pu tong yi ci xing shi yong wu jun shu ye qi	1
普通营养琼脂干粉	pu tong ying yang qiong zhi gan fen	1
起搏导线导引鞘	qi bo dao xian dao yin qiao	1
起搏器涂覆电极	qi bo qi tu fu dian ji	1
器材	qi cai	1
气垫床	qi dian chuang	1
骑缝钉	qi feng ding	1
骑缝钉记忆合金	qi feng ding ji yi he jin	1
气管插管	qi guan cha guan	1
气管插管包全麻包	qi guan cha guan bao quan ma bao	1
气管导管	qi guan dao guan	1
气管导管咬口	qi guan dao guan yao kou	1
气管切开包	qi guan qie kai bao	1
气管支架	qi guan zhi jia	1
气囊取石导管	qi nang qu shi dao guan	1
启瓶器	qi ping qi	1
其他介入诊断治疗用导丝	qi ta jie ru zhen duan zhi liao yong dao si	1
器械车	qi xie che	1
器械护套	qi xie hu tao	1
器械托槽架	qi xie tuo cao jia	1
气压止血带	qi ya zhi xue dai	1
髂动脉支架	qia dong mai zhi jia	1
前白蛋白	qian bai dan bai	1
前白蛋白试剂盒	qian bai dan bai shi ji he	1
前臂骨夹板	qian bi gu jia ban	1
前臂假肢	qian bi jia zhi	1
铅测定试剂盒	qian ce ding shi ji he	1
前方牵引装置	qian fang qian yin zhuang zhi	1
前房型硬晶体	qian fang xing ying jing ti	1
前胶原	qian jiao yuan	1
前列腺灌注管	qian lie xian guan zhu guan	1
前列腺酸性磷酸酶	qian lie xian suan xing lin suan mei	1
前列腺特异抗原	qian lie xian te yi kang yuan	1
前列腺特异性抗原	qian lie xian te yi xing kang yuan	1
嵌体蜡	qian ti la	1
牵引头帽	qian yin tou mao	1
钳子	qian zi	1
羟基丁酸脱氢酶	qiang ji ding suan tuo qing mei	1
羟基丁酸脱氢酶试剂盒	qiang ji ding suan tuo qing mei shi ji he	1
羟基磷灰石涂层髋关节	qiang ji lin hui shi tu ceng kuan guan jie	1
羟基磷灰石涂层髋关节柄	qiang ji lin hui shi tu ceng kuan guan jie bing	1
羟基磷灰石涂层髋关节髋臼内衬	qiang ji lin hui shi tu ceng kuan guan jie kuan jiu nei chen	1
腔静脉支架含输送系统	qiang jing mai zhi jia han shu song xi tong	1
腔镜使用套扎器	qiang jing shi yong tao zha qi	1
腔镜使用套扎线	qiang jing shi yong tao zha xian	1
腔镜使用推结器	qiang jing shi yong tui jie qi	1
抢救车	qiang jiu che	1
巧克力平板培养基	qiao ke li ping ban pei yang ji	1
切割抛光机	qie ge pao guang ji	1
切割球囊系统	qie ge qiu nang xi tong	1
切口疝补片	qie kou shan bu pian	1
切片刀	qie pian dao	1
切片石腊	qie pian shi la	1
青光眼植入物青光眼阀	qing guang yan zhi ru wu qing guang yan fa	1
青光眼植入物青光眼凝胶	qing guang yan zhi ru wu qing guang yan ning jiao	1
清洗液	qing xi ye	1
琼脂干粉	qiong zhi gan fen	1
求精移液管	qiu jing yi ye guan	1
球囊	qiu nang	1
球囊导管	qiu nang dao guan	1
球囊扩展导管	qiu nang kuo zhan dao guan	1
球囊扩张导管	qiu nang kuo zhang dao guan	1
球囊扩张造影导管	qiu nang kuo zhang zao ying dao guan	1
秋水仙素	qiu shui xian su	1
躯干矫形器	qu gan jiao xing qi	1
屈光性后房型人工晶体	qu guang xing hou fang xing ren gong jing ti	1
趋化因子测定试剂	qu hua yin zi ce ding shi ji	1
取石网篮	qu shi wang lan	1
取血栓导管	qu xue shuan dao guan	1
醛固酮	quan gu tong	1
全环形外固定支架	quan huan xing wai gu ding zhi jia	1
全聚乙烯胫骨平台膝关节	quan ju yi xi jing gu ping tai xi guan jie	1
全聚乙烯膝胫骨面关节	quan ju yi xi xi jing gu mian guan jie	1
全口牙	quan kou ya	1
全髋股骨柄	quan kuan gu gu bing	1
全髋金属髋臼金属外杯	quan kuan jin shu kuan jiu jin shu wai bei	1
全髋臼杯钴铬钼	quan kuan jiu bei gu ge mu	1
全髋臼杯钛合金	quan kuan jiu bei tai he jin	1
全髋臼内衬	quan kuan jiu nei chen	1
全髋臼外帽	quan kuan jiu wai mao	1
全髋系统股骨	quan kuan xi tong gu gu	1
全髋系统股骨柄	quan kuan xi tong gu gu bing	1
全髋系统股骨头	quan kuan xi tong gu gu tou	1
全髋系统加长股骨柄	quan kuan xi tong jia chang gu gu bing	1
全麻插管套件	quan ma cha guan tao jian	1
全麻废气静化器	quan ma fei qi jing hua qi	1
全涂层生物型直柄	quan tu ceng sheng wu xing zhi bing	1
全膝关节	quan xi guan jie	1
全膝关节置换系统	quan xi guan jie zhi huan xi tong	1
全血质控物	quan xue zhi kong wu	1
全自动注药泵	quan zi dong zhu yao beng	1
染色缸	ran se gang	1
染色体微缺失基因诊断试剂	ran se ti wei que shi ji yin zhen duan shi ji	1
桡动脉鞘	rao dong mai qiao	1
桡动脉鞘组	rao dong mai qiao zu	1
桡骨远端钢板	rao gu yuan duan gang ban	1
桡骨远端钢板不锈钢	rao gu yuan duan gang ban bu xiu gang	1
桡骨远端钢板纯钛	rao gu yuan duan gang ban chun tai	1
桡骨远端钢板钛合金	rao gu yuan duan gang ban tai he jin	1
桡骨远端锁定异型解剖钢板纯钛	rao gu yuan duan suo ding yi xing jie pou gang ban chun tai	1
桡骨远端异型解剖钢板	rao gu yuan duan yi xing jie pou gang ban	1
桡骨远端异型解剖钢板不锈钢	rao gu yuan duan yi xing jie pou gang ban bu xiu gang	1
桡骨远端异型解剖钢板纯钛	rao gu yuan duan yi xing jie pou gang ban chun tai	1
桡骨远端异型解剖钢板钛合金	rao gu yuan duan yi xing jie pou gang ban tai he jin	1
桡骨远端异型解剖锁定钢板	rao gu yuan duan yi xing jie pou suo ding gang ban	1
热敏打印纸	re min da yin zhi	1
热湿交换过滤器	re shi jiao huan guo lv qi	1
热温交换器套装	re wen jiao huan qi tao zhuang	1
热稀释漂浮导管	re xi shi piao fu dao guan	1
人垂体泌乳素	ren chui ti mi ru su	1
人促黄体生成激素	ren cu huang ti sheng cheng ji su	1
人发人工肌健	ren fa ren gong ji jian	1
人工半肩关节	ren gong ban jian guan jie	1
人工半髋关节	ren gong ban kuan guan jie	1
人工半髋关节肿瘤假体	ren gong ban kuan guan jie zhong liu jia ti	1
人工瓣膜	ren gong ban mo	1
人工瓣膜金属瓣心脏外科	ren gong ban mo jin shu ban xin zang wai ke	1
人工瓣膜生物瓣心脏外科	ren gong ban mo sheng wu ban xin zang wai ke	1
人工鼻	ren gong bi	1
人工鼻过滤器	ren gong bi guo lv qi	1
人工翻修膝	ren gong fan xiu xi	1
人工翻修膝高屈曲	ren gong fan xiu xi gao qu qu	1
人工翻修膝旋转铰链	ren gong fan xiu xi xuan zhuan jiao lian	1
人工肛袋	ren gong gang dai	1
人工骨	ren gong gu	1
人工骨粉	ren gong gu fen	1
人工股骨柄	ren gong gu gu bing	1
人工股骨头	ren gong gu gu tou	1
人工晶体	ren gong jing ti	1
人工髋关节	ren gong kuan guan jie	1
人工髋关节国产普通骨水泥	ren gong kuan guan jie guo chan pu tong gu shui ni	1
人工髋关节螺钉	ren gong kuan guan jie luo ding	1
人工髋关节其他配件包含螺钉	ren gong kuan guan jie qi ta pei jian bao han luo ding	1
人工膜肺	ren gong mo fei	1
人工膜肺氧合器	ren gong mo fei yang he qi	1
人工全肩关节	ren gong quan jian guan jie	1
人工全髋关节	ren gong quan kuan guan jie	1
人工全髋关节肿瘤假体组合式	ren gong quan kuan guan jie zhong liu jia ti zu he shi	1
人工桡骨头	ren gong rao gu tou	1
人工乳房	ren gong ru fang	1
人工授精管	ren gong shou jing guan	1
人工髓核	ren gong sui he	1
人工膝关节	ren gong xi guan jie	1
人工膝关节单髁置换型	ren gong xi guan jie dan ke zhi huan xing	1
人工膝关节后方稳定型关节假体	ren gong xi guan jie hou fang wen ding xing guan jie jia ti	1
人工膝关节铰链稳定型	ren gong xi guan jie jiao lian wen ding xing	1
人工膝关节其他配件包含螺钉	ren gong xi guan jie qi ta pei jian bao han luo ding	1
人工膝关节旋转铰链型	ren gong xi guan jie xuan zhuan jiao lian xing	1
人工膝关节旋转平台型	ren gong xi guan jie xuan zhuan ping tai xing	1
人工膝关节旋转平台型关节假体	ren gong xi guan jie xuan zhuan ping tai xing guan jie jia ti	1
人工膝关节肿瘤假体	ren gong xi guan jie zhong liu jia ti	1
人工心脏瓣膜金属瓣	ren gong xin zang ban mo jin shu ban	1
人工心脏瓣膜生物瓣	ren gong xin zang ban mo sheng wu ban	1
人工肘关节	ren gong zhou guan jie	1
人工椎间盘及其他非融合系统	ren gong zhui jian pan ji qi ta fei rong he xi tong	1
人工椎间盘及其他非融合装置	ren gong zhui jian pan ji qi ta fei rong he zhuang zhi	1
人工椎体	ren gong zhui ti	1
人绒毛膜促性腺激素	ren rong mao mo cu xing xian ji su	1
人乳头瘤病毒型	ren ru tou liu bing du xing	1
人乳头状瘤病毒检测试剂	ren ru tou zhuang liu bing du jian ce shi ji	1
妊娠相关蛋白试剂	ren shen xiang guan dan bai shi ji	1
妊娠相关蛋白稀释液	ren shen xiang guan dan bai xi shi ye	1
妊娠诊断检测试剂定性或半定量	ren shen zhen duan jian ce shi ji ding xing huo ban ding liang	1
人生长激素测定试剂	ren sheng zhang ji su ce ding shi ji	1
人体磅	ren ti bang	1
人型支原体检测试剂	ren xing zhi yuan ti jian ce shi ji	1
人血清白蛋白	ren xue qing bai dan bai	1
人造石面地柜	ren zao shi mian di gui	1
人造血管	ren zao xue guan	1
人造血管心脏外科	ren zao xue guan xin zang wai ke	1
绒毛膜促性腺激素	rong mao mo cu xing xian ji su	1
绒毛膜促性腺激素定量试剂盒	rong mao mo cu xing xian ji su ding liang shi ji he	1
溶栓导管	rong shuan dao guan	1
溶血素	rong xue su	1
肉汤琼脂干粉	rou tang qiong zhi gan fen	1
乳胶管	ru jiao guan	1
乳胶检查手套	ru jiao jian cha shou tao	1
乳胶抗链试剂	ru jiao kang lian shi ji	1
乳酸	ru suan	1
乳酸脱氢酶	ru suan tuo qing mei	1
乳酸脱氢酶试剂盒	ru suan tuo qing mei shi ji he	1
乳酸脱氢酶同工酶试剂盒	ru suan tuo qing mei tong gong mei shi ji he	1
乳头	ru tou	1
乳头切开刀	ru tou qie kai dao	1
乳头预切开刀	ru tou yu qie kai dao	1
乳突球囊	ru tu qiu nang	1
乳牙早失病态模型	ru ya zao shi bing tai mo xing	1
软衬材料	ruan chen cai liao	1
软晶体	ruan jing ti	1
软组织扩张器	ruan zu zhi kuo zhang qi	1
瑞姬氏染色液	rui ji shi ran se ye	1
瑞氏快速染色液	rui shi kuai su ran se ye	1
瑞氏染色液	rui shi ran se ye	1
瑞氏染液	rui shi ran ye	1
三醋酸膜透析器	san cu suan mo tou xi qi	1
三碘甲状腺氨酸	san dian jia zhuang xian an suan	1
三碘甲状腺原氨酸	san dian jia zhuang xian yuan an suan	1
三分类血球仪试剂	san fen lei xue qiu yi shi ji	1
三节实验柜	san jie shi yan gui	1
三联观片灯	san lian guan pian deng	1
三连三通	san lian san tong	1
三明治陶瓷内衬	san ming zhi tao ci nei chen	1
三腔二囊管	san qiang er nang guan	1
叁腔尿管	san qiang niao guan	1
三腔起搏器	san qiang qi bo qi	1
三腔起搏器加除颤器	san qiang qi bo qi jia chu chan qi	1
三腔气囊导尿管	san qiang qi nang dao niao guan	1
三腔取石气囊	san qiang qu shi qi nang	1
三腔无菌导尿管	san qiang wu jun dao niao guan	1
三岁恒牙交替解剖模型	san sui heng ya jiao ti jie pou mo xing	1
三通	san tong	1
三通管阀	san tong guan fa	1
三通施塞	san tong shi sai	1
三通延长管	san tong yan chang guan	1
三维钛网	san wei tai wang	1
三效热原灭活剂	san xiao re yuan mie huo ji	1
三效热原灭活消毒剂	san xiao re yuan mie huo xiao du ji	1
三效热原试纸	san xiao re yuan shi zhi	1
三氧化二铝陶瓷股骨头	san yang hua er lv tao ci gu gu tou	1
三医用光胶片及附属用品	san yi yong guang jiao pian ji fu shu yong pin	1
扫描仪	sao miao yi	1
沙保罗琼脂干粉	sha bao luo qiong zhi gan fen	1
纱布	sha bu	1
纱布绷带	sha bu beng dai	1
纱布垫	sha bu dian	1
纱布口罩	sha bu kou zhao	1
纱布块	sha bu kuai	1
砂轮	sha lun	1
沙门菌属属血清	sha men jun shu shu xue qing	1
沙眼衣原体	sha yan yi yuan ti	1
沙眼衣原体检测试剂	sha yan yi yuan ti jian ce shi ji	1
珊瑚面关节柄	shan hu mian guan jie bing	1
珊瑚面金属臼衬	shan hu mian jin shu jiu chen	1
珊瑚面金属臼三翼型	shan hu mian jin shu jiu san yi xing	1
疝环充填式补片	shan huan chong tian shi bu pian	1
疝气补片	shan qi bu pian	1
疝气带	shan qi dai	1
疝修补枪	shan xiu bu qiang	1
疝修预裁补片	shan xiu yu cai bu pian	1
上臂假肢	shang bi jia zhi	1
伤寒血清凝集试验试剂	shang han xue qing ning ji shi yan shi ji	1
伤口敷料	shang kou fu liao	1
上肢加压钢板	shang zhi jia ya gang ban	1
上肢加压钢板不锈钢	shang zhi jia ya gang ban bu xiu gang	1
上肢加压钢板纯钛	shang zhi jia ya gang ban chun tai	1
上肢加压钢板钛合金	shang zhi jia ya gang ban tai he jin	1
上肢加压锁定钢板	shang zhi jia ya suo ding gang ban	1
上肢加压锁定钢板不锈钢	shang zhi jia ya suo ding gang ban bu xiu gang	1
上肢加压锁定钢板纯钛	shang zhi jia ya suo ding gang ban chun tai	1
上肢加压锁定钢板钛合金	shang zhi jia ya suo ding gang ban tai he jin	1
上肢矫形器	shang zhi jiao xing qi	1
上肢接骨板	shang zhi jie gu ban	1
上肢皮质骨钛螺钉	shang zhi pi zhi gu tai luo ding	1
舌侧扣	she ce kou	1
舌侧拉环	she ce la huan	1
射频消融导管	she pin xiao rong dao guan	1
射频消融导管非温控	she pin xiao rong dao guan fei wen kong	1
射频消融导管及配件	she pin xiao rong dao guan ji pei jian	1
射频消融导管温控	she pin xiao rong dao guan wen kong	1
射频消融导管温控加硬可调弯	she pin xiao rong dao guan wen kong jia ying ke tiao wan	1
射频消融导管温控可调弯	she pin xiao rong dao guan wen kong ke tiao wan	1
射频消融导管温控双弯可调	she pin xiao rong dao guan wen kong shuang wan ke tiao	1
射频消融导管消融大头可调弯	she pin xiao rong dao guan xiao rong da tou ke tiao wan	1
舌钳	she qian	1
摄像机	she xiang ji	1
肾动脉支架系统	shen dong mai zhi jia xi tong	1
肾动脉支架预装球囊支架	shen dong mai zhi jia yu zhuang qiu nang zhi jia	1
神经补片	shen jing bu pian	1
神经导丝	shen jing dao si	1
神经介入不可脱球囊系统	shen jing jie ru bu ke tuo qiu nang xi tong	1
神经介入超滑导引导管	shen jing jie ru chao hua dao yin dao guan	1
神经介入导丝	shen jing jie ru dao si	1
神经介入导引导管	shen jing jie ru dao yin dao guan	1
神经介入导引导丝	shen jing jie ru dao yin dao si	1
神经介入加硬导丝	shen jing jie ru jia ying dao si	1
神经介入可脱球囊	shen jing jie ru ke tuo qiu nang	1
神经介入可脱球囊微导管	shen jing jie ru ke tuo qiu nang wei dao guan	1
神经介入普通导丝	shen jing jie ru pu tong dao si	1
神经介入鞘组	shen jing jie ru qiao zu	1
神经介入溶栓导管	shen jing jie ru rong shuan dao guan	1
神经介入微导管	shen jing jie ru wei dao guan	1
神经介入微导丝	shen jing jie ru wei dao si	1
神经介入造影超滑导管	shen jing jie ru zao ying chao hua dao guan	1
神经介入造影导管	shen jing jie ru zao ying dao guan	1
神经介入造影导丝	shen jing jie ru zao ying dao si	1
神经介入造影普通导管	shen jing jie ru zao ying pu tong dao guan	1
神经介入诊断治疗用途导丝	shen jing jie ru zhen duan zhi liao yong tu dao si	1
神经介入支架系统	shen jing jie ru zhi jia xi tong	1
深静脉穿刺套件	shen jing mai chuan ci tao jian	1
深静脉穿刺针	shen jing mai chuan ci zhen	1
神经微导丝	shen jing wei dao si	1
神经元特异性烯醇化酶	shen jing yuan te yi xing xi chun hua mei	1
肾盂造瘘管	shen yu zao lou guan	1
生化通用定标液	sheng hua tong yong ding biao ye	1
生化通用质控液	sheng hua tong yong zhi kong ye	1
生理微孔型全膝关节	sheng li wei kong xing quan xi guan jie	1
生理微孔型旋转平台全膝关节	sheng li wei kong xing xuan zhuan ping tai quan xi guan jie	1
生物柄	sheng wu bing	1
生物蛋白海绵	sheng wu dan bai hai mian	1
生物蛋白胶	sheng wu dan bai jiao	1
生物翻修髋臼	sheng wu fan xiu kuan jiu	1
生物固定柄	sheng wu gu ding bing	1
生物固定初次置换柄	sheng wu gu ding chu ci zhi huan bing	1
生物固定翻修髋臼杯	sheng wu gu ding fan xiu kuan jiu bei	1
生物固定髋臼内衬	sheng wu gu ding kuan jiu nei chen	1
生物固定配件	sheng wu gu ding pei jian	1
生物固定配件螺钉	sheng wu gu ding pei jian luo ding	1
生物固定配件螺钉每枚	sheng wu gu ding pei jian luo ding mei mei	1
生物固定型翻修柄	sheng wu gu ding xing fan xiu bing	1
生物固定型直柄翻修柄	sheng wu gu ding xing zhi bing fan xiu bing	1
生物酶清洗液	sheng wu mei qing xi ye	1
生物膜透析器	sheng wu mo tou xi qi	1
生物芯片试剂各种组合	sheng wu xin pian shi ji ge zhong zu he	1
生物型柄	sheng wu xing bing	1
生物型翻修柄	sheng wu xing fan xiu bing	1
生物型聚乙烯髋臼内村	sheng wu xing ju yi xi kuan jiu nei cun	1
生物型髋臼杯	sheng wu xing kuan jiu bei	1
生物型髋臼陶瓷内衬	sheng wu xing kuan jiu tao ci nei chen	1
生物型髋臼外杯	sheng wu xing kuan jiu wai bei	1
生物羊膜	sheng wu yang mo	1
生物指示剂	sheng wu zhi shi ji	1
生长阀	sheng zhang fa	1
生殖支原体检测试剂	sheng zhi zhi yuan ti jian ce shi ji	1
食道静脉曲张套扎器	shi dao jing mai qu zhang tao zha qi	1
食道扩张球囊	shi dao kuo zhang qiu nang	1
十二指肠管	shi er zhi chang guan	1
释放器	shi fang qi	1
石膏	shi gao	1
石膏绷带	shi gao beng dai	1
石膏剪	shi gao jian	1
石膏调切刀	shi gao tiao qie dao	1
试管	shi guan	1
试管架	shi guan jia	1
湿化瓶	shi hua ping	1
失活剂	shi huo ji	1
试剂	shi ji	1
试剂盒	shi ji he	1
试剂名称	shi ji ming cheng	1
石蜡	shi la	1
适配器	shi pei qi	1
视频采集卡	shi pin cai ji ka	1
史赛克股骨柄	shi sai ke gu gu bing	1
史赛克全髋修复系统螺钉	shi sai ke quan kuan xiu fu xi tong luo ding	1
史赛克全髋修复系统网	shi sai ke quan kuan xiu fu xi tong wang	1
十四经穴人体模型	shi si jing xue ren ti mo xing	1
十项尿试纸	shi xiang niao shi zhi	1
实验地柜	shi yan di gui	1
实验柜	shi yan gui	1
实验台	shi yan tai	1
十一项尿试纸	shi yi xiang niao shi zhi	1
手部异型解剖钢板	shou bu yi xing jie pou gang ban	1
手部异型解剖钢板不锈钢	shou bu yi xing jie pou gang ban bu xiu gang	1
手部异型解剖钢板纯钛	shou bu yi xing jie pou gang ban chun tai	1
手部异型解剖钢板钛合金	shou bu yi xing jie pou gang ban tai he jin	1
手称	shou cheng	1
手术刀柄	shou shu dao bing	1
手术刀片	shou shu dao pian	1
手术反光灯	shou shu fan guang deng	1
手术防粘连材料固体形状	shou shu fang zhan lian cai liao gu ti xing zhuang	1
手术及病理标本袋	shou shu ji bing li biao ben dai	1
手术剪	shou shu jian	1
手术解剖器	shou shu jie pou qi	1
手术巾	shou shu jin	1
手术图谱光盘	shou shu tu pu guang pan	1
手术消毒擦手液	shou shu xiao du ca shou ye	1
手术消毒洗手液	shou shu xiao du xi shou ye	1
手术引流管	shou shu yin liu guan	1
手套	shou tao	1
手消毒剂	shou xiao du ji	1
手指微型钢板	shou zhi wei xing gang ban	1
手足部跟骨钢板	shou zu bu gen gu gang ban	1
输尿管导管	shu niao guan dao guan	1
输尿管导管支架管	shu niao guan dao guan zhi jia guan	1
熟石膏粉	shu shi gao fen	1
输送系统	shu song xi tong	1
输血胶管	shu xue jiao guan	1
输氧管	shu yang guan	1
输氧胶管	shu yang jiao guan	1
输液胶贴	shu ye jiao tie	1
输液器	shu ye qi	1
输液延伸管	shu ye yan shen guan	1
树脂牙	shu zhi ya	1
输注导管	shu zhu dao guan	1
栓塞材料	shuan se cai liao	1
双鼻塞	shuang bi se	1
双边外固定支架	shuang bian wai gu ding zhi jia	1
双醋酸膜透析器	shuang cu suan mo tou xi qi	1
双导丝球囊	shuang dao si qiu nang	1
双动半髋	shuang dong ban kuan	1
双动股骨头	shuang dong gu gu tou	1
双极半髋	shuang ji ban kuan	1
双极半髋杯	shuang ji ban kuan bei	1
双极半髋金属杯	shuang ji ban kuan jin shu bei	1
双极半髋臼	shuang ji ban kuan jiu	1
双极半髋卡式双动头	shuang ji ban kuan ka shi shuang dong tou	1
双极半髋帽	shuang ji ban kuan mao	1
双极杯	shuang ji bei	1
双极股骨头	shuang ji gu gu tou	1
双极临时起搏导管	shuang ji lin shi qi bo dao guan	1
双极心房导线	shuang ji xin fang dao xian	1
双极心房电极	shuang ji xin fang dian ji	1
双极心房细电极	shuang ji xin fang xi dian ji	1
双极心室导线	shuang ji xin shi dao xian	1
双极心室电极	shuang ji xin shi dian ji	1
双极心室细电极	shuang ji xin shi xi dian ji	1
双极左室电极	shuang ji zuo shi dian ji	1
双面代架黑板	shuang mian dai jia hei ban	1
双面支架黑板	shuang mian zhi jia hei ban	1
双腔	shuang qiang	1
双腔尿管	shuang qiang niao guan	1
双腔气囊导尿管	shuang qiang qi nang dao niao guan	1
双腔取卵针	shuang qiang qu luan zhen	1
双腔型	shuang qiang xing	1
双人外科显微镜	shuang ren wai ke xian wei jing	1
双糖铁琼脂干粉	shuang tang tie qiong zhi gan fen	1
双涂层关节柄	shuang tu ceng guan jie bing	1
双涂层关节长柄翻修	shuang tu ceng guan jie chang bing fan xiu	1
双涂层髋关节柄	shuang tu ceng kuan guan jie bing	1
双弯射频消融导管可调弯	shuang wan she pin xiao rong dao guan ke tiao wan	1
双氧水	shuang yang shui	1
双锥面螺旋臼标准型多齿型	shuang zhui mian luo xuan jiu biao zhun xing duo chi xing	1
水封瓶	shui feng ping	1
水解酪蛋白琼脂干粉	shui jie lao dan bai qiong zhi gan fen	1
水解弹簧圈	shui jie tan huang quan	1
水银	shui yin	1
丝攻	si gong	1
四功能美容机	si gong neng mei rong ji	1
撕囊镊	si nang nie	1
斯式针	si shi zhen	1
四外科耗材及其他	si wai ke hao cai ji qi ta	1
松质骨拉力螺钉	song zhi gu la li luo ding	1
松质骨螺钉	song zhi gu luo ding	1
塑料薄膜手套	su liao bao mo shou tao	1
塑料窥器	su liao kui qi	1
塑料晾片板	su liao liang pian ban	1
塑料试管	su liao shi guan	1
塑料头皮夹	su liao tou pi jia	1
塑料载片盒	su liao zai pian he	1
苏木精	su mu jing	1
苏木素染色液	su mu su ran se ye	1
酸蚀剂	suan shi ji	1
髓内针	sui nei zhen	1
随弃式导电粘胶极板	sui qi shi dao dian zhan jiao ji ban	1
髓腔塞	sui qiang sai	1
碎石网篮	sui shi wang lan	1
锁定螺钉	suo ding luo ding	1
锁骨纯钛钢板	suo gu chun tai gang ban	1
锁骨钢板	suo gu gang ban	1
锁骨钢板不锈钢	suo gu gang ban bu xiu gang	1
锁骨钢板纯钛	suo gu gang ban chun tai	1
锁骨钢板钛合金	suo gu gang ban tai he jin	1
锁骨肩锁钛钢板左右侧	suo gu jian suo tai gang ban zuo you ce	1
锁骨下静脉用中心静脉导管	suo gu xia jing mai yong zhong xin jing mai dao guan	1
索控肩背带	suo kong jian bei dai	1
钛重建板	tai chong jian ban	1
钛钉	tai ding	1
胎儿吸引器	tai er xi yin qi	1
钛合金大钢托	tai he jin da gang tuo	1
钛合金股骨柄	tai he jin gu gu bing	1
钛合金骨螺钉	tai he jin gu luo ding	1
钛合金烤瓷	tai he jin kao ci	1
钛合金人工翻修股骨柄	tai he jin ren gong fan xiu gu gu bing	1
钛合金人工股骨柄	tai he jin ren gong gu gu bing	1
钛合金人工髋臼杯	tai he jin ren gong kuan jiu bei	1
钛合金生物型股骨柄	tai he jin sheng wu xing gu gu bing	1
钛合金微孔关节柄喷涂	tai he jin wei kong guan jie bing pen tu	1
钛金属接骨螺钉	tai jin shu jie gu luo ding	1
钛髋臼系统臼杯	tai kuan jiu xi tong jiu bei	1
台盼兰染色剂	tai pan lan ran se ji	1
钛片	tai pian	1
台式血压计	tai shi xue ya ji	1
钛网	tai wang	1
胎音听筒	tai yin ting tong	1
钛珠涂层股骨柄	tai zhu tu ceng gu gu bing	1
钛珠涂层髋臼杯	tai zhu tu ceng kuan jiu bei	1
弹簧圈	tan huang quan	1
弹簧圈外周介入	tan huang quan wai zhou jie ru	1
弹簧圈心脏介入	tan huang quan xin zang jie ru	1
弹簧栓子	tan huang shuan zi	1
弹力背心套	tan li bei xin tao	1
弹力长袖上衣	tan li chang xiu shang yi	1
弹力大腿套	tan li da tui tao	1
弹力腹套	tan li fu tao	1
弹力颌颈套	tan li he jing tao	1
弹力颌套	tan li he tao	1
弹力肩臂套	tan li jian bi tao	1
弹力肩胸套	tan li jian xiong tao	1
弹力可调胸腹裤	tan li ke tiao xiong fu ku	1
弹力裤	tan li ku	1
弹力连臂手套	tan li lian bi shou tao	1
弹力面罩	tan li mian zhao	1
弹力前臂套	tan li qian bi tao	1
弹力上臂套	tan li shang bi tao	1
弹力上肢套	tan li shang zhi tao	1
弹力束乳带	tan li shu ru dai	1
弹力双上臂套	tan li shuang shang bi tao	1
弹力袜	tan li wa	1
弹力无指手套	tan li wu zhi shou tao	1
弹力膝套	tan li xi tao	1
弹力下肢套	tan li xia zhi tao	1
弹力小腿套	tan li xiao tui tao	1
弹力有指手套	tan li you zhi shou tao	1
摊片镊包埋	tan pian nie bao mai	1
碳肾	tan shen	1
探针	tan zhen	1
糖化血红蛋白	tang hua xue hong dan bai	1
糖化血清蛋白果糖氨	tang hua xue qing dan bai guo tang an	1
糖类抗原肿瘤试剂	tang lei kang yuan zhong liu shi ji	1
唐筛洗剂液扩增液	tang shai xi ji ye kuo zeng ye	1
唐氏筛查双标试剂	tang shi shai cha shuang biao shi ji	1
唐氏综合征筛查质控	tang shi zong he zheng shai cha zhi kong	1
陶瓷股骨头	tao ci gu gu tou	1
陶瓷髋臼杯	tao ci kuan jiu bei	1
陶瓷内衬	tao ci nei chen	1
陶瓷球头	tao ci qiu tou	1
陶瓷人工股骨头	tao ci ren gong gu gu tou	1
陶瓷头	tao ci tou	1
特殊标测电极	te shu biao ce dian ji	1
特殊标测电极二十极	te shu biao ce dian ji er shi ji	1
特殊标测电极球囊标测	te shu biao ce dian ji qiu nang biao ce	1
特殊标测电极体表电极	te shu biao ce dian ji ti biao dian ji	1
特殊标测电极希氏束	te shu biao ce dian ji xi shi shu	1
特殊长鞘组	te shu chang qiao zu	1
特殊垫圈	te shu dian quan	1
特殊封堵器	te shu feng du qi	1
特殊截肢片面假肢	te shu jie zhi pian mian jia zhi	1
特殊消融导管	te shu xiao rong dao guan	1
特殊一次性使用输液器	te shu yi ci xing shi yong shu ye qi	1
特殊一次性使用无菌输液器	te shu yi ci xing shi yong wu jun shu ye qi	1
剔挖器	ti wa qi	1
体外受精培养液	ti wai shou jing pei yang ye	1
体外循环管道	ti wai xun huan guan dao	1
体外引流袋	ti wai yin liu dai	1
体温表	ti wen biao	1
体温表甩降器	ti wen biao shuai jiang qi	1
体温针	ti wen zhen	1
梯形钳	ti xing qian	1
梯子	ti zi	1
天津合成骨水泥	tian jin he cheng gu shui ni	1
天门冬氨酸氨基转移酶试剂盒	tian men dong an suan an ji zhuan yi mei shi ji he	1
天疱疮抗体	tian pao chuang kang ti	1
天平	tian ping	1
天酸粘固粉	tian suan zhan gu fen	1
天义福髋关节假体翻修柄	tian yi fu kuan guan jie jia ti fan xiu bing	1
天义福髋关节假体股骨柄	tian yi fu kuan guan jie jia ti gu gu bing	1
天义福髋关节假体股骨头	tian yi fu kuan guan jie jia ti gu gu tou	1
天义福髋关节假体金属髋臼	tian yi fu kuan guan jie jia ti jin shu kuan jiu	1
天义福髋关节假体髋臼	tian yi fu kuan guan jie jia ti kuan jiu	1
天义福髋关节假体螺钉	tian yi fu kuan guan jie jia ti luo ding	1
天义福髋关节假体双动头	tian yi fu kuan guan jie jia ti shuang dong tou	1
天义福髋关节假体远端塞	tian yi fu kuan guan jie jia ti yuan duan sai	1
天义福髋关节假体中控体	tian yi fu kuan guan jie jia ti zhong kong ti	1
铁测定试剂盒	tie ce ding shi ji he	1
铁蛋白	tie dan bai	1
铁蛋白试剂盒	tie dan bai shi ji he	1
铁二门更衣柜	tie er men geng yi gui	1
铁面圆凳	tie mian yuan deng	1
铁推车	tie tui che	1
听诊器	ting zhen qi	1
听诊器耳塞	ting zhen qi er sai	1
听诊器胶管	ting zhen qi jiao guan	1
铜测定试剂盒	tong ce ding shi ji he	1
铜仿膜透析器	tong fang mo tou xi qi	1
同工酶电泳检验试剂	tong gong mei dian yong jian yan shi ji	1
铜蓝蛋白测定试剂	tong lan dan bai ce ding shi ji	1
酮酸	tong suan	1
酮体试纸条	tong ti shi zhi tiao	1
同型半胱氨酸	tong xing ban guang an suan	1
通用股骨头	tong yong gu gu tou	1
通用凝血定标血浆正常	tong yong ning xue ding biao xue jiang zheng chang	1
通用透析管路	tong yong tou xi guan lu	1
通用透析管路按适合机型分类	tong yong tou xi guan lu an shi he ji xing fen lei	1
通用远端骨水泥中置器	tong yong yuan duan gu shui ni zhong zhi qi	1
同种异体骨	tong zhong yi ti gu	1
透明敷料	tou ming fu liao	1
透明质酸	tou ming zhi suan	1
透明质酸酶	tou ming zhi suan mei	1
透明质酸钠凝胶	tou ming zhi suan na ning jiao	1
头皮留置针	tou pi liu zhi zhen	1
头皮式留置针	tou pi shi liu zhi zhen	1
透气胶布	tou qi jiao bu	1
透气纸胶带	tou qi zhi jiao dai	1
透析粉	tou xi fen	1
透析器聚砜膜	tou xi qi ju feng mo	1
透析器消毒使用浓缩液	tou xi qi xiao du shi yong nong suo ye	1
透析器血路管	tou xi qi xue lu guan	1
透析液	tou xi ye	1
投影仪	tou ying yi	1
涂层全膝关节	tu ceng quan xi guan jie	1
涂层旋转平台型全膝关节	tu ceng xuan zhuan ping tai xing quan xi guan jie	1
涂层造影导丝	tu ceng zao ying dao si	1
兔子补体	tu zi bu ti	1
推荐型髋关节柄	tui jian xing kuan guan jie bing	1
推送器	tui song qi	1
托槽粘结剂	tuo cao nian jie ji	1
脱蜡染色夹	tuo la ran se jia	1
脱敏剂	tuo min ji	1
脱脂绷带	tuo zhi beng dai	1
脱脂棉花	tuo zhi mian hua	1
脱脂棉卷	tuo zhi mian juan	1
脱脂纱布	tuo zhi sha bu	1
脱脂纱布包	tuo zhi sha bu bao	1
脱脂纱布块	tuo zhi sha bu kuai	1
脱脂纱布棉垫	tuo zhi sha bu mian dian	1
脱脂血垫	tuo zhi xue dian	1
脱脂药棉	tuo zhi yao mian	1
外固定架	wai gu ding jia	1
外科补片	wai ke bu pian	1
外科无损伤缝线	wai ke wu sun shang feng xian	1
外裴试剂	wai pei shi ji	1
外沿聚乙烯内衬	wai yan ju yi xi nei chen	1
外引流胆道引流管	wai yin liu dan dao yin liu guan	1
外展架	wai zhan jia	1
外周穿刺中心静脉导管	wai zhou chuan ci zhong xin jing mai dao guan	1
外周大直径球囊	wai zhou da zhi jing qiu nang	1
外周介入长鞘组	wai zhou jie ru chang qiao zu	1
外周介入超滑导丝	wai zhou jie ru chao hua dao si	1
外周介入超滑造影导管	wai zhou jie ru chao hua zao ying dao guan	1
外周介入导丝	wai zhou jie ru dao si	1
外周介入导引导管	wai zhou jie ru dao yin dao guan	1
外周介入加硬导丝	wai zhou jie ru jia ying dao si	1
外周介入普通导丝	wai zhou jie ru pu tong dao si	1
外周介入普通鞘组	wai zhou jie ru pu tong qiao zu	1
外周介入普通造影导管	wai zhou jie ru pu tong zao ying dao guan	1
外周介入鞘组	wai zhou jie ru qiao zu	1
外周介入球囊	wai zhou jie ru qiu nang	1
外周介入微导管	wai zhou jie ru wei dao guan	1
外周介入微导丝	wai zhou jie ru wei dao si	1
外周介入造影导管	wai zhou jie ru zao ying dao guan	1
外周可撕开鞘组	wai zhou ke si kai qiao zu	1
外周切割球囊导管	wai zhou qie ge qiu nang dao guan	1
外周血管覆膜支架	wai zhou xue guan fu mo zhi jia	1
外周血管球囊扩张支架	wai zhou xue guan qiu nang kuo zhang zhi jia	1
外周血管支架	wai zhou xue guan zhi jia	1
外周血管支架流明莱可视	wai zhou xue guan zhi jia liu ming lai ke shi	1
外周血管支架血管覆膜支架	wai zhou xue guan zhi jia xue guan fu mo zhi jia	1
外周血管自膨式支架	wai zhou xue guan zi peng shi zhi jia	1
外周血淋巴细胞染色体培养基	wai zhou xue lin ba xi bao ran se ti pei yang ji	1
外周血提取试剂盒	wai zhou xue ti qu shi ji he	1
外周支架传输系统	wai zhou zhi jia chuan shu xi tong	1
外周中心静脉导管	wai zhou zhong xin jing mai dao guan	1
弯剪刀双动	wan jian dao shuang dong	1
腕离断假肢	wan li duan jia zhi	1
弯盘	wan pan	1
万用型骨水泥远端塞	wan yong xing gu shui ni yuan duan sai	1
网杯	wang bei	1
网织红细胞染色液	wang zhi hong xi bao ran se ye	1
微穿刺鞘	wei chuan ci qiao	1
微穿刺鞘组	wei chuan ci qiao zu	1
微导管	wei dao guan	1
微导管和微导管系统	wei dao guan he wei dao guan xi tong	1
微导管套装	wei dao guan tao zhuang	1
微导丝	wei dao si	1
胃管	wei guan	1
胃镜灯泡	wei jing deng pao	1
胃镜润滑胶浆	wei jing run hua jiao jiang	1
胃镜咬口	wei jing yao kou	1
微孔表面处理股骨近端股骨柄	wei kong biao mian chu li gu gu jin duan gu gu bing	1
微孔表面股骨柄	wei kong biao mian gu gu bing	1
微孔全涂层标准生物型翻修柄	wei kong quan tu ceng biao zhun sheng wu xing fan xiu bing	1
微孔生物型髋臼	wei kong sheng wu xing kuan jiu	1
微孔生物型髋臼杯	wei kong sheng wu xing kuan jiu bei	1
微孔生物型髋臼假体	wei kong sheng wu xing kuan jiu jia ti	1
微孔生物型髋臼内衬	wei kong sheng wu xing kuan jiu nei chen	1
微孔钛臼	wei kong tai jiu	1
微孔钛臼衬	wei kong tai jiu chen	1
微孔涂层股骨柄	wei kong tu ceng gu gu bing	1
微孔涂层股骨柄带	wei kong tu ceng gu gu bing dai	1
微孔涂层近端固定生物型直柄	wei kong tu ceng jin duan gu ding sheng wu xing zhi bing	1
微孔涂层髋臼杯	wei kong tu ceng kuan jiu bei	1
微孔涂层远端固定生物型直柄	wei kong tu ceng yuan duan gu ding sheng wu xing zhi bing	1
微量生化管	wei liang sheng hua guan	1
微量血酮定量测定试纸条	wei liang xue tong ding liang ce ding shi zhi tiao	1
微量元素试剂	wei liang yuan su shi ji	1
微量注射泵	wei liang zhu she beng	1
维纳斯剪	wei na si jian	1
微桥线	wei qiao xian	1
微球蛋白	wei qiu dan bai	1
维生素检测试剂	wei sheng su jian ce shi ji	1
围腰	wei yao	1
胃造瘘管	wei zao lou guan	1
微柱凝胶检测卡	wei zhu ning jiao jian ce ka	1
稳定加强型全膝关节翻修系统	wen ding jia qiang xing quan xi guan jie fan xiu xi tong	1
稳定加强型全膝关节置换系统	wen ding jia qiang xing quan xi guan jie zhi huan xi tong	1
窝沟封闭剂	wo gou feng bi ji	1
卧式高压锅汽圈	wo shi gao ya guo qi quan	1
戊二醛	wu er quan	1
戊二醛浓度测试卡	wu er quan nong du ce shi ka	1
戊二醛消毒剂	wu er quan xiao du ji	1
戊二醛消毒液	wu er quan xiao du ye	1
无纺胶布	wu fang jiao bu	1
戊肝抗	wu gan kang	1
戊肝抗体	wu gan kang ti	1
五功能美容机	wu gong neng mei rong ji	1
五官科集光灯	wu guan ke ji guang deng	1
雾化器	wu hua qi	1
雾化器喷嘴	wu hua qi pen zui	1
雾化吸入器	wu hua xi ru qi	1
无菌薄膜手套	wu jun bo mo shou tao	1
无菌采样拭子	wu jun cai yang shi zi	1
无菌导尿包	wu jun dao niao bao	1
无菌辅巾	wu jun fu jin	1
无菌敷料	wu jun fu liao	1
无菌柜	wu jun gui	1
无菌石蜡油	wu jun shi la you	1
无菌手术刀片	wu jun shou shu dao pian	1
无菌医用乳胶手套	wu jun yi yong ru jiao shou tao	1
戊康碘	wu kang dian	1
五口腔科耗材	wu kou qiang ke hao cai	1
无领抛光锥形柄	wu ling pao guang zhui xing bing	1
无水酒精	wu shui jiu jing	1
无水乙醇	wu shui yi chun	1
无损伤缝合线	wu sun shang feng he xian	1
无损伤缝合针	wu sun shang feng he zhen	1
污物车	wu wu che	1
无纤维蛋白绵羊血	wu xian wei dan bai mian yang xue	1
戊型肝炎抗体	wu xing gan yan kang ti	1
无影灯	wu ying deng	1
无影灯炮	wu ying deng pao	1
细胞刮刀	xi bao gua dao	1
洗必泰氯己定	xi bi tai lv ji ding	1
吸潮纸尖	xi chao zhi jian	1
洗疮器	xi chuang qi	1
洗涤红细胞多联袋	xi di hong xi bao duo lian dai	1
洗耳球	xi er qiu	1
膝关节	xi guan jie	1
膝关节髌骨假体	xi guan jie bin gu jia ti	1
膝关节部分切面	xi guan jie bu fen qie mian	1
膝关节单髁置换	xi guan jie dan ke zhi huan	1
膝关节骨水泥型	xi guan jie gu shui ni xing	1
膝关节矫形器	xi guan jie jiao xing qi	1
洗精培养液	xi jing pei yang ye	1
细菌快速血培养瓶	xi jun kuai su xue pei yang ping	1
细菌微量生化鉴定管	xi jun wei liang sheng hua jian ding guan	1
细菌性阴道炎试剂氨法	xi jun xing yin dao yan shi ji an fa	1
细菌性阴道炎试剂唾液酸酶法	xi jun xing yin dao yan shi ji tuo ye suan mei fa	1
细菌药敏试剂纸片	xi jun yao min shi ji zhi pian	1
细菌药敏纸片	xi jun yao min zhi pian	1
细菌诊断血清	xi jun zhen duan xue qing	1
细蜡线	xi la xian	1
膝离断大腿假肢	xi li duan da tui jia zhi	1
膝离断假肢	xi li duan jia zhi	1
系列髋关节假体	xi lie kuan guan jie jia ti	1
系列髋关节假体喷涂股骨柄	xi lie kuan guan jie jia ti pen tu gu gu bing	1
洗瓶刷	xi ping shua	1
洗手刷	xi shou shua	1
吸痰管	xi tan guan	1
吸痰装置	xi tan zhuang zhi	1
吸头	xi tou	1
吸唾管	xi tuo guan	1
洗胃管	xi wei guan	1
洗胃器	xi wei qi	1
系线镊	xi xian nie	1
吸氧面罩	xi yang mian zhao	1
洗衣机	xi yi ji	1
吸引连接管	xi yin lian jie guan	1
吸引器	xi yin qi	1
吸引器连接管	xi yin qi lian jie guan	1
下环钩	xia huan gou	1
下腔静脉滤器	xia qiang jing mai lv qi	1
下送下收车	xia song xia shou che	1
下送下收车封闭	xia song xia shou che feng bi	1
下肢断端固器	xia zhi duan duan gu qi	1
下肢股骨接钢板	xia zhi gu gu jie gang ban	1
下肢股骨接骨钢板	xia zhi gu gu jie gu gang ban	1
下肢加压钢板	xia zhi jia ya gang ban	1
下肢加压钢板不锈钢	xia zhi jia ya gang ban bu xiu gang	1
下肢加压钢板纯钛	xia zhi jia ya gang ban chun tai	1
下肢加压钢板钛合金	xia zhi jia ya gang ban tai he jin	1
下肢加压锁定钢板	xia zhi jia ya suo ding gang ban	1
下肢加压锁定钢板不锈钢	xia zhi jia ya suo ding gang ban bu xiu gang	1
下肢加压锁定钢板纯钛	xia zhi jia ya suo ding gang ban chun tai	1
下肢加压锁定钢板钛合金	xia zhi jia ya suo ding gang ban tai he jin	1
下肢接骨板	xia zhi jie gu ban	1
下肢接骨钢板	xia zhi jie gu gang ban	1
下肢皮质骨钛螺钉	xia zhi pi zhi gu tai luo ding	1
下肢全螺纹空心松质骨钛螺钉	xia zhi quan luo wen kong xin song zhi gu tai luo ding	1
下肢松质骨螺钉半螺纹	xia zhi song zhi gu luo ding ban luo wen	1
下肢松质骨螺钉全螺纹	xia zhi song zhi gu luo ding quan luo wen	1
下肢型接骨钢板	xia zhi xing jie gu gang ban	1
下肢形髁钢板	xia zhi xing ke gang ban	1
下肢远端钢板	xia zhi yuan duan gang ban	1
腺苷脱氨酶试剂	xian gan tuo an mei shi ji	1
线锯条	xian ju tiao	1
先天性心脏病封堵器及配件	xian tian xing xin zang bing feng du qi ji pei jian	1
线团	xian tuan	1
显微持针钳	xian wei chi zhen qian	1
纤维蛋白原测定盒	xian wei dan bai yuan ce ding he	1
纤维蛋白原测定试剂盒	xian wei dan bai yuan ce ding shi ji he	1
显微镜	xian wei jing	1
显微镜冷光源灯泡	xian wei jing leng guang yuan deng pao	1
纤维桩套装	xian wei zhuang tao zhuang	1
橡胶布	xiang jiao bu	1
橡胶导尿管	xiang jiao dao niao guan	1
橡胶管	xiang jiao guan	1
消毒包布	xiao du bao bu	1
消毒碘棉签	xiao du dian mian qian	1
消毒液	xiao du ye	1
小儿钢板	xiao er gang ban	1
小儿射频消融导管	xiao er she pin xiao rong dao guan	1
小儿血培养瓶	xiao er xue pei yang ping	1
小号吸嘴	xiao hao xi zui	1
消佳净	xiao jia jing	1
小胶布	xiao jiao bu	1
小腿假肢成人型	xiao tui jia zhi cheng ren xing	1
小腿假肢儿童型	xiao tui jia zhi er tong xing	1
小腿矫形器	xiao tui jiao xing qi	1
心包引流管	xin bao yin liu guan	1
锌测定试剂盒	xin ce ding shi ji he	1
心电电极贴	xin dian dian ji tie	1
心电监护电极	xin dian jian hu dian ji	1
心电图机	xin dian tu ji	1
心电图记录纸	xin dian tu ji lu zhi	1
心电图纸	xin dian tu zhi	1
心肺触诊电脑模拟人	xin fei chu zhen dian nao mo ni ren	1
心肌肌钙蛋白	xin ji ji gai dan bai	1
心肌酶谱	xin ji mei pu	1
心肌注射系统	xin ji zhu she xi tong	1
新洁尔灭苯扎溴铵	xin jie er mie ben zha xiu an	1
新生儿疾病筛查质控	xin sheng er ji bing shai cha zhi kong	1
新生儿脐贴	xin sheng er qi tie	1
新生儿筛查采血卡	xin sheng er shai cha cai xie ka	1
新生儿筛查采血针	xin sheng er shai cha cai xue zhen	1
新生儿筛查血滤纸片打孔支架	xin sheng er shai cha xue lv zhi pian da kong zhi jia	1
新生儿筛查专用乙醇	xin sheng er shai cha zhuan yong yi chun	1
心室电极心内膜除颤电极	xin shi dian ji xin nei mo chu chan dian ji	1
心外膜起搏导线	xin wai mo qi bo dao xian	1
心外膜起搏电极导线	xin wai mo qi bo dian ji dao xian	1
心血管补片	xin xue guan bu pian	1
心脏插管	xin zang cha guan	1
心脏固定器	xin zang gu ding qi	1
心脏介入长鞘组	xin zang jie ru chang qiao zu	1
心脏介入超滑导丝	xin zang jie ru chao hua dao si	1
心脏介入导引导管	xin zang jie ru dao yin dao guan	1
心脏介入导引导丝	xin zang jie ru dao yin dao si	1
心脏介入普通导丝	xin zang jie ru pu tong dao si	1
心脏介入普通鞘组	xin zang jie ru pu tong qiao zu	1
心脏介入特殊长鞘组	xin zang jie ru te shu chang qiao zu	1
心脏介入造影导管	xin zang jie ru zao ying dao guan	1
心脏介入造影导丝	xin zang jie ru zao ying dao si	1
心脏漂浮导管	xin zang piao fu dao guan	1
心脏起搏器	xin zang qi bo qi	1
心脏停博液灌注插管	xin zang ting bo ye guan zhu cha guan	1
型胆道引流管	xing dan dao yin liu guan	1
型低粘骨水泥注入器	xing di zhan gu shui ni zhu ru qi	1
型电热管	xing dian re guan	1
型电热管片	xing dian re guan pian	1
型钢板	xing gang ban	1
型勾	xing gou	1
型股骨柄金枪鱼柄	xing gu gu bing jin qiang yu bing	1
型管	xing guan	1
形管	xing guan	1
性激素结合球蛋白	xing ji su jie he qiu dan bai	1
型甲状腺引流管	xing jia zhuang xian yin liu guan	1
型接头	xing jie tou	1
型髋臼	xing kuan jiu	1
型脑钠肽	xing nao na tai	1
型脑钠肽定标液	xing nao na tai ding biao ye	1
型脑钠肽质控	xing nao na tai zhi kong	1
型球囊扩张导管	xing qiu nang kuo zhang dao guan	1
型心脏起搏器	xing xin zang qi bo qi	1
胸腹腔引流管	xiong fu qiang yin liu guan	1
胸骨钢丝线带针	xiong gu gang si xian dai zhen	1
胸廓固定带	xiong kuo gu ding dai	1
胸腔闭式引流瓶	xiong qiang bi shi yin liu ping	1
胸腔闭锁引流瓶	xiong qiang bi suo yin liu ping	1
胸腔撑开器	xiong qiang cheng kai qi	1
胸腔穿刺针	xiong qiang chuan ci zhen	1
胸腔镜冲洗吸引器带电钩	xiong qiang jing chong xi xi yin qi dai dian gou	1
胸腔引流管	xiong qiang yin liu guan	1
胸腔引流管硅胶	xiong qiang yin liu guan gui jiao	1
胸腰椎后路侧方横突钩含附件	xiong yao zhui hou lu ce fang heng tu gou han fu jian	1
胸腰椎后路侧方偏体钩含附件	xiong yao zhui hou lu ce fang pian ti gou han fu jian	1
胸腰椎后路侧方椎板钩含附件	xiong yao zhui hou lu ce fang zhui ban gou han fu jian	1
胸腰椎后路侧方椎弓根钩含附件	xiong yao zhui hou lu ce fang zhui gong gen gou han fu jian	1
胸腰椎后路创伤钉板系统不锈钢	xiong yao zhui hou lu chuang shang ding ban xi tong bu xiu gang	1
胸腰椎后路创伤钉板系统纯钛	xiong yao zhui hou lu chuang shang ding ban xi tong chun tai	1
胸腰椎后路创伤钉板系统钛合金	xiong yao zhui hou lu chuang shang ding ban xi tong tai he jin	1
胸腰椎后路创伤钉棒系统不锈钢	xiong yao zhui hou lu chuang shang ding bang xi tong bu xiu gang	1
胸腰椎后路创伤钉棒系统纯钛	xiong yao zhui hou lu chuang shang ding bang xi tong chun tai	1
胸腰椎后路创伤钉棒系统钛合金	xiong yao zhui hou lu chuang shang ding bang xi tong tai he jin	1
胸腰椎后路钉板系统	xiong yao zhui hou lu ding ban xi tong	1
胸腰椎后路钉板系统固定钉	xiong yao zhui hou lu ding ban xi tong gu ding ding	1
胸腰椎后路钉板系统自攻固定钉	xiong yao zhui hou lu ding ban xi tong zi gong gu ding ding	1
胸腰椎后路钉棒系统	xiong yao zhui hou lu ding bang xi tong	1
胸腰椎后路钉棒系统固定弯棒	xiong yao zhui hou lu ding bang xi tong gu ding wan bang	1
胸腰椎后路钉棒系统固定直棒	xiong yao zhui hou lu ding bang xi tong gu ding zhi bang	1
胸腰椎后路钉棒椎弓根矫形系统	xiong yao zhui hou lu ding bang zhui gong gen jiao xing xi tong	1
胸腰椎后路钢棒系统	xiong yao zhui hou lu gang bang xi tong	1
胸腰椎后路钩棒系统	xiong yao zhui hou lu gou bang xi tong	1
胸腰椎后路钩棒系统不锈钢	xiong yao zhui hou lu gou bang xi tong bu xiu gang	1
胸腰椎后路钩棒系统纯钛	xiong yao zhui hou lu gou bang xi tong chun tai	1
胸腰椎后路钩棒系统钛合金	xiong yao zhui hou lu gou bang xi tong tai he jin	1
胸腰椎后路固定板	xiong yao zhui hou lu gu ding ban	1
胸腰椎后路骨折钢棒系统	xiong yao zhui hou lu gu zhe gang bang xi tong	1
胸腰椎后路滑脱钉板系统	xiong yao zhui hou lu hua tuo ding ban xi tong	1
胸腰椎后路滑脱钉板系统不锈钢	xiong yao zhui hou lu hua tuo ding ban xi tong bu xiu gang	1
胸腰椎后路滑脱钉板系统钛合金	xiong yao zhui hou lu hua tuo ding ban xi tong tai he jin	1
胸腰椎后路滑脱钉棒系统	xiong yao zhui hou lu hua tuo ding bang xi tong	1
胸腰椎后路滑脱钉棒系统不锈钢	xiong yao zhui hou lu hua tuo ding bang xi tong bu xiu gang	1
胸腰椎后路滑脱钉棒系统钛合金	xiong yao zhui hou lu hua tuo ding bang xi tong tai he jin	1
胸腰椎后路滑脱钢板系统	xiong yao zhui hou lu hua tuo gang ban xi tong	1
胸腰椎后路经椎间孔椎间融合器	xiong yao zhui hou lu jing zhui jian kong zhui jian rong he qi	1
胸腰椎后路上开口横突钩含附件	xiong yao zhui hou lu shang kai kou heng tu gou han fu jian	1
胸腰椎后路上开口偏体钩含附件	xiong yao zhui hou lu shang kai kou pian ti gou han fu jian	1
胸腰椎后路上开口椎板钩含附件	xiong yao zhui hou lu shang kai kou zhui ban gou han fu jian	1
胸腰椎后路微创钢棒含附件	xiong yao zhui hou lu wei chuang gang bang han fu jian	1
胸腰椎后路微创螺钉含附件	xiong yao zhui hou lu wei chuang luo ding han fu jian	1
胸腰椎后路椎间融合器	xiong yao zhui hou lu zhui jian rong he qi	1
胸腰椎后路椎间旋入式融合器	xiong yao zhui hou lu zhui jian xuan ru shi rong he qi	1
胸腰椎后路椎间置入式融合器	xiong yao zhui hou lu zhui jian zhi ru shi rong he qi	1
胸腰椎前路板	xiong yao zhui qian lu ban	1
胸腰椎前路单杆钉棒系统	xiong yao zhui qian lu dan gan ding bang xi tong	1
胸腰椎前路单杆钉棒系统不锈钢	xiong yao zhui qian lu dan gan ding bang xi tong bu xiu gang	1
胸腰椎前路单杆钉棒系统钛合金	xiong yao zhui qian lu dan gan ding bang xi tong tai he jin	1
胸腰椎前路钉板固定螺钉含组件	xiong yao zhui qian lu ding ban gu ding luo ding han zu jian	1
胸腰椎前路钉板固定螺栓含组件	xiong yao zhui qian lu ding ban gu ding luo shuan han zu jian	1
胸腰椎前路钉板系统	xiong yao zhui qian lu ding ban xi tong	1
胸腰椎前路钉板系统不锈钢	xiong yao zhui qian lu ding ban xi tong bu xiu gang	1
胸腰椎前路钉板系统钛合金	xiong yao zhui qian lu ding ban xi tong tai he jin	1
胸腰椎前路钉棒系统	xiong yao zhui qian lu ding bang xi tong	1
胸腰椎前路钉棒系统垫片	xiong yao zhui qian lu ding bang xi tong dian pian	1
胸腰椎前路钉棒系统双棒连接器	xiong yao zhui qian lu ding bang xi tong shuang bang lian jie qi	1
胸腰椎前路固定棒直径以上含	xiong yao zhui qian lu gu ding bang zhi jing yi shang han	1
胸腰椎前路固定棒直径以下	xiong yao zhui qian lu gu ding bang zhi jing yi xia	1
胸腰椎前路双杆钉棒系统	xiong yao zhui qian lu shuang gan ding bang xi tong	1
胸腰椎前路双杆钉棒系统不锈钢	xiong yao zhui qian lu shuang gan ding bang xi tong bu xiu gang	1
胸腰椎前路双杆钉棒系统钛合金	xiong yao zhui qian lu shuang gan ding bang xi tong tai he jin	1
胸腰椎前路椎间金属融合器	xiong yao zhui qian lu zhui jian jin shu rong he qi	1
胸腰椎前路椎间人工骨融合器	xiong yao zhui qian lu zhui jian ren gong gu rong he qi	1
胸腰椎前路椎间融合器	xiong yao zhui qian lu zhui jian rong he qi	1
胸腰椎前路椎间碳纤维融合器	xiong yao zhui qian lu zhui jian tan xian wei rong he qi	1
胸腰椎椎间融合器	xiong yao zhui zhui jian rong he qi	1
胸主动脉覆膜支架系统近端主体	xiong zhu dong mai fu mo zhi jia xi tong jin duan zhu ti	1
胸主动脉覆膜支架系统延长段	xiong zhu dong mai fu mo zhi jia xi tong yan chang duan	1
胸主动脉覆膜支架系统远端主体	xiong zhu dong mai fu mo zhi jia xi tong yuan duan zhu ti	1
胸主动脉瘤血管内支架系统	xiong zhu dong mai liu xue guan nei zhi jia xi tong	1
戌二醛浓度测试纸	xu er quan nong du ce shi zhi	1
悬吊式硬晶体	xuan diao shi ying jing ti	1
旋毛虫抗体	xuan mao chong kang ti	1
旋切血栓导管	xuan qie xue shuan dao guan	1
旋入钉	xuan ru ding	1
选择性巧克培养基	xuan ze xing qiao ke pei yang ji	1
选择型血管造影导管	xuan ze xing xue guan zao ying dao guan	1
旋转平台全膝关节	xuan zhuan ping tai quan xi guan jie	1
旋转平台膝关节	xuan zhuan ping tai xi guan jie	1
旋转平台型关节假体	xuan zhuan ping tai xing guan jie jia ti	1
旋转平台型全膝	xuan zhuan ping tai xing quan xi	1
血氨	xue an	1
血氨测定试剂	xue an ce ding shi ji	1
血沉架	xue chen jia	1
血袋	xue dai	1
血仿膜透析器	xue fang mo tou xi qi	1
血管闭合器	xue guan bi he qi	1
血管长鞘组	xue guan chang qiao zu	1
血管紧张素	xue guan jin zhang su	1
血管滤器	xue guan lv qi	1
血管内超声导管	xue guan nei chao sheng dao guan	1
血管内放疗导管	xue guan nei fang liao dao guan	1
血管内造影导管	xue guan nei zao ying dao guan	1
血管普通鞘组	xue guan pu tong qiao zu	1
血管钛夹	xue guan tai jia	1
血管造影导管	xue guan zao ying dao guan	1
血管支架	xue guan zhi jia	1
血管支架镍钛合金支架	xue guan zhi jia nie tai he jin zhi jia	1
血管自膨式支架	xue guan zi peng shi zhi jia	1
血红蛋白电泳检查试剂	xue hong dan bai dian yong jian cha shi ji	1
血红蛋白电泳介面液	xue hong dan bai dian yong jie mian ye	1
血红蛋白吸管	xue hong dan bai xi guan	1
血浆分离器	xue jiang fen li qi	1
血浆分离器透析用	xue jiang fen li qi tou xi yong	1
血滤机专用连接导管	xue lv ji zhuan yong lian jie dao guan	1
血滤器	xue lv qi	1
血滤器合成膜	xue lv qi he cheng mo	1
血凝仪专用试剂	xue ning yi zhuan yong shi ji	1
血平板	xue ping ban	1
血气分析仪试剂及洗液	xue qi fen xi yi shi ji ji xi ye	1
血气毛细采血管	xue qi mao xi cai xie guan	1
血清	xue qing	1
血清蛋白电泳检验试剂	xue qing dan bai dian yong jian yan shi ji	1
血清抗环瓜氨酸肽抗体	xue qing kang huan gua an suan tai kang ti	1
血清铁	xue qing tie	1
血清载脂蛋白	xue qing zai zhi dan bai	1
血球定标液	xue qiu ding biao ye	1
血球计数仪试剂	xue qiu ji shu yi shi ji	1
血球计数仪专用试剂	xue qiu ji shu yi zhuan yong shi ji	1
血球清洗液	xue qiu qing xi ye	1
血球稀释液	xue qiu xi shi ye	1
血球质控液	xue qiu zhi kong ye	1
血容量监测导管	xue rong liang jian ce dao guan	1
血容器	xue rong qi	1
血栓抽吸导管	xue shuan chou xi dao guan	1
血丝牙托粉	xue si ya tuo fen	1
血糖	xue tang	1
血糖测定仪	xue tang ce ding yi	1
血糖试纸	xue tang shi zhi	1
血糖试纸条	xue tang shi zhi tiao	1
血透包	xue tou bao	1
血透压力传感器	xue tou ya li chuan gan qi	1
血透用留置导管	xue tou yong liu zhi dao guan	1
血透用双腔留置导管长期	xue tou yong shuang qiang liu zhi dao guan chang qi	1
血透用双腔留置导管临时	xue tou yong shuang qiang liu zhi dao guan lin shi	1
血吸虫抗体	xue xi chong kang ti	1
血小板源性生长因子试剂	xue xiao ban yuan xing sheng zhang yin zi shi ji	1
血型定型试剂	xue xing ding xing shi ji	1
血型定型试剂血站用	xue xing ding xing shi ji xue zhan yong	1
血压计	xue ya ji	1
血压计玻璃管	xue ya ji bo li guan	1
血压计气囊	xue ya ji qi nang	1
血压计袖袋	xue ya ji xiu dai	1
血压器	xue ya qi	1
血液保存液	xue ye bao cun ye	1
血液灌流器	xue ye guan liu qi	1
血液灌流器活性碳	xue ye guan liu qi huo xing tan	1
血液灌流器树脂	xue ye guan liu qi shu zhi	1
血液过滤器	xue ye guo lv qi	1
血液回收耗材	xue ye hui shou hao cai	1
血液透析粉	xue ye tou xi fen	1
血液透析液粉	xue ye tou xi ye fen	1
血液增菌培养	xue ye zeng jun pei yang	1
血液增菌培养液	xue ye zeng jun pei yang ye	1
循环免疫复合物	xun huan mian yi fu he wu	1
牙齿邻面片切沙片	ya chi lin mian pian qie sha pian	1
牙弓夹板	ya gong jia ban	1
牙骨凿	ya gu zao	1
牙冠雕刻顺序模型	ya guan diao ke shun xu mo xing	1
牙合机	ya he ji	1
牙胶	ya jiao	1
牙胶尖	ya jiao jian	1
牙科模拟实习系统	ya ke mo ni shi xi xi tong	1
牙科综合治疗机	ya ke zong he zhi liao ji	1
压力导丝	ya li dao si	1
压力换能器传感器	ya li huan neng qi chuan gan qi	1
压力连接管长管	ya li lian jie guan chang guan	1
压力连接管短管	ya li lian jie guan duan guan	1
压力延长管	ya li yan chang guan	1
压力蒸汽灭菌化学指示胶带	ya li zheng qi mie jun hua xue zhi shi jiao dai	1
压力蒸汽灭菌化学指示纸卡标签	ya li zheng qi mie jun hua xue zhi shi zhi ka biao qian	1
压力蒸汽灭菌生物指示剂	ya li zheng qi mie jun sheng wu zhi shi ji	1
压配式球形臼	ya pei shi qiu xing jiu	1
压配式球形臼标准型	ya pei shi qiu xing jiu biao zhun xing	1
压配式球形臼标准型臼衬	ya pei shi qiu xing jiu biao zhun xing jiu chen	1
压配式球形臼防脱位型	ya pei shi qiu xing jiu fang tuo wei xing	1
压配式球形臼防脱位型臼衬	ya pei shi qiu xing jiu fang tuo wei xing jiu chen	1
压配式球形臼罩	ya pei shi qiu xing jiu zhao	1
牙片机	ya pian ji	1
鸦片检测试剂	ya pian jian ce shi ji	1
压舌板	ya she ban	1
牙托	ya tuo	1
牙托粉	ya tuo fen	1
牙托水	ya tuo shui	1
牙用不锈钢丝	ya yong bu xiu gang si	1
牙用不锈钢线	ya yong bu xiu gang xian	1
牙用镊	ya yong nie	1
牙周病分解模型	ya zhou bing fen jie mo xing	1
牙周病分类模型	ya zhou bing fen lei mo xing	1
牙周塞治剂	ya zhou sai zhi ji	1
研钵	yan bo	1
延长导丝	yan chang dao si	1
延长接管静脉	yan chang jie guan jing mai	1
研光器	yan guang qi	1
眼科剪	yan ke jian	1
眼科球后针头	yan ke qiu hou zhen tou	1
眼科手术巾	yan ke shou shu jin	1
眼科手术染色剂	yan ke shou shu ran se ji	1
眼科手术用硅油	yan ke shou shu yong gui you	1
眼科手术用重水	yan ke shou shu yong zhong shui	1
眼科无损伤线	yan ke wu sun shang xian	1
眼科用手术粘贴巾	yan ke yong shou shu zhan tie jin	1
盐水接头	yan shui jie tou	1
盐酸槽印模膏	yan suan cao yin mo gao	1
厌氧菌鉴定卡	yan yang jun jian ding ka	1
眼用灌注液	yan yong guan zhu ye	1
眼用填充气体	yan yong tian chong qi ti	1
眼用粘弹剂	yan yong zhan dan ji	1
岩藻糖苷酶	yan zao tang gan mei	1
岩澡糖苷酶	yan zao tang gan mei	1
岩澡糖苷酶试剂盒	yan zao tang gan mei shi ji he	1
羊肠线	yang chang xian	1
阳光系列支架	yang guang xi lie zhi jia	1
氧化汞	yang hua gong	1
氧化铝内衬	yang hua lv nei chen	1
氧化铝陶瓷股骨头	yang hua lv tao ci gu gu tou	1
氧化酶纸片	yang hua mei zhi pian	1
氧化锌	yang hua xin	1
氧力表	yang li biao	1
氧气袋	yang qi dai	1
羊水细胞培养瓶	yang shui xi bao pei yang ping	1
羊水细胞染色体培养基	yang shui xi bao ran se ti pei yang ji	1
羊血	yang xue	1
药车	yao che	1
药匙	yao chi	1
腰大池穿刺置管引流装置	yao da chi chuan ci zhi guan yin liu zhuang zhi	1
药膏罐	yao gao guan	1
咬骨剪	yao gu jian	1
咬合纸	yao he zhi	1
腰脊术	yao ji shu	1
药敏琼脂干粉	yao min qiong zhi gan fen	1
药敏纸片	yao min zhi pian	1
药品车	yao pin che	1
药品柜	yao pin gui	1
腰围	yao wei	1
药物洗脱支架	yao wu xi tuo zhi jia	1
药物支架	yao wu zhi jia	1
摇椅方丝	yao yi fang si	1
摇椅圆丝	yao yi yuan si	1
腰椎穿刺包	yao zhui chuan ci bao	1
腋臭衣	ye chou yi	1
液基细胞试剂	ye ji xi bao shi ji	1
叶酸检测试剂	ye suan jian ce shi ji	1
液体生化质控血清	ye ti sheng hua zhi kong xue qing	1
一步法促进剂	yi bu fa cu jin ji	1
义齿	yi chi	1
义齿坚固网	yi chi jian gu wang	1
乙醇	yi chun	1
乙醇检测试剂	yi chun jian ce shi ji	1
一次使用精密储尿器	yi ci shi yong jing mi chu niao qi	1
一次使用男性假性尿袋	yi ci shi yong nan xing jia xing niao dai	1
一次性按键式电刀笔	yi ci xing an jian shi dian dao bi	1
一次性备皮包	yi ci xing bei pi bao	1
一次性避光输液器	yi ci xing bi guang shu ye qi	1
一次性闭孔子系统	yi ci xing bi kong zi xi tong	1
一次性比色杯	yi ci xing bi se bei	1
一次性鼻胃肠管肠内营养管	yi ci xing bi wei chang guan chang nei ying yang guan	1
一次性便盆	yi ci xing bian pen	1
一次性病理切片	yi ci xing bing li qie pian	1
一次性玻璃试管	yi ci xing bo li shi guan	1
一次性采血器	yi ci xing cai xue qi	1
一次性采血针	yi ci xing cai xue zhen	1
一次性侧侧吻合器	yi ci xing ce ce wen he qi	1
一次性产包通用型	yi ci xing chan bao tong yong xing	1
一次性肠道营养重力滴注管	yi ci xing chang dao ying yang zhong li di zhu guan	1
一次性肠内营养输注泵管	yi ci xing chang nei ying yang shu zhu beng guan	1
一次性齿科胶片	yi ci xing chi ke jiao pian	1
一次性持续给药输液泵	yi ci xing chi xu gei yao shu ye beng	1
一次性储血滤血器	yi ci xing chu xue lv xue qi	1
一次性穿刺器	yi ci xing chuan ci qi	1
一次性穿刺针	yi ci xing chuan ci zhen	1
一次性床单	yi ci xing chuang dan	1
一次性单腔导尿管	yi ci xing dan qiang dao niao guan	1
一次性单腔导尿管成人用	yi ci xing dan qiang dao niao guan cheng ren yong	1
一次性单腔导尿管儿童用	yi ci xing dan qiang dao niao guan er tong yong	1
一次性导丝	yi ci xing dao si	1
一次性电刀笔	yi ci xing dian dao bi	1
一次性防护服	yi ci xing fang hu fu	1
一次性防护口罩	yi ci xing fang hu kou zhao	1
一次性防护帽	yi ci xing fang hu mao	1
一次性腹带	yi ci xing fu dai	1
一次性妇检垫	yi ci xing fu jian dian	1
一次性干式激光胶片	yi ci xing gan shi ji guang jiao pian	1
一次性肝素帽	yi ci xing gan su mao	1
一次性肛管	yi ci xing gang guan	1
一次性高压注射筒	yi ci xing gao ya zhu she tong	1
一次性管型吻合器	yi ci xing guan xing wen he qi	1
一次性冠状动脉刀头	yi ci xing guan zhuang dong mai dao tou	1
一次性硅胶胃管	yi ci xing gui jiao wei guan	1
一次性氦氖激光胶片	yi ci xing hai nai ji guang jiao pian	1
一次性红外激光胶片	yi ci xing hong wai ji guang jiao pian	1
一次性喉罩	yi ci xing hou zhao	1
一次性换药包	yi ci xing huan yao bao	1
一次性换药盆	yi ci xing huan yao pen	1
一次性回路板电极负极板	yi ci xing hui lu ban dian ji fu ji ban	1
一次性会阴抹洗包	yi ci xing hui yin mo xi bao	1
一次性监护电极	yi ci xing jian hu dian ji	1
一次性静脉营养袋	yi ci xing jing mai ying yang dai	1
一次性静脉营养滤器	yi ci xing jing mai ying yang lv qi	1
一次性抗凝吸引器管	yi ci xing kang ning xi yin qi guan	1
一次性可调节避光输液器	yi ci xing ke tiao jie bi guang shu ye qi	1
一次性可调节普通输液器	yi ci xing ke tiao jie pu tong shu ye qi	1
一次性口腔包	yi ci xing kou qiang bao	1
一次性口腔护理包	yi ci xing kou qiang hu li bao	1
一次性口腔检查包	yi ci xing kou qiang jian cha bao	1
一次性口腔器械盒	yi ci xing kou qiang qi xie he	1
一次性口罩	yi ci xing kou zhao	1
一次性窥器	yi ci xing kui qi	1
一次性扩阴器	yi ci xing kuo yin qi	1
一次性离心管	yi ci xing li xin guan	1
一次性离心碗	yi ci xing li xin wan	1
一次性联合麻醉包	yi ci xing lian he ma zui bao	1
一次性连接导管	yi ci xing lian jie dao guan	1
一次性颅钻套	yi ci xing lu zuan tao	1
一次性螺纹管	yi ci xing luo wen guan	1
一次性麻醉穿刺针	yi ci xing ma zui chuan ci zhen	1
一次性麻醉面罩	yi ci xing ma zui mian zhao	1
一次性帽子	yi ci xing mao zi	1
一次性棉签	yi ci xing mian qian	1
一次性尿杯	yi ci xing niao bei	1
一次性尿沉渣离心管	yi ci xing niao chen zha li xin guan	1
一次性尿垫	yi ci xing niao dian	1
一次性尿壶	yi ci xing niao hu	1
一次性尿裤	yi ci xing niao ku	1
一次性尿试管	yi ci xing niao shi guan	1
一次性培养皿	yi ci xing pei yang min	1
一次性皮肤缝合器	yi ci xing pi fu feng he qi	1
一次性皮肤缝合器及缝合钉	yi ci xing pi fu feng he qi ji feng he ding	1
一次性漂浮导管	yi ci xing piao fu dao guan	1
一次性普通医用吸氧面罩	yi ci xing pu tong yi yong xi yang mian zhao	1
一次性气管导管	yi ci xing qi guan dao guan	1
一次性气管切开插管	yi ci xing qi guan qie kai cha guan	1
一次性切割缝合器	yi ci xing qie ge feng he qi	1
一次性切开包	yi ci xing qie kai bao	1
一次性取精杯	yi ci xing qu jing bei	1
一次性全景胶片	yi ci xing quan jing jiao pian	1
一次性全麻包	yi ci xing quan ma bao	1
一次性乳腺定位导丝	yi ci xing ru xian ding wei dao si	1
一次性乳腺定位针	yi ci xing ru xian ding wei zhen	1
一次性乳腺胶片	yi ci xing ru xian jiao pian	1
一次性三腔气囊导管	yi ci xing san qiang qi nang dao guan	1
一次性三腔气囊导尿管	yi ci xing san qiang qi nang dao niao guan	1
一次性三腔气囊导尿管成人用	yi ci xing san qiang qi nang dao niao guan cheng ren yong	1
一次性三腔气囊导尿管儿童用	yi ci xing san qiang qi nang dao niao guan er tong yong	1
一次性三向瓣膜式管	yi ci xing san xiang ban mo shi guan	1
一次性三用喷枪	yi ci xing san yong pen qiang	1
一次性神经阻滞麻醉包	yi ci xing shen jing zu zhi ma zui bao	1
一次性使用备皮包	yi ci xing shi yong bei pi bao	1
一次性使用鼻饲营养管	yi ci xing shi yong bi si ying yang guan	1
一次性使用采血针	yi ci xing shi yong cai xue zhen	1
一次性使用产包	yi ci xing shi yong chan bao	1
一次性使用袋式输液器	yi ci xing shi yong dai shi shu ye qi	1
一次性使用导光鼻塞	yi ci xing shi yong dao guang bi se	1
一次性使用导尿包	yi ci xing shi yong dao niao bao	1
一次性使用导尿袋	yi ci xing shi yong dao niao dai	1
一次性使用导尿管	yi ci xing shi yong dao niao guan	1
一次性使用垫巾	yi ci xing shi yong dian jin	1
一次性使用垫巾单	yi ci xing shi yong dian jin dan	1
一次性使用定量采血吸管	yi ci xing shi yong ding liang cai xie xi guan	1
一次性使用洞巾	yi ci xing shi yong dong jin	1
一次性使用动静脉留置针	yi ci xing shi yong dong jing mai liu zhi zhen	1
一次性使用动脉留置针	yi ci xing shi yong dong mai liu zhi zhen	1
一次性使用负压引流袋	yi ci xing shi yong fu ya yin liu dai	1
一次性使用负压引流器	yi ci xing shi yong fu ya yin liu qi	1
一次性使用负压引流球	yi ci xing shi yong fu ya yin liu qiu	1
一次性使用肝素帽	yi ci xing shi yong gan su mao	1
一次性使用肛门袋	yi ci xing shi yong gang men dai	1
一次性使用骨髓穿刺包	yi ci xing shi yong gu sui chuan ci bao	1
一次性使用混合碗	yi ci xing shi yong hun he wan	1
一次性使用胫骨骨髓穿刺针	yi ci xing shi yong jing gu gu sui chuan ci zhen	1
一次性使用静脉留置针	yi ci xing shi yong jing mai liu zhi zhen	1
一次性使用静脉输液针	yi ci xing shi yong jing mai shu ye zhen	1
一次性使用静脉营养袋	yi ci xing shi yong jing mai ying yang dai	1
一次性使用静脉营养输液袋	yi ci xing shi yong jing mai ying yang shu ye dai	1
一次性使用精密输液器	yi ci xing shi yong jing mi shu ye qi	1
一次性使用精细输液器	yi ci xing shi yong jing xi shu ye qi	1
一次性使用孔洞巾	yi ci xing shi yong kong dong jin	1
一次性使用口罩	yi ci xing shi yong kou zhao	1
一次性使用口罩帽子	yi ci xing shi yong kou zhao mao zi	1
一次性使用颅脑外引流器	yi ci xing shi yong lu nao wai yin liu qi	1
一次性使用颅内血肿粉碎穿刺针	yi ci xing shi yong lu nei xue zhong fen sui chuan ci zhen	1
一次性使用麻醉包联合麻醉	yi ci xing shi yong ma zui bao lian he ma zui	1
一次性使用麻醉包腰椎麻醉	yi ci xing shi yong ma zui bao yao zhui ma zui	1
一次性使用麻醉包硬膜外麻醉	yi ci xing shi yong ma zui bao ying mo wai ma zui	1
一次性使用麻醉气体过滤器	yi ci xing shi yong ma zui qi ti guo lv qi	1
一次性使用麻醉气体净化器	yi ci xing shi yong ma zui qi ti jing hua qi	1
一次性使用帽子	yi ci xing shi yong mao zi	1
一次性使用灭菌保护膜手术围裙	yi ci xing shi yong mie jun bao hu mo shou shu wei qun	1
一次性使用灭菌注射器	yi ci xing shi yong mie jun zhu she qi	1
一次性使用膜胶带	yi ci xing shi yong mo jiao dai	1
一次性使用镊子	yi ci xing shi yong nie zi	1
一次性使用膀胱冲洗器	yi ci xing shi yong pang guang chong xi qi	1
一次性使用普通胃管	yi ci xing shi yong pu tong wei guan	1
一次性使用腔镜套管穿刺套件	yi ci xing shi yong qiang jing tao guan chuan ci tao jian	1
一次性使用溶药注射器	yi ci xing shi yong rong yao zhu she qi	1
一次性使用溶药注射器配针头	yi ci xing shi yong rong yao zhu she qi pei zhen tou	1
一次性使用三通阀	yi ci xing shi yong san tong fa	1
一次性使用石英输液器	yi ci xing shi yong shi ying shu ye qi	1
一次性使用手术巾	yi ci xing shi yong shou shu jin	1
一次性使用输血管	yi ci xing shi yong shu xue guan	1
一次性使用输血器	yi ci xing shi yong shu xue qi	1
一次性使用输血器塑针吹塑滴斗	yi ci xing shi yong shu xue qi su zhen chui su di dou	1
一次性使用输血器塑针注塑滴斗	yi ci xing shi yong shu xue qi su zhen zhu su di dou	1
一次性使用输氧管输出管加鼻塞	yi ci xing shi yong shu yang guan shu chu guan jia bi se	1
一次性使用输液管	yi ci xing shi yong shu ye guan	1
一次性使用输液器	yi ci xing shi yong shu ye qi	1
一次性使用输液器塑针吹塑滴斗	yi ci xing shi yong shu ye qi su zhen chui su di dou	1
一次性使用输液器塑针注塑滴斗	yi ci xing shi yong shu ye qi su zhen zhu su di dou	1
一次性使用输液延长管	yi ci xing shi yong shu ye yan chang guan	1
一次性使用头皮针	yi ci xing shi yong tou pi zhen	1
一次性使用弯盘	yi ci xing shi yong wan pan	1
一次性使用胃包	yi ci xing shi yong wei bao	1
一次性使用胃管鼻饲管	yi ci xing shi yong wei guan bi si guan	1
一次性使用胃管成人用	yi ci xing shi yong wei guan cheng ren yong	1
一次性使用胃管儿童用	yi ci xing shi yong wei guan er tong yong	1
一次性使用无纺布口罩大中小	yi ci xing shi yong wu fang bu kou zhao da zhong xiao	1
一次性使用无纺布帽子大中小	yi ci xing shi yong wu fang bu mao zi da zhong xiao	1
一次性使用无菌避光延长管	yi ci xing shi yong wu jun bi guang yan chang guan	1
一次性使用无菌避光注射器	yi ci xing shi yong wu jun bi guang zhu she qi	1
一次性使用无菌导尿包	yi ci xing shi yong wu jun dao niao bao	1
一次性使用无菌导引导管	yi ci xing shi yong wu jun dao yin dao guan	1
一次性使用无菌滴定管式输液器	yi ci xing shi yong wu jun di ding guan shi shu ye qi	1
一次性使用无菌腹腔穿刺包	yi ci xing shi yong wu jun fu qiang chuan ci bao	1
一次性使用无菌灌肠袋	yi ci xing shi yong wu jun guan chang dai	1
一次性使用无菌配药注射器带针	yi ci xing shi yong wu jun pei yao zhu she qi dai zhen	1
一次性使用无菌手术衣	yi ci xing shi yong wu jun shou shu yi	1
一次性使用无菌输液器	yi ci xing shi yong wu jun shu ye qi	1
一次性使用无菌小儿输液器	yi ci xing shi yong wu jun xiao er shu ye qi	1
一次性使用无菌胸腔穿刺包	yi ci xing shi yong wu jun xiong qiang chuan ci bao	1
一次性使用无菌血袋	yi ci xing shi yong wu jun xue dai	1
一次性使用无菌腰椎穿刺包	yi ci xing shi yong wu jun yao zhui chuan ci bao	1
一次性使用无菌阴道扩张器	yi ci xing shi yong wu jun yin dao kuo zhang qi	1
一次性使用无菌针头	yi ci xing shi yong wu jun zhen tou	1
一次性使用无菌注射器	yi ci xing shi yong wu jun zhu she qi	1
一次性使用无菌注射器带针	yi ci xing shi yong wu jun zhu she qi dai zhen	1
一次性使用无菌注射器甘油型	yi ci xing shi yong wu jun zhu she qi gan you xing	1
一次性使用无菌注射器配针头	yi ci xing shi yong wu jun zhu she qi pei zhen tou	1
一次性使用无菌注射针	yi ci xing shi yong wu jun zhu she zhen	1
一次性使用吸痰管	yi ci xing shi yong xi tan guan	1
一次性使用吸引器连接管	yi ci xing shi yong xi yin qi lian jie guan	1
一次性使用吸引头	yi ci xing shi yong xi yin tou	1
一次性使用吸引装置袋	yi ci xing shi yong xi yin zhuang zhi dai	1
一次性使用心外吸引管	yi ci xing shi yong xin wai xi yin guan	1
一次性使用心脏停博液灌注管路	yi ci xing shi yong xin zang ting bo ye guan zhu guan lu	1
一次性使用胸腔引流瓶	yi ci xing shi yong xiong qiang yin liu ping	1
一次性使用血浆袋	yi ci xing shi yong xue jiang dai	1
一次性使用血浆分离器	yi ci xing shi yong xue jiang fen li qi	1
一次性使用血细胞分离器	yi ci xing shi yong xue xi bao fen li qi	1
一次性使用血液灌流器	yi ci xing shi yong xue ye guan liu qi	1
一次性使用压力传感器	yi ci xing shi yong ya li chuan gan qi	1
一次性使用眼科手术刀	yi ci xing shi yong yan ke shou shu dao	1
一次性使用氧气输出管	yi ci xing shi yong yang qi shu chu guan	1
一次性使用医用床单	yi ci xing shi yong yi yong chuang dan	1
一次性使用医用棉签	yi ci xing shi yong yi yong mian qian	1
一次性使用医用粘贴薄膜手术巾	yi ci xing shi yong yi yong zhan tie bo mo shou shu jin	1
一次性使用医用治疗巾	yi ci xing shi yong yi yong zhi liao jin	1
一次性使用医用中单	yi ci xing shi yong yi yong zhong dan	1
一次性使用引流袋	yi ci xing shi yong yin liu dai	1
一次性使用真空采血管	yi ci xing shi yong zhen kong cai xie guan	1
一次性使用真空采血器	yi ci xing shi yong zhen kong cai xue qi	1
一次性使用真空采血针	yi ci xing shi yong zhen kong cai xue zhen	1
一次性使用中单	yi ci xing shi yong zhong dan	1
一次性使用注射器	yi ci xing shi yong zhu she qi	1
一次性使用子宫造影通水管	yi ci xing shi yong zi gong zao ying tong shui guan	1
一次性使用自毁式注射器	yi ci xing shi yong zi hui shi zhu she qi	1
一次性使用自毁性注射器	yi ci xing shi yong zi hui xing zhu she qi	1
一次性使用自毁性注射器配针头	yi ci xing shi yong zi hui xing zhu she qi pei zhen tou	1
一次性手套	yi ci xing shou tao	1
一次性输氧管	yi ci xing shu yang guan	1
一次性输液加温袋	yi ci xing shu ye jia wen dai	1
一次性输液加温延长管	yi ci xing shu ye jia wen yan chang guan	1
一次性输液贴	yi ci xing shu ye tie	1
一次性双腔气囊导尿管	yi ci xing shuang qiang qi nang dao niao guan	1
一次性双腔气囊导尿管成人用	yi ci xing shuang qiang qi nang dao niao guan cheng ren yong	1
一次性双腔气囊导尿管儿童用	yi ci xing shuang qiang qi nang dao niao guan er tong yong	1
一次性双腔气中导尿管	yi ci xing shuang qiang qi zhong dao niao guan	1
一次性塑料薄膜手套	yi ci xing su liao bao mo shou tao	1
一次性塑料滴管	yi ci xing su liao di guan	1
一次性塑料试管	yi ci xing su liao shi guan	1
一次性塑料吸管	yi ci xing su liao xi guan	1
一次性痰杯	yi ci xing tan bei	1
一次性头皮夹	yi ci xing tou pi jia	1
一次性头皮针	yi ci xing tou pi zhen	1
一次性弯盘	yi ci xing wan pan	1
一次性微量泵延长管	yi ci xing wei liang beng yan chang guan	1
一次性无菌输液管	yi ci xing wu jun shu ye guan	1
一次性无菌输液接头	yi ci xing wu jun shu ye jie tou	1
一次性无菌痰杯	yi ci xing wu jun tan bei	1
一次性无菌注射针	yi ci xing wu jun zhu she zhen	1
一次性吸痰管	yi ci xing xi tan guan	1
一次性吸氧管	yi ci xing xi yang guan	1
一次性吸引器袋	yi ci xing xi yin qi dai	1
一次性吸引器连接管及连接头	yi ci xing xi yin qi lian jie guan ji lian jie tou	1
一次性吸引头	yi ci xing xi yin tou	1
一次性鞋套	yi ci xing xie tao	1
一次性新生儿护脐带	yi ci xing xin sheng er hu qi dai	1
一次性新生儿婴儿胃管鼻饲管	yi ci xing xin sheng er ying er wei guan bi si guan	1
一次性新生儿婴儿吸痰管	yi ci xing xin sheng er ying er xi tan guan	1
一次性胸带	yi ci xing xiong dai	1
一次性胸腔穿刺包	yi ci xing xiong qiang chuan ci bao	1
一次性旋转型闭合器	yi ci xing xuan zhuan xing bi he qi	1
一次性牙垫	yi ci xing ya dian	1
一次性压力传感器	yi ci xing ya li chuan gan qi	1
一次性压舌板	yi ci xing ya she ban	1
一次性延伸管	yi ci xing yan shen guan	1
一次性腰椎穿刺麻醉包	yi ci xing yao zhui chuan ci ma zui bao	1
一次性移液枪吸嘴	yi ci xing yi ye qiang xi zui	1
一次性医用鼻吸氧管	yi ci xing yi yong bi xi yang guan	1
一次性医用非吸性缝合线带针	yi ci xing yi yong fei xi xing feng he xian dai zhen	1
一次性医用光胶片感蓝	yi ci xing yi yong guang jiao pian gan lan	1
一次性医用光胶片感绿	yi ci xing yi yong guang jiao pian gan lv	1
一次性医用耗材名称	yi ci xing yi yong hao cai ming cheng	1
一次性医用胶片	yi ci xing yi yong jiao pian	1
一次性医用乳胶检查手套	yi ci xing yi yong ru jiao jian cha shou tao	1
一次性医用雾化吸入器	yi ci xing yi yong wu hua xi ru qi	1
一次性医用无菌手术手套	yi ci xing yi yong wu jun shou shu shou tao	1
一次性阴道补片	yi ci xing yin dao bu pian	1
一次性阴道扩张器	yi ci xing yin dao kuo zhang qi	1
一次性硬膜外穿刺联合套件	yi ci xing ying mo wai chuan ci lian he tao jian	1
一次性硬膜外麻醉包	yi ci xing ying mo wai ma zui bao	1
一次性硬腰穿刺联合套件	yi ci xing ying yao chuan ci lian he tao jian	1
一次性圆形吻合器	yi ci xing yuan xing wen he qi	1
一次性造影高压连接管	yi ci xing zao ying gao ya lian jie guan	1
一次性真空采血管采血针	yi ci xing zhen kong cai xie guan cai xue zhen	1
一次性枕套	yi ci xing zhen tao	1
一次性镇痛泵	yi ci xing zhen tong beng	1
一次性针头	yi ci xing zhen tou	1
一次性蒸汽雾化器	yi ci xing zheng qi wu hua qi	1
一次性治疗碗	yi ci xing zhi liao wan	1
一次性直型闭合器	yi ci xing zhi xing bi he qi	1
一次性中横单	yi ci xing zhong heng dan	1
一次性主动脉打孔器	yi ci xing zhu dong mai da kong qi	1
一次性注射器	yi ci xing zhu she qi	1
胰岛泵储药器	yi dao beng chu yao qi	1
胰岛素	yi dao su	1
胰岛素泵连接管及连接针头	yi dao su beng lian jie guan ji lian jie zhen tou	1
胰岛素泵输注装置及配套耗材	yi dao su beng shu zhu zhuang zhi ji pei tao hao cai	1
胰岛素笔式注射器	yi dao su bi shi zhu she qi	1
胰岛素笔注射用针头	yi dao su bi zhu she yong zhen tou	1
胰岛素测定试剂	yi dao su ce ding shi ji	1
胰岛素抗体	yi dao su kang ti	1
胰岛素抗体试剂	yi dao su kang ti shi ji	1
胰岛素样生长因子	yi dao su yang sheng zhang yin zi	1
胰岛素原试剂	yi dao su yuan shi ji	1
胰岛细胞抗体试剂	yi dao xi bao kang ti shi ji	1
乙肝表面抗原	yi gan biao mian kang yuan	1
乙肝表面抗原试剂盒血站用	yi gan biao mian kang yuan shi ji he xue zhan yong	1
乙肝表面抗原试纸	yi gan biao mian kang yuan shi zhi	1
乙肝病毒	yi gan bing du	1
乙肝病毒抗原检测试剂盒	yi gan bing du kang yuan jian ce shi ji he	1
乙肝病毒前抗原	yi gan bing du qian kang yuan	1
乙肝二对半	yi gan er dui ban	1
乙肝核心抗体	yi gan he xin kang ti	1
乙肝核心抗原	yi gan he xin kang yuan	1
乙肝两对半	yi gan liang dui ban	1
乙肝两对半试纸条	yi gan liang dui ban shi zhi tiao	1
伊红	yi hong	1
伊红美兰琼脂干粉	yi hong mei lan qiong zhi gan fen	1
伊红染色剂	yi hong ran se ji	1
伊红染色液	yi hong ran se ye	1
医疗诊断题库	yi liao zhen duan ti ku	1
胰酶	yi mei	1
乙酰氨基葡萄糖多聚体溶液	yi xian an ji pu tao tang duo ju ti rong ye	1
乙酰氨基葡萄糖苷酶	yi xian an ji pu tao tang gan mei	1
异形接骨钢板	yi xing jie gu gang ban	1
义眼片	yi yan pian	1
义眼台	yi yan tai	1
移液管	yi ye guan	1
医用鼻吸氧管单塞	yi yong bi xi yang guan dan sai	1
医用鼻吸氧管挂耳	yi yong bi xi yang guan gua er	1
医用鼻吸氧管型氧管	yi yong bi xi yang guan xing yang guan	1
医用鼻吸氧管氧塞	yi yong bi xi yang guan yang sai	1
医用不可吸收性缝合线	yi yong bu ke xi shou xing feng he xian	1
医用不可吸收性缝合线带针	yi yong bu ke xi shou xing feng he xian dai zhen	1
医用不可吸收性缝合线段装	yi yong bu ke xi shou xing feng he xian duan zhuang	1
医用电极片	yi yong dian ji pian	1
医用耳脑胶医用胶	yi yong er nao jiao yi yong jiao	1
医用非灭菌脱脂纱布叠片	yi yong fei mie jun tuo zhi sha bu die pian	1
医用非吸性缝合线	yi yong fei xi xing feng he xian	1
医用缝合线团	yi yong feng he xian tuan	1
医用缝合针	yi yong feng he zhen	1
医用缝针	yi yong feng zhen	1
医用光胶片冲洗套药显影定影液	yi yong guang jiao pian chong xi tao yao xian ying ding ying ye	1
医用光胶片感蓝	yi yong guang jiao pian gan lan	1
医用光胶片感绿	yi yong guang jiao pian gan lv	1
医用光胶片套药显影定影粉	yi yong guang jiao pian tao yao xian ying ding ying fen	1
医用海绵	yi yong hai mian	1
医用含氯消毒片	yi yong han lv xiao du pian	1
医用耗材	yi yong hao cai	1
医用几丁糖	yi yong ji ding tang	1
医用胶	yi yong jiao	1
医用胶布	yi yong jiao bu	1
医用胶片	yi yong jiao pian	1
医用可吸收性缝合线	yi yong ke xi shou xing feng he xian	1
医用可吸收性缝合线带针	yi yong ke xi shou xing feng he xian dai zhen	1
医用可吸收性缝合线段装	yi yong ke xi shou xing feng he xian duan zhuang	1
医用棉垫光不显影	yi yong mian dian guang bu xian ying	1
医用棉垫光显影	yi yong mian dian guang xian ying	1
医用棉签	yi yong mian qian	1
医用灭菌脱脂纱布叠片	yi yong mie jun tuo zhi sha bu die pian	1
医用平头老虎钳	yi yong ping tou lao hu qian	1
医用乳胶检查手套	yi yong ru jiao jian cha shou tao	1
医用乳胶手套	yi yong ru jiao shou tao	1
医用三角缝针	yi yong san jiao feng zhen	1
医用纱布块	yi yong sha bu kuai	1
医用石膏绷带	yi yong shi gao beng dai	1
医用石膏棉纸	yi yong shi gao mian zhi	1
医用手术手套	yi yong shou shu shou tao	1
医用手套	yi yong shou tao	1
医用输液贴	yi yong shu ye tie	1
医用输液贴膜	yi yong shu ye tie mo	1
医用输液贴无纺布	yi yong shu ye tie wu fang bu	1
医用弹力绷带	yi yong tan li beng dai	1
医用弹力网帽	yi yong tan li wang mao	1
医用弹性绷带	yi yong tan xing beng dai	1
医用透明敷料	yi yong tou ming fu liao	1
医用脱脂非灭菌纱布叠片	yi yong tuo zhi fei mie jun sha bu die pian	1
医用脱脂棉花	yi yong tuo zhi mian hua	1
医用脱脂棉球	yi yong tuo zhi mian qiu	1
医用脱脂棉球大中小	yi yong tuo zhi mian qiu da zhong xiao	1
医用脱脂灭菌纱布叠片	yi yong tuo zhi mie jun sha bu die pian	1
医用脱脂灭菌纱布叠片光不显影	yi yong tuo zhi mie jun sha bu die pian guang bu xian ying	1
医用脱脂灭菌纱布叠片光显影	yi yong tuo zhi mie jun sha bu die pian guang xian ying	1
医用脱脂纱布切片	yi yong tuo zhi sha bu qie pian	1
医用卫生材料及敷料	yi yong wei sheng cai liao ji fu liao	1
医用无纺布透气胶带	yi yong wu fang bu tou qi jiao dai	1
医用无菌保护套	yi yong wu jun bao hu tao	1
医用吸水敷料	yi yong xi shui fu liao	1
医用橡皮	yi yong xiang pi	1
医用橡皮膏	yi yong xiang pi gao	1
医用橡皮膏纱底	yi yong xiang pi gao sha di	1
医用橡皮膏塑底	yi yong xiang pi gao su di	1
医用橡皮膏氧化锌胶布	yi yong xiang pi gao yang hua xin jiao bu	1
医用消毒包装袋	yi yong xiao du bao zhuang dai	1
医用消毒洗手液	yi yong xiao du xi shou ye	1
医用羊肠线	yi yong yang chang xian	1
医用一字螺丝刀	yi yong yi zi luo si dao	1
医用园缝针	yi yong yuan feng zhen	1
医用粘贴敷料	yi yong zhan tie fu liao	1
医用纸塑胶	yi yong zhi su jiao	1
衣原体	yi yuan ti	1
抑制素	yi zhi su	1
异种骨	yi zhong gu	1
异种异体骨	yi zhong yi ti gu	1
一注射穿刺及医用高分子材料	yi zhu she chuan ci ji yi yong gao fen zi cai liao	1
椅子	yi zi	1
阴道超探头套	yin dao chao tan tou tao	1
阴道冲洗器	yin dao chong xi qi	1
银粉离子	yin fen li zi	1
银汞胶囊	yin gong jiao nang	1
银汞调和机	yin gong tiao he ji	1
银夹	yin jia	1
阴茎夹	yin jing jia	1
引流袋	yin liu dai	1
印模托盘	yin mo tuo pan	1
隐形义齿	yin xing yi chi	1
隐血检验试剂	yin xue jian yan shi ji	1
隐血试纸	yin xue shi zhi	1
隐血试纸条	yin xue shi zhi tiao	1
因子	yin zi	1
因子测定试剂	yin zi ce ding shi ji	1
硬衬材料	ying chen cai liao	1
影碟机	ying die ji	1
硬度渐变导引导管	ying du jian bian dao yin dao guan	1
荧光灯	ying guang deng	1
荧光原位杂交试剂	ying guang yuan wei za jiao shi ji	1
硬晶体	ying jing ti	1
硬膜外导管	ying mo wai dao guan	1
硬脑膜修补材料	ying nao mo xiu bu cai liao	1
硬石膏	ying shi gao	1
营养琼脂平板	ying yang qiong zhi ping ban	1
鹰嘴咬骨钳	ying zui yao gu qian	1
有创血压传感器	you chuang xue ya chuan gan qi	1
油交缸	you jiao gang	1
游离甲状腺素	you li jia zhuang xian su	1
游离前列腺特异性抗原	you li qian lie xian te yi xing kang yuan	1
游离牵引勾	you li qian yin gou	1
游离三碘甲状腺原氨酸	you li san dian jia zhuang xian yuan an suan	1
幽门螺杆菌	you men luo gan jun	1
幽门螺杆菌抗原测定	you men luo gan jun kang yuan ce ding	1
幽门螺旋杆菌抗体诊断试剂	you men luo xuan gan jun kang ti zhen duan shi ji	1
幽门螺旋杆菌抗原诊断试剂	you men luo xuan gan jun kang yuan zhen duan shi ji	1
有效氯指示卡	you xiao lv zhi shi ka	1
预安装血管支架系统	yu an zhuang xue guan zhi jia xi tong	1
预冲液	yu chong ye	1
预塑形微导管	yu su xing wei dao guan	1
预塑性微导管	yu su xing wei dao guan	1
预装血管支架系统	yu zhuang xue guan zhi jia xi tong	1
远端塞	yuan duan sai	1
远端塞中置器	yuan duan sai zhong zhi qi	1
远端栓子	yuan duan shuan zi	1
远端中置器	yuan duan zhong zhi qi	1
圆弓丝	yuan gong si	1
圆丝弓带环	yuan si gong dai huan	1
圆丝弓颊管	yuan si gong jia guan	1
圆形吻合器	yuan xing wen he qi	1
圆形吻合器钉仓	yuan xing wen he qi ding cang	1
圆形吻合器及钉仓	yuan xing wen he qi ji ding cang	1
圆转凳	yuan zhuan deng	1
孕激素受体	yun ji su shou ti	1
运送拭子	yun song shi zi	1
孕酮	yun tong	1
孕酮检测试剂	yun tong jian ce shi ji	1
载玻片	zai bo pian	1
载脂蛋白	zai zhi dan bai	1
载脂蛋白试剂盒	zai zhi dan bai shi ji he	1
造瘘口袋	zao lou kou dai	1
藻酸盐印模材料	zao suan yan yin mu cai liao	1
造牙粉	zao ya fen	1
造影导管	zao ying dao guan	1
造影导丝	zao ying dao si	1
造影管硅胶	zao ying guan gui jiao	1
造影剂针筒	zao ying ji zhen tong	1
造影连接管	zao ying lian jie guan	1
早孕试纸	zao yun shi zhi	1
早早孕检测条	zao zao yun jian ce tiao	1
粘固粉调刀	zhan gu fen tiao dao	1
粘贴巾	zhan tie jin	1
粘贴手术巾	zhan tie shou shu jin	1
掌骨钢板	zhang gu gang ban	1
掌跖骨钢板	zhang zhi gu gang ban	1
掌跖骨钢板不锈钢	zhang zhi gu gang ban bu xiu gang	1
掌跖骨钢板纯钛	zhang zhi gu gang ban chun tai	1
掌跖骨钢板钛合金	zhang zhi gu gang ban tai he jin	1
诊察床	zhen cha chuang	1
诊查床	zhen cha chuang	1
振荡器	zhen dang qi	1
诊断导丝	zhen duan dao si	1
诊断消融用可调弯导管温控普通	zhen duan xiao rong yong ke tiao wan dao guan wen kong pu tong	1
枕颈融合棒	zhen jing rong he bang	1
枕颈融合环	zhen jing rong he huan	1
枕颈融合系统	zhen jing rong he xi tong	1
枕颈融合系统不锈钢	zhen jing rong he xi tong bu xiu gang	1
枕颈融合系统钛合金	zhen jing rong he xi tong tai he jin	1
真菌显色培养皿	zhen jun xian se pei yang min	1
真菌药敏培养基	zhen jun yao min pei yang ji	1
真菌药敏琼脂干粉	zhen jun yao min qiong zhi gan fen	1
真菌药敏纸片	zhen jun yao min zhi pian	1
真空测试图	zhen kong ce shi tu	1
真空高压消毒锅	zhen kong gao ya xiao du guo	1
真空骨水泥混合	zhen kong gu shui ni hun he	1
真空骨水泥搅拌系统	zhen kong gu shui ni jiao ban xi tong	1
真空混合器	zhen kong hun he qi	1
真空混合装置	zhen kong hun he zhuang zhi	1
真空搅拌器	zhen kong jiao ban qi	1
诊疗台	zhen liao tai	1
真丝胶带	zhen si jiao dai	1
枕套	zhen tao	1
镇痛泵	zhen tong beng	1
针炙针	zhen zhi zhen	1
珍珠面标准柄	zhen zhu mian biao zhun bing	1
珍珠面复合股骨柄	zhen zhu mian fu he gu gu bing	1
珍珠面金属杯	zhen zhu mian jin shu bei	1
珍珠面金属臼	zhen zhu mian jin shu jiu	1
正畸模型	zheng ji mo xing	1
正畸托槽	zheng ji tuo cao	1
直柄翻修柄	zhi bing fan xiu bing	1
直柄微孔	zhi bing wei kong	1
痔疮环状切除吻合器	zhi chuang huan zhuang qie chu wen he qi	1
脂蛋白	zhi dan bai	1
脂蛋白液体试剂盒	zhi dan bai ye ti shi ji he	1
脂肪酶	zhi fang mei	1
脂肪酶试剂盒	zhi fang mei shi ji he	1
直弓丝	zhi gong si	1
趾骨钢板	zhi gu gang ban	1
跖骨钢板	zhi gu gang ban	1
指骨钢板	zhi gu gang ban	1
植骨灵	zhi gu ling	1
志贺菌属属血清	zhi he jun shu shu xue qing	1
支架	zhi jia	1
支架系统	zhi jia xi tong	1
直接胆红素	zhi jie dan hong su	1
直接胆红素试剂盒	zhi jie dan hong su shi ji he	1
质控图纸	zhi kong tu zhi	1
治疗车	zhi liao che	1
治疗机	zhi liao ji	1
治疗输血器	zhi liao shu xue qi	1
治疗台	zhi liao tai	1
植入式化疗泵	zhi ru shi hua liao beng	1
植入式心房激素电极	zhi ru shi xin fang ji su dian ji	1
植入式心律转复除颤器	zhi ru shi xin lv zhuan fu chu chan qi	1
植入式心律转复除颤器双腔型	zhi ru shi xin lv zhuan fu chu chan qi shuang qiang xing	1
植入式心室激素电极	zhi ru shi xin shi ji su dian ji	1
指示卡	zhi shi ka	1
指示源灯泡	zhi shi yuan deng pao	1
直丝弓带环	zhi si gong dai huan	1
直丝弓颊面管	zhi si gong jia mian guan	1
直头猪尾造影导管放射造影导管	zhi tou zhu wei zao ying dao guan fang she zao ying dao guan	1
直线缝合器	zhi xian feng he qi	1
直线缝合器钉仓	zhi xian feng he qi ding cang	1
直线缝合器及钉仓	zhi xian feng he qi ji ding cang	1
直线切割缝合器	zhi xian qie ge feng he qi	1
直线切割缝合器钉仓	zhi xian qie ge feng he qi ding cang	1
直线切割缝合器及钉仓	zhi xian qie ge feng he qi ji ding cang	1
直型重建钢板不锈钢	zhi xing chong jian gang ban bu xiu gang	1
直型重建钢板纯钛	zhi xing chong jian gang ban chun tai	1
直型重建钢板钛合金	zhi xing chong jian gang ban tai he jin	1
直型钢板	zhi xing gang ban	1
直型钢板不锈钢	zhi xing gang ban bu xiu gang	1
直型钢板纯钛	zhi xing gang ban chun tai	1
直型钢板钛合金	zhi xing gang ban tai he jin	1
止血材料	zhi xue cai liao	1
止血海绵不可吸收	zhi xue hai mian bu ke xi shou	1
止血海绵可吸收	zhi xue hai mian ke xi shou	1
止血夹子装置	zhi xue jia zi zhuang zhi	1
止血脑棉片	zhi xue nao mian pian	1
止血钳	zhi xue qian	1
指引导管	zhi yin dao guan	1
支原体	zhi yuan ti	1
支原体解脲人型培养基	zhi yuan ti jie niao ren xing pei yang ji	1
支原体培养鉴定药敏试剂	zhi yuan ti pei yang jian ding yao min shi ji	1
支原体试剂盒	zhi yuan ti shi ji he	1
支原体药敏试纸	zhi yuan ti yao min shi zhi	1
支原体药敏一体化支体	zhi yuan ti yao min yi ti hua zhi ti	1
指趾骨钢板	zhi zhi gu gang ban	1
指趾骨钢板不锈钢	zhi zhi gu gang ban bu xiu gang	1
指趾骨钢板纯钛	zhi zhi gu gang ban chun tai	1
指趾骨钢板钛合金	zhi zhi gu gang ban tai he jin	1
指趾掌接骨板	zhi zhi zhang jie gu ban	1
中单	zhong dan	1
肿瘤坏死因子	zhong liu huai si yin zi	1
肿瘤试剂	zhong liu shi ji	1
肿瘤特异性生长因子	zhong liu te yi xing sheng zhang yin zi	1
中频制造机	zhong pin zhi zao ji	1
中频铸造机	zhong pin zhu zao ji	1
中心静脉导管	zhong xin jing mai dao guan	1
中心静脉导管单腔	zhong xin jing mai dao guan dan qiang	1
中心静脉导管三腔	zhong xin jing mai dao guan san qiang	1
中心静脉导管双腔	zhong xin jing mai dao guan shuang qiang	1
中性粒细胞胞浆抗体试剂	zhong xing li xi bao bao jiang kang ti shi ji	1
中性树胶	zhong xing shu jiao	1
重要喷雾美容机	zhong yao pen wu mei rong ji	1
中药喷雾美容机	zhong yao pen wu mei rong ji	1
中置器	zhong zhi qi	1
肘关节	zhou guan jie	1
肘离断假肢	zhou li duan jia zhi	1
轴流风机	zhou liu feng ji	1
贮槽	zhu cao	1
贮槽架	zhu cao jia	1
铸道蜡线	zhu dao la xian	1
主动固定起搏电极导线	zhu dong gu ding qi bo dian ji dao xian	1
主动脉内球囊导管	zhu dong mai nei qiu nang dao guan	1
主动脉内球囊反搏导管	zhu dong mai nei qiu nang fan bo dao guan	1
主动脉支架镍钛合金支架	zhu dong mai zhi jia nie tai he jin zhi jia	1
珠结式股骨柄	zhu jie shi gu gu bing	1
主控机	zhu kong ji	1
注射盒	zhu she he	1
注射针头	zhu she zhen tou	1
柱秃屏	zhu tu ping	1
猪尾巴导管	zhu wei ba dao guan	1
贮血滤血器	zhu xue lv xue qi	1
煮牙盒	zhu ya he	1
贮液囊	zhu ye nang	1
抓髌器记忆合金	zhua bin qi ji yi he jin	1
转换接口	zhuan huan jie kou	1
转换器	zhuan huan qi	1
转肽酶	zhuan tai mei	1
转铁蛋白检测试剂	zhuan tie dan bai jian ce shi ji	1
转椅	zhuan yi	1
专用试剂	zhuan yong shi ji	1
专用透析管路	zhuan yong tou xi guan lu	1
专用透析管路按适合机型分类	zhuan yong tou xi guan lu an shi he ji xing fen lei	1
专用吸嘴	zhuan yong xi zui	1
专用压力泵	zhuan yong ya li beng	1
椎体成形术系统	zhui ti cheng xing shu xi tong	1
椎体成形术系统膨胀系列	zhui ti cheng xing shu xi tong peng zhang xi lie	1
锥形股骨球头	zhui xing gu gu qiu tou	1
锥形股骨头金属	zhui xing gu gu tou jin shu	1
锥形股骨头陶瓷	zhui xing gu gu tou tao ci	1
锥形颈动脉支架	zhui xing jing dong mai zhi jia	1
自动烘手器	zi dong hong shou qi	1
自动化配血试剂	zi dong hua pei xue shi ji	1
自动痔疮套扎器	zi dong zhi chuang tao zha qi	1
子宫扩张器	zi gong kuo zhang qi	1
自攻钛钉	zi gong tai ding	1
子宫探针	zi gong tan zhen	1
子宫套扎线	zi gong tao zha xian	1
子宫通水管	zi gong tong shui guan	1
资料柜	zi liao gui	1
自免肝组合	zi mian gan zu he	1
自凝血丝牙托粉	zi ning xue si ya tuo fen	1
自凝牙托粉	zi ning ya tuo fen	1
自凝牙托水	zi ning ya tuo shui	1
自凝造牙粉	zi ning zao ya fen	1
自膨式外周支架	zi peng shi wai zhou zhi jia	1
自膨式外周支架系统	zi peng shi wai zhou zhi jia xi tong	1
自膨式支架	zi peng shi zhi jia	1
自膨胀镍钛支架系统	zi peng zhang nie tai zhi jia xi tong	1
自膨胀髂动脉支架系统	zi peng zhang qia dong mai zhi jia xi tong	1
紫杉醇释放冠脉支架系统	zi shan chun shi fang guan mai zhi jia xi tong	1
自锁型肱骨髓内钉	zi suo xing gong gu sui nei ding	1
自锁型肱骨髓内钉不锈钢	zi suo xing gong gu sui nei ding bu xiu gang	1
自锁型肱骨髓内钉纯钛	zi suo xing gong gu sui nei ding chun tai	1
自锁型肱骨髓内钉钛合金	zi suo xing gong gu sui nei ding tai he jin	1
自锁型肱骨髓内钉尾钉	zi suo xing gong gu sui nei ding wei ding	1
自锁型肱骨髓内钉主钉	zi suo xing gong gu sui nei ding zhu ding	1
自锁型股骨髓内钉	zi suo xing gu gu sui nei ding	1
自锁型股骨髓内钉不锈钢	zi suo xing gu gu sui nei ding bu xiu gang	1
自锁型股骨髓内钉纯钛	zi suo xing gu gu sui nei ding chun tai	1
自锁型股骨髓内钉钛合金	zi suo xing gu gu sui nei ding tai he jin	1
自锁型股骨髓内钉尾钉	zi suo xing gu gu sui nei ding wei ding	1
自锁型股骨髓内钉主钉	zi suo xing gu gu sui nei ding zhu ding	1
自锁型胫骨髓内钉	zi suo xing jing gu sui nei ding	1
自锁型胫骨髓内钉不锈钢	zi suo xing jing gu sui nei ding bu xiu gang	1
自锁型胫骨髓内钉纯钛	zi suo xing jing gu sui nei ding chun tai	1
自锁型胫骨髓内钉钛合金	zi suo xing jing gu sui nei ding tai he jin	1
自锁型胫骨髓内钉尾钉	zi suo xing jing gu sui nei ding wei ding	1
自锁型胫骨髓内钉主钉	zi suo xing jing gu sui nei ding zhu ding	1
紫外线测试卡	zi wai xian ce shi ka	1
紫外线灯管	zi wai xian deng guan	1
紫外线消毒车	zi wai xian xiao du che	1
自吸泵	zi xi beng	1
总蛋白	zong dan bai	1
总蛋白测定试剂盒	zong dan bai ce ding shi ji he	1
总蛋白试剂盒	zong dan bai shi ji he	1
总蛋白液体试剂盒	zong dan bai ye ti shi ji he	1
总胆固醇	zong dan gu chun	1
总胆固醇试剂	zong dan gu chun shi ji	1
总胆固醇试剂盒	zong dan gu chun shi ji he	1
总胆固醇液体试剂盒	zong dan gu chun ye ti shi ji he	1
总胆红素	zong dan hong su	1
总胆红素低标	zong dan hong su di biao	1
总胆红素试剂盒	zong dan hong su shi ji he	1
总胆汁酸	zong dan zhi suan	1
总胆汁酸试剂盒	zong dan zhi suan shi ji he	1
总钙	zong gai	1
综合手术床	zong he shou shu chuang	1
综合治疗牙椅	zong he zhi liao ya yi	1
综合治疗牙椅治疗机	zong he zhi liao ya yi zhi liao ji	1
棕色滴瓶	zong se di ping	1
棕色小口瓶	zong se xiao kou ping	1
总铁结合力	zong tie jie he li	1
足部矫形器	zu bu jiao xing qi	1
足跟垫	zu gen dian	1
组合式股骨柄	zu he shi gu gu bing	1
组合式后稳定型翻修关节	zu he shi hou wen ding xing fan xiu guan jie	1
组合式髋臼杯	zu he shi kuan jiu bei	1
组件名称	zu jian ming cheng	1
组配生物型翻修柄	zu pei sheng wu xing fan xiu bing	1
组配型生物柄	zu pei xing sheng wu bing	1
组套名称	zu tao ming cheng	1
组织剪	zu zhi jian	1
组织培养油	zu zhi pei yang you	1
组织因子测定试剂	zu zhi yin zi ce ding shi ji	1
组织再生膜	zu zhi zai sheng mo	1
左室起搏电极导线	zuo shi qi bo dian ji dao xian	1
左心部传送导管系统	zuo xin bu chuan song dao guan xi tong	1
左右共用型造影导管	zuo you gong yong xing zao ying dao guan	1
左右共用造影导管	zuo you gong yong zao ying dao guan	1
