阿斗当皇帝	a dou dang huang di	1
阿斗的江山	a dou de jiang shan	1
阿公吃黄连	a gong chi huang lian	1
阿拉伯数字八字分家	a la bo shu zi ba zi fen jia	1
挨鞭子不挨棍子	ai bian zi bu ai gun zi	1
挨鞭子的日子到了	ai bian zi de ri zi dao le	1
挨刀的货	ai dao de huo	1
挨了棒的狗	ai le bang de gou	1
爱上钩	ai shang gou	1
矮子放屁	ai zi fang pi	1
矮子爬坡	ai zi pa po	1
矮子骑大马	ai zi qi da ma	1
矮子上楼梯	ai zi shang lou ti	1
矮子推掌	ai zi tui zhang	1
矮子坐高凳	ai zi zuo gao deng	1
矮子坐高登	ai zi zuo gao deng	1
案板底下放风第	an ban di xia fang feng di	1
案板上砍骨头	an ban shang kan gu tou	1
岸边的青蛙	an bian de qing wa	1
按彩球的乞丐	an cai qiu de qi gai	1
暗地里耍拳	an di li shua quan	1
按鸡头啄米	an ji tou zhuo mi	1
按老方子吃药	an lao fang zi chi yao	1
安禄山起兵	an lu shan qi bing	1
庵庙里的尼姑	an miao li de ni gu	1
暗室里穿针	an shi li chuan zhen	1
暗喜欢	an xi huan	1
安营扎寨	an ying zha zhai	1
按着葫芦挖籽	an zhe hu lu wa zi	1
按着脑袋往火炕里钻	an zhe nao dai wang huo kang li zuan	1
按着牛头喝水	an zhe niu tou he shui	1
暗中活动	an zhong huo dong	1
八百年前立的旗杆	ba bai nian qian li de qi gan	1
巴不得	ba bu de	1
拔草引蛇	ba cao yin she	1
八个老汉划拳	ba ge lao han hua quan	1
八个歪脖坐一桌	ba ge wai bo zuo yi zhuo	1
拔尖	ba jian	1
芭蕉开花	ba jiao kai hua	1
芭蕉叶上垒鸟窝	ba jiao ye shang lei niao wo	1
疤瘌眼长疮	ba la yan zhang chuang	1
拔了毛的凤凰	ba le mao de feng huang	1
把脸装进裤裆里	ba lian zhuang jin ku dang li	1
把你往苦里引	ba ni wang ku li yin	1
把人跌闪得好苦	ba ren die shan de hao ku	1
八十老人吹灯	ba shi lao ren chui deng	1
霸王别姬	ba wang bie ji	1
八仙过海	ba xian guo hai	1
八贤王进宫	ba xian wang jin gong	1
八月十五吃元宵	ba yue shi wu chi yuan xiao	1
八月十五的月亮	ba yue shi wu de yue liang	1
巴掌穿鞋	ba zhang chuan xie	1
摆布不开	bai bu bu kai	1
摆不平	bai bu ping	1
白搭工	bai da gong	1
白费神	bai fei shen	1
白费心机	bai fei xin ji	1
白骨精化美女	bai gu jing hua mei nv	1
白骨精说人话	bai gu jing shuo ren hua	1
百货大楼卖西装	bai huo da lou mai xi zhuang	1
百斤重担能上肩一两笔杆提不动	bai jin zhong dan neng shang jian yi liang bi gan ti bu dong	1
白蜡材结桂花	bai la cai jie gui hua	1
白了尾巴尖的狐狸	bai le wei ba jian de hu li	1
柏马屁拍到蹄子上	bai ma pi pai dao ti zi shang	1
白娘子遇许仙	bai niang zi yu xu xian	1
白跑	bai pao	1
白日做梦	bai ri zuo meng	1
白送	bai song	1
白疼了一场	bai teng liao yi chang	1
白天盼月亮	bai tian pan yue liang	1
百万雄师下江南	bai wan xiong shi xia jiang nan	1
白钻空子	bai zuan kong zi	1
半道上捡个喇叭	ban dao shang jian ge la ba	1
半斤对八两	ban jin dui ba liang	1
半空中骑马	ban kong zhong qi ma	1
斑马的脑袋	ban ma de nao dai	1
搬菩萨洗澡	ban pu sa xi zao	1
半夜做梦娶新娘	ban ye zuo meng qu xin niang	1
斑鸩打架	ban zhen da jia	1
扮猪吃老虎	ban zhu chi lao hu	1
包输	bao shu	1
辈辈苦	bei bei ku	1
背后整人	bei hou zheng ren	1
悲喜交加	bei xi jiao jia	1
本领高	ben ling gao	1
本末颠倒	ben mo dian dao	1
本质太差	ben zhi tai cha	1
蹦老高	beng lao gao	1
甭想	beng xiang	1
彼此彼此	bi ci bi ci	1
彼此一样丑	bi ci yi yang chou	1
必定有缘故	bi ding you yuan gu	1
毕恭毕敬	bi gong bi jing	1
比马大	bi ma da	1
比上不足比下不余	bi shang bu zu bi xia bu yu	1
变得真快	bian de zhen kuai	1
变坏了	bian huai le	1
变他本色	bian ta ben shai	1
憋出个猴来	bie chu ge hou lai	1
别看他小	bie kan ta xiao	1
瘪了	bie le	1
憋气窝火	bie qi wo huo	1
别人不亲自己亲	bie ren bu qin zi ji qin	1
不安好心眼	bu an hao xin yan	1
不必多言	bu bi duo yan	1
不变色	bu bian se	1
步步登高	bu bu deng gao	1
步步高升	bu bu gao sheng	1
不成	bu cheng	1
不出所料	bu chu suo liao	1
不得不低头	bu de bu di tou	1
不得不老实	bu de bu lao shi	1
不得己	bu de ji	1
不点不亮	bu dian bu liang	1
不懂	bu dong	1
不对路数	bu dui lu shu	1
不对头	bu dui tou	1
不分老嫩	bu fen lao nen	1
不分上下	bu fen shang xia	1
不分主次	bu fen zhu ci	1
不干脆	bu gan cui	1
不敢想	bu gan xiang	1
不敢坐上席	bu gan zuo shang xi	1
不顾根本	bu gu gen ben	1
不管驴事	bu guan lv shi	1
不过瘾	bu guo yin	1
不好提	bu hao ti	1
不合算	bu he suan	1
不合辙	bu he zhe	1
不怀好意	bu huai hao yi	1
不会套	bu hui tao	1
不计其数	bu ji qi shu	1
不记前仇俏媳妇戴凤冠	bu ji qian chou qiao xi fu dai feng guan	1
不简单	bu jian dan	1
不进则退	bu jin ze tui	1
不可靠	bu ke kao	1
不可能不受沾染	bu ke neng bu shou zhan ran	1
不烂搞到烂	bu lan gao dao lan	1
不领情	bu ling qing	1
不露头	bu lu tou	1
不能不求人	bu neng bu qiu ren	1
不能容忍	bu neng rong ren	1
不怕没人要	bu pa mei ren yao	1
不怕压力大	bu pa ya li da	1
不怕影儿斜	bu pa ying er xie	1
不如鸡	bu ru ji	1
不上算	bu shang suan	1
不是好东西	bu shi hao dong xi	1
不是好苗头	bu shi hao miao tou	1
不是好人	bu shi hao ren	1
不是好种	bu shi hao zhong	1
不是路	bu shi lu	1
不是门	bu shi men	1
不是哪块香料	bu shi na kuai xiang liao	1
不是闹着玩的	bu shi nao zhe wan de	1
不是时候	bu shi shi hou	1
不识时务	bu shi shi wu	1
不识抬举	bu shi tai ju	1
不是偷也是偷	bu shi tou ye shi tou	1
不识相	bu shi xiang	1
不是这块料	bu shi zhe kuai liao	1
不是正经材料	bu shi zheng jing cai liao	1
不死也要脱层皮	bu si ye yao tuo ceng pi	1
不算数	bu suan shu	1
不惜代价	bu xi dai jia	1
不响	bu xiang	1
不想给你吵	bu xiang gei ni chao	1
不相上下	bu xiang shang xia	1
不象样	bu xiang yang	1
不晓得软硬	bu xiao de ruan ying	1
不行了	bu xing le	1
不要脸	bu yao lian	1
不腰痛	bu yao tong	1
不着边际	bu zhao bian ji	1
不知吃力	bu zhi chi li	1
不知底细	bu zhi di xi	1
不知几品	bu zhi ji pin	1
不知轻重	bu zhi qing zhong	1
不值摔打	bu zhi shuai da	1
不知死活	bu zhi si huo	1
不知眼有多高	bu zhi yan you duo gao	1
不阻力	bu zu li	1
彩虹和白云谈情	cai hong he bai yun tan qing	1
财迷转向	cai mi zhuan xiang	1
采取主动	cai qu zhu dong	1
财神爷戴乌纱帽	cai shen ye dai wu sha mao	1
踩着肩头往头上拉屎	cai zhe jian tou wang tou shang la shi	1
藏头露尾	cang tou lu wei	1
苍蝇叮菩萨	cang ying ding pu sa	1
苍蝇嘴巴狗鼻子	cang ying zui ba gou bi zi	1
草包	cao bao	1
曹操败走华客道	cao cao bai zou hua ke dao	1
曹操败走华容道	cao cao bai zou hua rong dao	1
曹操吃鸡肋	cao cao chi ji lei	1
曹操遇蒋干	cao cao yu jiang gan	1
曹操诸葛亮	cao cao zhu ge liang	1
厕所里照镜子	ce suo li zhao jing zi	1
茶壶有嘴难说话	cha hu you zui nan shuo hua	1
茶铺里不要的伙计	cha pu li bu yao de huo ji	1
长城上的砖	chang cheng shang de zhuan	1
嫦娥跳舞	chang e tiao wu	1
唱高调	chang gao diao	1
长颈鹿进马群	chang jing lu jin ma qun	1
长丝瓜当扁担	chang si gua dang bian dan	1
唱戏的穿龙袍	chang xi de chuan long pao	1
唱戏的胡子	chang xi de hu zi	1
扯得长	che de chang	1
彻底垮台	che di kua tai	1
扯裤子补补丁	che ku zi bu bu ding	1
扯着老虎尾巴喊救命	che zhe lao hu wei ba han jiu ming	1
趁机磨刀	chen ji mo dao	1
成不了皇帝	cheng bu liao huang di	1
城隍庙里着了火	cheng huang miao li zhe le huo	1
城隍娘娘有喜	cheng huang niang niang you xi	1
城楼上亮相	cheng lou shang liang xiang	1
成全好事	cheng quan hao shi	1
成群结队	cheng qun jie dui	1
逞什么	cheng shen me	1
成双成对	cheng shuang cheng dui	1
诚心实意	cheng xin shi yi	1
吃亏的是自己	chi kui de shi zi ji	1
吃了对门谢隔壁	chi le dui men xie ge bi	1
痴人说梦	chi ren shuo meng	1
吃软不吃硬	chi ruan bu chi ying	1
痴心妄想	chi xin wang xiang	1
吃鱼不吐骨头	chi yu bu tu gu tou	1
迟早要飞	chi zao yao fei	1
充人来了	chong ren lai le	1
臭不要脸	chou bu yao lian	1
丑对丑	chou dui chou	1
臭美	chou mei	1
抽你的筋剥你的皮	chou ni de jin bo ni de pi	1
楚霸王自刎乌江	chu ba wang zi wen wu jiang	1
出不了格	chu bu liao ge	1
出不了好主意	chu bu liao hao zhu yi	1
出师不利	chu shi bu li	1
出手不高	chu shou bu gao	1
喘不上气	chuan bu shang qi	1
吹不得	chui bu de	1
吹不响	chui bu xiang	1
吹的	chui de	1
吹了	chui le	1
垂头丧气	chui tou sang qi	1
此路不通	ci lu bu tong	1
葱头不开花	cong tou bu kai hua	1
从头甜到脚	cong tou tian dao jiao	1
粗中有细	cu zhong you xi	1
催命鬼	cui ming gui	1
存心害人	cun xin hai ren	1
错了	cuo le	1
错路一条	cuo lu yi tiao	1
大摆布	da bai bu	1
大不了	da bu liao	1
搭不上手	da bu shang shou	1
大材小用	da cai xiao yong	1
大车初一打拼伙	da che chu yi da pin huo	1
大处不算小处算	da chu bu suan xiao chu suan	1
大吹大擂	da chui da lei	1
打灯笼走亲戚一明去明来	da deng long zou qin qi yi ming qu ming lai	1
大公鸡吃米	da gong ji chi mi	1
大姑娘嫁太监	da gu niang jia tai jian	1
大姑娘瞧嫁妆	da gu niang qiao jia zhuang	1
大姑娘肿脸	da gu niang zhong lian	1
大海里的一滴水	da hai li de yi di shui	1
大街上的行人	da jie shang de xing ren	1
打开棺材喊捉贼	da kai guan cai han zhuo zei	1
打开天窗	da kai tian chuang	1
大老粗	da lao cu	1
大流子的弟弟	da liu zi de di di	1
打锣卖糖	da luo mai tang	1
大门日的石狮子	da men ri de shi shi zi	1
大年三十看黄历	da nian san shi kan huang li	1
打鸟姿态	da niao zi tai	1
打破脑袋叫扇子扇	da po nao dai jiao shan zi shan	1
大起大落	da qi da luo	1
搭起戏台卖豆腐	da qi xi tai mai dou fu	1
搭起戏台卖螃蟹	da qi xi tai mai pang xie	1
大热天穿皮袄	da re tian chuan pi ao	1
打上黑脸照镜	da shang hei lian zhao jing	1
大圣吃毫毛	da sheng chi hao mao	1
大声叫喊	da sheng jiao han	1
大水冲了龙王庙	da shui chong le long wang miao	1
打死老鼠喂猫	da si lao shu wei mao	1
打乌米的眼睛	da wu mi de yan jing	1
大虾炒鸡爪儿	da xia chao ji zhua er	1
大显神威	da xian shen wei	1
大象喝水	da xiang he shui	1
大小各有用场	da xiao ge you yong chang	1
大雁飞行	da yan fei xing	1
大智若愚	da zhi ruo yu	1
打肿脸充胖子	da zhong lian chong pang zi	1
打足了气的皮球	da zu le qi de pi qiu	1
打足气的气球	da zu qi de qi qiu	1
带刺	dai ci	1
呆着不动	dai zhe bu dong	1
戴着面具进棺材	dai zhe mian ju jin guan cai	1
戴着面具亲嘴	dai zhe mian ju qin zui	1
呆子	dai zi	1
担当不起	dan dang bu qi	1
淡而无味	dan er wu wei	1
胆小如鼠	dan xiao ru shu	1
挡凤板做锅盖	dang feng ban zuo guo gai	1
倒挨了一锥子	dao ai le yi zhui zi	1
倒挨一脚	dao ai yi jiao	1
稻草人救火	dao cao ren jiu huo	1
道道多	dao dao duo	1
捣鼓不开	dao gu bu kai	1
倒了大霉	dao le da mei	1
盗马贼披袈裟	dao ma zei pi jia sha	1
倒贴	dao tie	1
道听途说	dao ting tu shuo	1
倒着走	dao zhe zou	1
得不偿失	de bu chang shi	1
得心应手	de xin ying shou	1
等不到老	deng bu dao lao	1
等着挨刀	deng zhe ai dao	1
登着耗子当成牛	deng zhe hao zi dang cheng niu	1
低声下气	di sheng xia qi	1
点不起火	dian bu qi huo	1
点燃的蜡烛一长命不了	dian ran de la zhu yi zhang ming bu liao	1
点着火的双响	dian zhe huo de shuang xiang	1
吊儿郎当	diao er lang dang	1
动不得	dong bu de	1
东倒西歪	dong dao xi wai	1
抖起来了	dou qi lai le	1
抖什么威风	dou shen me wei feng	1
都闲着	dou xian zhe	1
堵不完的窟窿	du bu wan de ku long	1
独具只眼	du ju zhi yan	1
肚里有货倒不出	du li you huo dao bu chu	1
独吞	du tun	1
断了柄锄头安了把	duan le bing chu tou an le ba	1
断了线的梭子	duan le xian de suo zi	1
短命的货	duan ming de huo	1
对不上号	dui bu shang hao	1
对天讲话	dui tian jiang hua	1
多此一举	duo ci yi ju	1
多一层比少一层好	duo yi ceng bi shao yi ceng hao	1
多一股子气	duo yi gu zi qi	1
多余	duo yu	1
躲雨躲到城隍庙	duo yu duo dao cheng huang miao	1
多嘴多舌	duo zui duo she	1
鹅蛋石跌进刺蓬里	e dan shi die jin ci peng li	1
恶鬼见钟旭	e gui jian zhong xu	1
饿虎进宅	e hu jin zhai	1
饿狼窜进羊厩	e lang cuan jin yang jiu	1
恶狼对羊笑	e lang dui yang xiao	1
恶狼和疯狗作伴	e lang he feng gou zuo ban	1
饿狼日里夺脆骨	e lang ri li duo cui gu	1
恶狼生个贼狐狸	e lang sheng ge zei hu li	1
鹅盆里不准鸭插嘴	e pen li bu zhun ya cha zui	1
恶人登门	e ren deng men	1
恶人雕戴皮帽	e ren diao dai pi mao	1
恶人先告状	e ren xian gao zhuang	1
鹅伸脖子	e shen bo zi	1
额头角上搁扁担	e tou jiao shang ge bian dan	1
额头上插牡丹	e tou shang cha mu dan	1
额外负担	e wai fu dan	1
鹅在水中寻食	e zai shui zhong xun shi	1
饿着肚子做梦	e zhe du zi zuo meng	1
饿猪占木槽	e zhu zhan mu cao	1
二百加五十	er bai jia wu shi	1
二百五	er bai wu	1
二不愣当家	er bu leng dang jia	1
二尺长的吹火筒	er chi zhang de chui huo tong	1
耳朵里塞棉花	er duo li sai mian hua	1
耳朵塞驴毛	er duo sai lv mao	1
二郎神的印堂	er lang shen de yin tang	1
二两棉花	er liang mian hua	1
二流子	er liu zi	1
二流子打鼓	er liu zi da gu	1
二踢脚	er ti jiao	1
二万五千里长征	er wan wu qian li chang zheng	1
尔虞我诈	er yu wo zha	1
儿子不养娘	er zi bu yang niang	1
发啦	fa la	1
乏味	fa wei	1
翻不过身来	fan bu guo shen lai	1
翻江倒海	fan jiang dao hai	1
犯劲	fan jin	1
反了	fan le	1
飞不起来	fei bu qi lai	1
费功夫	fei gong fu	1
非输不可	fei shu bu ke	1
非灾即祸	fei zai ji huo	1
扶不直	fu bu zhi	1
父子相认	fu zi xiang ren	1
旮旯里藏毒蛇	ga la li cang du she	1
嘎小子买烧鸡	ga xiao zi mai shao ji	1
改朝换代	gai chao huan dai	1
盖房请来箍桶匠	gai fang qing lai gu tong jiang	1
盖了九床被子做美梦	gai le jiu chuang bei zi zuo mei meng	1
该下台了	gai xia tai le	1
干瘪	gan bie	1
干草点灯	gan cao dian deng	1
赶场带相亲	gan chang dai xiang qin	1
赶场走进死胡同	gan chang zou jin si hu tong	1
干打雷不下雨	gan da lei bu xia yu	1
干干脆脆	gan gan cui cui	1
干旱的庄稼	gan han de zhuang jia	1
干河沟的鱼	gan he gou de yu	1
干河滩里种牡丹	gan he tan li zhong mu dan	1
干活打瞌睡	gan huo da ke shui	1
赶鸡下河	gan ji xia he	1
赶脚的骑驴	gan jiao de qi lv	1
干净不了	gan jing bu liao	1
橄榄屁股	gan lan pi gu	1
赶龙王下海	gan long wang xia hai	1
干萝卜缨熬汤	gan luo bo ying ao tang	1
擀面杖吹火	gan mian zhang chui huo	1
擀面杖分长短	gan mian zhang fen chang duan	1
擀面杖钻石头	gan mian zhang zuan shi tou	1
干轻巧活	gan qing qiao huo	1
甘蔗拔节	gan zhe ba jie	1
甘蔗林里种香瓜	gan zhe lin li zhong xiang gua	1
甘蔗皮编席子	gan zhe pi bian xi zi	1
赶着王母娘娘叫大姑	gan zhe wang mu niang niang jiao da gu	1
刚扯帆就遇顶头风	gang che fan jiu yu ding tou feng	1
刚出炉的纯钢	gang chu lu de chun gang	1
刚出山的太阳	gang chu shan de tai yang	1
刚出水的虾子	gang chu shui de xia zi	1
刚出土的黄连	gang chu tu de huang lian	1
刚逮住的鲤鱼	gang dai zhu de li yu	1
高出了头	gao chu le tou	1
高飞的鸟儿遇老鹰	gao fei de niao er yu lao ying	1
高级合金钢	gao ji he jin gang	1
高明	gao ming	1
高攀	gao pan	1
高山头种辣椒	gao shan tou zhong la jiao	1
高兴得发傻	gao xing dei fa sha	1
高姿态	gao zi tai	1
疙瘩饼子送闺女	ge da bing zi song gui nv	1
隔黄河送秋波	ge huang he song qiu bo	1
隔年的臭虫	ge nian de chou chong	1
隔年的春联	ge nian de chun lian	1
各人享各人福	ge ren xiang ge ren fu	1
隔山打鸟	ge shan da niao	1
割下鼻子换面吃	ge xia bi zi huan mian chi	1
各显神通	ge xian shen tong	1
各有各的打法	ge you ge de da fa	1
各有一技之长	ge you yi ji zhi chang	1
各于一行	ge yu yi hang	1
胳肢窝里夹耗子	ge zhi wo li jia hao zi	1
各走各的道	ge zou ge de dao	1
各走一端	ge zou yi duan	1
根底浅	gen di qian	1
根深时茂	gen shen shi mao	1
根子不正	gen zi bu zheng	1
够不着	gou bu zhao	1
够喘的了	gou chuan de le	1
勾勾搭搭	gou gou da da	1
狗眼看人	gou yan kan ren	1
够硬	gou ying	1
顾前不顾后	gu qian bu gu hou	1
鼓足了劲	gu zu le jin	1
挂个空名	gua ge kong ming	1
怪事一桩	guai shi yi zhuang	1
怪物	guai wu	1
管不了庙里事	guan bu liao miao li shi	1
管得宽	guan de kuan	1
管的宽	guan de kuan	1
观点模糊	guan dian mo hu	1
光打光	guang da guang	1
光剩嘴了	guang sheng zui le	1
光耍嘴	guang shua zui	1
鬼把戏	gui ba xi	1
鬼点子多	gui dian zi duo	1
鬼相	gui xiang	1
鬼样子	gui yang zi	1
过得硬	guo de ying	1
过一天算一天	guo yi tian suan yi tian	1
还不了	hai bu le	1
还是老一套	hai shi lao yi tao	1
旱该倒了	han gai dao le	1
罕见	han jian	1
寒酸	han suan	1
好大的胆	hao da de dan	1
好大的口气	hao da de kou qi	1
好大的气	hao da de qi	1
好大的胃口	hao da de wei kou	1
好景不长	hao jing bu chang	1
好看有限	hao kan you xian	1
好厉害	hao li hai	1
好难请	hao nan qing	1
好捏	hao nie	1
好色之徒	hao se zhi tu	1
好上加好	hao shang jia hao	1
好伟大	hao wei da	1
合在一起干	he zai yi qi gan	1
黑吃黑	hei chi hei	1
黑老鸦下了个白鸡蛋	hei lao ya xia le ge bai ji dan	1
黑李这碰见猛张飞	hei li zhe peng jian meng zhang fei	1
黑下脏来	hei xia zang lai	1
黑瞎子吃石榴	hei xia zi chi shi liu	1
黑瞎子上轿	hei xia zi shang jiao	1
黑瞎子耍门扛	hei xia zi shua men kang	1
黑旋风的本名	hei xuan feng de ben ming	1
狠对狠	hen dui hen	1
恨人不死	hen ren bu si	1
横冲直撞	heng chong zhi zhuang	1
横闯一个点儿	heng chuang yi ge dian er	1
横杠竹子	heng gang zhu zi	1
哼哈二将斗法	heng ha er jiang dou fa	1
横说竖说都有理	heng shuo shu shuo dou you li	1
横行霸道	heng xing ba dao	1
横行不了	heng xing bu liao	1
红不过一会儿了	hong bu guo yi hui er le	1
红不久	hong bu jiu	1
红到顶了	hong dao ding le	1
红光满面	hong guang man mian	1
红花女做媒	hong hua nv zuo mei	1
烘炉里的王八	hong lu li de wang ba	1
红娘挨打	hong niang ai da	1
红人	hong ren	1
红运将至	hong yun jiang zhi	1
洪泽湖的鱼鹰	hong ze hu de yu ying	1
后半截	hou ban jie	1
后患无穷	hou huan wu qiong	1
后悔已晚	hou hui yi wan	1
后劲大	hou jin da	1
后来居上	hou lai ju shang	1
喉咙长刺口生疮	hou long zhang ci kou sheng chuang	1
猴学样	hou xue yang	1
猴子戴凉帽	hou zi dai liang mao	1
猴子的屁股	hou zi de pi gu	1
猴子扇扇子	hou zi shan shan zi	1
互不相干	hu bu xiang gan	1
护城河的王八	hu cheng he de wang ba	1
糊糊涂涂	hu hu tu tu	1
胡砍	hu kan	1
胡拉乱扯	hu la luan che	1
狐狸吃不到的葡萄	hu li chi bu dao de pu tao	1
狐狸吃刺猬	hu li chi ci wei	1
狐狸钻罐子	hu li zuan guan zi	1
葫芦掉井里	hu lu diao jing li	1
葫芦蜂的窝	hu lu feng de wo	1
葫芦里卖药	hu lu li mai yao	1
葫芦里装水	hu lu li zhuang shui	1
胡萝卜就烧酒	hu luo bo jiu shao jiu	1
胡萝卜刻的小孩儿	hu luo bo ke de xiao hai er	1
胡扑打	hu pu da	1
猢狲穿衣裳	hu sun chuan yi shang	1
胡屠户的女婿	hu tu hu de nv xu	1
互相照应	hu xiang zhao ying	1
画笔敲敲	hua bi qiao qiao	1
华而不实	hua er bu shi	1
花岗岩下油锅	hua gang yan xia you guo	1
花骨朵碰在屠刀上	hua gu duo peng zai tu dao shang	1
花果山上没外姓	hua guo shan shang mei wai xing	1
花架下养鸡鸭	hua jia xia yang ji ya	1
画匠不给神作揖	hua jiang bu gei shen zuo yi	1
花轿前的乐队	hua jiao qian de yue dui	1
画面上的酒菜	hua mian shang de jiu cai	1
花瓶里种树	hua ping li zhong shu	1
话中带刺	hua zhong dai ci	1
坏到一块了	huai dao yi kuai le	1
怀的鬼胎	huai de gui tai	1
怀儿婆的口粮	huai er po de kou liang	1
皇帝补皮鞋	huang di bu pi xie	1
黄豆煮豆腐	huang dou zhu dou fu	1
黄连树上结糖梨	huang lian shu shang jie tang li	1
黄连树下种苦瓜	huang lian shu xia zhong ku gua	1
荒凉	huang liang	1
黄牛拉磨	huang niu la mo	1
黄鼠狼抽了筋	huang shu lang chou le jin	1
黄鼠狼的脾气	huang shu lang de pi qi	1
黄鼠狼见了鸡	huang shu lang jian le ji	1
黄鼠狼下息	huang shu lang xia xi	1
会唱会跳	hui chang hui tiao	1
回头见高低	hui tou jian gao di	1
回头难	hui tou nan	1
悔之莫及	hui zhi mo ji	1
会走不会飞	hui zou bu hui fei	1
浑蛋	hun dan	1
混蛋到底	hun dan dao di	1
混饭吃	hun fan chi	1
混年号	hun nian hao	1
浑身打哆哆	hun shen da duo duo	1
浑身都软了	hun shen dou ruan le	1
浑身是气	hun shen shi qi	1
活蹦乱跳	huo beng luan tiao	1
豁出来了	huo chu lai le	1
豁出去了	huo chu qu le	1
火气太大	huo qi tai da	1
货色不多架势不大	huo se bu duo jia shi bu da	1
祸在眼前	huo zai yan qian	1
豁子吵嘴	huo zi chao zui	1
豁子喝米汤	huo zi he mi tang	1
鸡肠舌刮油	ji chang she gua you	1
记吃不记打	ji chi bu ji da	1
机关枪瞄大炮	ji guan qiang miao da pao	1
唧唧喳喳	ji ji zha zha	1
脊梁骨上长茄子	ji liang gu shang chang qie zi	1
积木搭墙	ji mu da qiang	1
急人之所急	ji ren zhi suo ji	1
藉丝炒黄豆芽	ji si chao huang dou ya	1
畸形人做衣服	ji xing ren zuo yi fu	1
贾宝玉出家	jia bao yu chu jia	1
贾宝玉的通灵玉	jia bao yu de tong ling yu	1
贾宝玉看西厢记	jia bao yu kan xi xiang ji	1
假充鹰	jia chong ying	1
假的	jia de	1
贾府门前的狮子	jia fu men qian de shi zi	1
嫁祸于人	jia huo yu ren	1
贾家姑娘嫁贾家	jia jia gu niang jia jia jia	1
假门假事	jia men jia shi	1
家人不认识一家人	jia ren bu ren shi yi jia ren	1
见不得人	jian bu de ren	1
奸臣当道	jian chen dang dao	1
煎过三遍的药渣	jian guo san bian de yao zha	1
贱货	jian huo	1
见窟窿就钻	jian ku long jiu zuan	1
见面就崩	jian mian jiu beng	1
见死不救	jian si bu jiu	1
肩头上放花炮	jian tou shang fang hua pao	1
见异思迁	jian yi si qian	1
见者有份	jian zhe you fen	1
讲风凉话	jiang feng liang hua	1
蒋干盗书	jiang gan dao shu	1
酱缸腌时子	jiang gang yan shi zi	1
酱坛里装个鳖	jiang tan li zhuang ge bie	1
脚踩两只船	jiao cai liang zhi chuan	1
脚踩西瓜皮手里抓把泥	jiao cai xi gua pi shou li zhua ba ni	1
脚蹬鼻子	jiao deng bi zi	1
脚底下踩棒槌	jiao di xia cai bang chui	1
跤龙头上搔痒	jiao long tou shang sao yang	1
脚盆里撑船	jiao pen li cheng chuan	1
教菩萨认字	jiao pu sa ren zi	1
叫人眼饱肚饥	jiao ren yan bao du ji	1
脚踏实地	jiao ta shi di	1
狡兔撞鹰	jiao tu zhuang ying	1
结果不好	jie guo bu hao	1
街上卖笛	jie shang mai di	1
借题发挥	jie ti fa hui	1
街头的狗	jie tou de gou	1
街头上耍把戏	jie tou shang shua ba xi	1
进不得城	jin bu de cheng	1
金不换	jin bu huan	1
尽见鬼	jin jian gui	1
尽讲风凉话	jin jiang feng liang hua	1
斤斤计较	jin jin ji jiao	1
进来容易出去难	jin lai rong yi chu qu nan	1
浸湿的木头	jin shi de mu tou	1
尽是老调	jin shi lao diao	1
进退两难	jin tui liang nan	1
尽往上看	jin wang shang kan	1
紧往上爬	jin wang shang pa	1
尽想好事	jin xiang hao shi	1
紧相连	jin xiang lian	1
紧着裤子数日月	jin zhe ku zi shu ri yue	1
尽捉弄人	jin zhuo nong ren	1
经不起风雨	jing bu qi feng yu	1
经不起推敲	jing bu qi tui qiao	1
经得起打击	jing de qi da ji	1
惊弓之鸟	jing gong zhi niao	1
京戏走台步	jing xi zou tai bu	1
惊蛰后的蜈蚣	jing zhe hou de wu gong	1
镜子里亲嘴	jing zi li qin zui	1
就当自己长得白	jiu dang zi ji zhang de bai	1
酒鬼掉进酒池里	jiu gui diao jin jiu chi li	1
酒鬼喝汽水	jiu gui he qi shui	1
揪着马尾巴赛跑	jiu zhe ma wei ba sai pao	1
就着猪肉吃油条	jiu zhe zhu rou chi you tiao	1
酒盅里拌黄瓜	jiu zhong li ban huang gua	1
决不回头	jue bu hui tou	1
绝户头得个改家子	jue hu tou de ge gai jia zi	1
决了堤的水	jue le di de shui	1
撅着屁股看天	jue zhe pi gu kan tian	1
开弓的箭	kai gong de jian	1
开卦府的包公	kai gua fu de bao gong	1
开棺验尸	kai guan yan shi	1
开花的白菜	kai hua de bai cai	1
开花期遇暴雨	kai hua qi yu bao yu	1
开会差半点	kai hui cha ban dian	1
开会请了假	kai hui qing le jia	1
开局摆开拦河车	kai ju bai kai lan he che	1
开局的兵卒	kai ju de bing zu	1
开了闸的河水	kai le zha de he shui	1
开溜	kai liu	1
开水里捞肥皂	kai shui li lao fei zao	1
开水泡黄豆	kai shui pao huang dou	1
开水泼老鼠	kai shui po lao shu	1
开水碗上的葱花	kai shui wan shang de cong hua	1
开水洗脸	kai shui xi lian	1
开水煮白玉	kai shui zhu bai yu	1
开洋荤	kai yang hun	1
开着电扇聊天	kai zhe dian shan liao tian	1
开着收音机听戏	kai zhe shou yin ji ting xi	1
开着拖拉机撵兔子	kai zhe tuo la ji nian tu zi	1
砍不倒大树	kan bu dao da shu	1
看不上眼	kan bu shang yan	1
看错人了	kan cuo ren le	1
砍倒大树捉鸟	kan dao da shu zhuo niao	1
砍倒的柳树	kan dao de liu shu	1
看多少算多少	kan duo shao suan duo shao	1
看家拳头	kan jia quan tou	1
看见和尚喊姨夫	kan jian he shang han yi fu	1
看见尼姑喊嫂子	kan jian ni gu han sao zi	1
看见外公叫爷爷	kan jian wai gong jiao ye ye	1
看门的神仙	kan men de shen xian	1
看你咋吹	kan ni za chui	1
看破戏尘	kan po xi chen	1
看人挑担	kan ren tiao dan	1
砍树吃桔子	kan shu chi ju zi	1
看戏挑媳妇	kan xi tiao xi fu	1
看羊的狗	kan yang de gou	1
看衣裳行事	kan yi shang xing shi	1
看着天说话	kan zhe tian shuo hua	1
靠不住	kao bu zhu	1
刻薄	ke bo	1
嗑瓜子吃核桃	ke gua zi chi he tao	1
嗑瓜子瞌出个臭虫	ke gua zi ke chu ge chou chong	1
嗑瓜子嗑出虾米来	ke gua zi ke chu xia mi lai	1
客气碰着老实	ke qi peng zhe lao shi	1
瞌睡送个枕头	ke shui song ge zhen tou	1
磕完头撒供	ke wan tou sa gong	1
肯定	ken ding	1
肯定了	ken ding le	1
啃着鱼骨聊天	ken zhe yu gu liao tian	1
坑到家了	keng dao jia le	1
坑人不浅	keng ren bu qian	1
空袋了	kong dai le	1
空肚子打饱隔	kong du zi da bao ge	1
空费芯	kong fei xin	1
空架子	kong jia zi	1
空劳神	kong lao shen	1
空手进衙门	kong shou jin ya men	1
空手跑进中药店	kong shou pao jin zhong yao dian	1
空手抓白鱼	kong shou zhua bai yu	1
空想	kong xiang	1
空心罗汉	kong xin luo han	1
口蜜腹剑	kou mi fu jian	1
窟窿套窟窿	ku long tao ku long	1
苦苗苗	ku miao miao	1
苦生苦长	ku sheng ku chang	1
苦水里泡大的	ku shui li pao da de	1
苦也	ku ye	1
苦竹子根头出苦笋	ku zhu zi gen tou chu ku sun	1
筷子搭桥	kuai zi da qiao	1
筷子顶豆腐	kuai zi ding dou fu	1
筷子里拔旗杆	kuai zi li ba qi gan	1
筐里选瓜	kuang li xuan gua	1
葵花籽里拌盐水	kui hua zi li ban yan shui	1
拉肚子吃泻药	la du zi chi xie yao	1
垃圾堆里的破鞋	la ji dui li de po xie	1
辣椒炒豆腐	la jiao chao dou fu	1
蜡台上无油	la tai shang wu you	1
腊鸭子煮到锅里头	la ya zi zhu dao guo li tou	1
腊月里扇扇子	la yue li shan shan zi	1
拉着手走路	la zhe shou zou lu	1
蜡烛的脾气	la zhu de pi qi	1
癞蛤蟆穿大红袍	lai ha ma chuan da hong pao	1
癞蛤蟆打吹欠	lai ha ma da chui qian	1
赖泥下窑	lai ni xia yao	1
来头不小	lai tou bu xiao	1
癞子的脑袋	lai zi de nao dai	1
烂板桥上的龙王	lan ban qiao shang de long wang	1
懒厨子做席	lan chu zi zuo xi	1
滥竿充数	lan gan chong shu	1
烂膏药贴在好肉上	lan gao yao tie zai hao rou shang	1
懒驴上磨	lan lv shang mo	1
烂泥里打桩子	lan ni li da zhuang zi	1
烂泥菩萨	lan ni pu sa	1
烂泥菩萨洗脸	lan ni pu sa xi lian	1
烂泥土下窑	lan ni tu xia yao	1
懒婆娘的裹脚布	lan po niang de guo jiao bu	1
烂鱼开了膛	lan yu kai le tang	1
狼吃狼	lang chi lang	1
榔头对锤子	lang tou dui chui zi	1
狼惜猪娃	lang xi zhu wa	1
浪中行船	lang zhong hang chuan	1
浪子回头	lang zi hui tou	1
老等	lao deng	1
老调子	lao diao zi	1
劳而无功	lao er wu gong	1
牢房里赌博	lao fang li du bo	1
老肥猪上屠场	lao fei zhu shang tu chang	1
老坟头里的尸骨	lao fen tou li de shi gu	1
老鸹叮蚌壳	lao gua ding bang ke	1
老光棍	lao guang gun	1
老海瑞上金殿	lao hai rui shang jin dian	1
老猴爬旗杆	lao hou pa qi gan	1
老虎的儿子	lao hu de er zi	1
老虎和猪生的	lao hu he zhu sheng de	1
老虎皮兔子胆	lao hu pi tu zi dan	1
老糊涂	lao hu tu	1
老奸巨猾	lao jian ju hua	1
老来俏	lao lai qiao	1
老驴打滚	lao lv da gun	1
老母猪爬楼梯	lao mu zhu pa lou ti	1
老母猪上山	lao mu zhu shang shan	1
老牛拉破车	lao niu la po che	1
老牛钻狗洞	lao niu zuan gou dong	1
老实人	lao shi ren	1
老鼠扒屎盆	lao shu ba shi pen	1
老鼠管仓	lao shu guan cang	1
老鼠爬香炉	lao shu pa xiang lu	1
老鼠碰见猫	lao shu peng jian mao	1
老鼠睡猫窝	lao shu shui mao wo	1
老鼠偷秤砣	lao shu tou cheng tuo	1
老鼠咬屁股	lao shu yao pi gu	1
老水牛拉马车	lao shui niu la ma che	1
老太婆过年	lao tai po guo nian	1
老太婆啃鸡筋	lao tai po ken ji jin	1
老太太扎鞋底	lao tai tai zha xie di	1
老太爷看告示	lao tai ye kan gao shi	1
老鹰吃鸡毛	lao ying chi ji mao	1
老主意	lao zhu yi	1
老子纳妾儿姘居	lao zi na qie er pin ju	1
老子偷猪儿偷牛	lao zi tou zhu er tou niu	1
老子坐班房	lao zi zuo ban fang	1
乐颠了馅儿	le dian le xian er	1
冷不防	leng bu fang	1
冷落	leng luo	1
立不起来	li bu qi lai	1
立场不稳	li chang bu wen	1
理亏	li kui	1
里外发烧	li wai fa shao	1
恋恋不舍	lian lian bu she	1
脸上无光	lian shang wu guang	1
两人一份	liang ren yi fen	1
两想	liang xiang	1
两袖清风	liang xiu qing feng	1
两眼墨黑	liang yan mo hei	1
亮月下耍大刀	liang yue xia shua da dao	1
料不到	liao bu dao	1
零比零	ling bi ling	1
灵丹妙药	ling dan miao yao	1
另搞一套	ling gao yi tao	1
另有所图	ling you suo tu	1
溜了	liu le	1
留神	liu shen	1
溜须不要命	liu xu bu yao ming	1
溜须拍马	liu xu pai ma	1
留一手	liu yi shou	1
露底	lou di	1
路不宽	lu bu kuan	1
露骨	lu gu	1
露了蹄半山崖的观音	lu le ti ban shan ya de guan yin	1
露头角	lu tou jiao	1
卤煮寒鸭子	lu zhu han ya zi	1
乱蹦乱跳	luan beng luan tiao	1
乱联系	luan lian xi	1
乱牵扯	luan qian che	1
乱认亲	luan ren qin	1
略使小技	lue shi xiao ji	1
略显其能	lue xian qi neng	1
马鞭打牛	ma bian da niu	1
马槽边上的苍蝇	ma cao bian shang de cang ying	1
马车过沼泽地	ma che guo zhao ze di	1
麻袋里装麦秸	ma dai li zhuang mai jie	1
麻袋做龙袍	ma dai zuo long pao	1
麻秆搭桥	ma gan da qiao	1
麻秆做术腿	ma gan zuo shu tui	1
麻姑娘搽雪花膏	ma gu niang cha xue hua gao	1
蚂蟥叭在牛尾上	ma huang ba zai niu wei shang	1
麻秸抵门	ma jie di men	1
马脸比母猪头	ma lian bi mu zhu tou	1
麻脸姑娘掉井里	ma lian gu niang diao jing li	1
麻脸媳妇拜见上嘴婆	ma lian xi fu bai jian shang zui po	1
蚂蛉长毛	ma ling chang mao	1
麻柳树解板子	ma liu shu jie ban zi	1
马路上跑火车	ma lu shang pao huo che	1
马路新闻	ma lu xin wen	1
麻婆打扮	ma po da ban	1
麻婆照镜子	ma po zhao jing zi	1
麻雀搬家	ma que ban jia	1
麻雀吃桑葚	ma que chi sang shen	1
麻雀的肚腹	ma que de du fu	1
麻雀掉到洞庭湖里	ma que diao dao dong ting hu li	1
麻雀斗鸡	ma que dou ji	1
麻雀嫁女	ma que jia nv	1
马群里的骆驼	ma qun li de luo tuo	1
马勺当锣打	ma shao dang luo da	1
麻蛇钻刺棵	ma she zuan ci ke	1
麻绳穿针	ma sheng chuan zhen	1
麻绳打毛衣	ma sheng da mao yi	1
马食槽不许驴插嘴	ma shi cao bu xu lv cha zui	1
马桶里倒香水	ma tong li dao xiang shui	1
马桶上插花	ma tong shang cha hua	1
码头工人扛麻包	ma tou gong ren kang ma bao	1
马王爷	ma wang ye	1
马尾穿萝卜	ma wei chuan luo bo	1
马尾拴鸡蛋	ma wei shuan ji dan	1
麻线搓绳	ma xian cuo sheng	1
蚂蚁打食	ma yi da shi	1
麻油炒豆腐	ma you chao dou fu	1
蚂蚱配蝗虫	ma zha pei huang chong	1
码子前面添零	ma zi qian mian tian ling	1
麻子敲门	ma zi qiao men	1
麻子跳伞	ma zi tiao san	1
买车不要骡子	mai che bu yao luo zi	1
卖棺材的闻人重病	mai guan cai de wen ren zhong bing	1
卖棺材的咬牙	mai guan cai de yao ya	1
买回彩电带回发票	mai hui cai dian dai hui fa piao	1
麦秸烧火	mai jie shao huo	1
买卖不大架子大	mai mai bu da jia zi da	1
麦芒戮到眼睛里	mai mang lu dao yan jing li	1
买帽子当鞋穿	mai mao zi dang xie chuan	1
卖弄风流	mai nong feng liu	1
麦田里的韭菜	mai tian li de jiu cai	1
麦田里撒豌豆	mai tian li sa wan dou	1
买眼药进了石灰店	mai yan yao jin le shi hui dian	1
蛮不讲理	man bu jiang li	1
满肚子熊点子	man du zi xiong dian zi	1
慢工出细活	man gong chu xi huo	1
慢慢挪	man man nuo	1
慢慢腾腾	man man teng teng	1
满嘴喷粪	man zui pen fen	1
忙上加忙	mang shang jia mang	1
冒充打猎人	mao chong da lie ren	1
冒充富态	mao chong fu tai	1
冒货	mao huo	1
没安好心	mei an hao xin	1
没出息	mei chu xi	1
没得用	mei de yong	1
没肚量	mei du liang	1
没多大劲	mei duo da jin	1
没方子	mei fang zi	1
没福	mei fu	1
没高的	mei gao de	1
没骨气	mei gu qi	1
没几步跑头	mei ji bu pao tou	1
没见过大场面	mei jian guo da chang mian	1
没进步	mei jin bu	1
没脸回江东	mei lian hui jiang dong	1
没人领情	mei ren ling qing	1
没人要的货	mei ren yao de huo	1
美上天了	mei shang tian le	1
没什么两样	mei shen me liang yang	1
没水吃渴死人	mei shui chi ke si ren	1
没一点情味	mei yi dian qing wei	1
没影子	mei ying zi	1
没用处	mei yong chu	1
没有出路	mei you chu lu	1
没有回音	mei you hui yin	1
没有几句	mei you ji ju	1
没有看出你来	mei you kan chu ni lai	1
没有热乎劲	mei you re hu jin	1
没有日子了	mei you ri zi le	1
没有一块好的	mei you yi kuai hao de	1
没有用	mei you yong	1
没缘	mei yuan	1
没长劲	mei zhang jin	1
没指望	mei zhi wang	1
没咒念	mei zhou nian	1
没准儿	mei zhun er	1
门当户对	men dang hu dui	1
闷起来了	men qi lai le	1
懵门了	meng men le	1
迷迷糊糊	mi mi hu hu	1
弥天大谎	mi tian da huang	1
面面有用	mian mian you yong	1
勉强不得	mian qiang bu de	1
面生	mian sheng	1
明打明	ming da ming	1
命根子	ming gen zi	1
明砍	ming kan	1
明看不成器丢又舍不得	ming kan bu cheng qi diu you she bu de	1
摸不着底	mo bu zhao di	1
摸出来的	mo chu lai de	1
莫名其妙	mo ming qi miao	1
莫想	mo xiang	1
莫须有	mo xu you	1
木匠铺里拉大锯	mu jiang pu li la da ju	1
目空一切	mu kong yi qie	1
木偶流眼泪	mu ou liu yan lei	1
牧人不刮胡子	mu ren bu gua hu zi	1
木头人过河	mu tou ren guo he	1
拿菜刀哄孩子	na cai dao hong hai zi	1
拿根面条去上吊	na gen mian tiao qu shang diao	1
哪还用言	na hai yong yan	1
拿脑袋撞墙	na nao dai zhuang qiang	1
拿乌龟当锅盖	na wu gui dang guo gai	1
哪一壶不开单提哪一壶	na yi hu bu kai dan ti na yi hu	1
拿着车票进戏馆子	na zhe che piao jin xi guan zi	1
拿着碾盆打月亮	na zhe nian pen da yue liang	1
拿着铁锹当锅使	na zhe tie qiao dang guo shi	1
奈何不得	nai he bu de	1
耐滑头	nai hua tou	1
难产	nan chan	1
难缠	nan chan	1
难撑	nan cheng	1
难得	nan de	1
难得一回	nan de yi hui	1
难分色	nan fen se	1
难逢	nan feng	1
难过	nan guo	1
难回头	nan hui tou	1
难交	nan jiao	1
难嚼难咽	nan jiao nan yan	1
难看	nan kan	1
难劈	nan pi	1
难通过	nan tong guo	1
难脱身	nan tuo shen	1
难下手	nan xia shou	1
难养活	nan yang huo	1
闹个不停	nao ge bu ting	1
闹了个大窝脖	nao le ge da wo bo	1
脑门上开口	nao men shang kai kou	1
脑门上长瘤	nao men shang zhang liu	1
恼一个好一个	nao yi ge hao yi ge	1
闹钟打哈哈	nao zhong da ha ha	1
哪吒战小龙	ne zha zhan xiao long	1
内行	nei hang	1
内外勾结	nei wai gou jie	1
泥巴捏的小人	ni ba nie de xiao ren	1
你吃鸡鸭肉我啃窝窝头	ni chi ji ya rou wo ken wo wo tou	1
你东我西	ni dong wo xi	1
逆风点火	ni feng dian huo	1
泥佛爷的眼珠儿	ni fo ye de yan zhu er	1
尼姑生孩子	ni gu sheng hai zi	1
你来我去	ni lai wo qu	1
你卖门神我卖鬼	ni mai men shen wo mai gui	1
泥菩萨洗脸	ni pu sa xi lian	1
你去南极我去北极	ni qu nan ji wo qu bei ji	1
泥人经不起雨打	ni ren jing bu qi yu da	1
泥神笑菩萨	ni shen xiao pu sa	1
逆水行船	ni shui xing chuan	1
逆水行舟	ni shui xing zhou	1
你算哪一路	ni suan na yi lu	1
腻透了	ni tou le	1
你行我也行	ni xing wo ye xing	1
你也好不了多少	ni ye hao bu liao duo shao	1
你有秤杆我有砣	ni you cheng gan wo you tuo	1
泥蒸的馒头	ni zheng de man tou	1
你做生意我教书	ni zuo sheng yi wo jiao shu	1
年年都一样	nian nian dou yi yang	1
碾盘对碾盘	nian pan dui nian pan	1
拈轻怕重	nian qing pa zhong	1
念完了经打和尚	nian wan le jing da he shang	1
撵走孤狸住上狼	nian zou gu li zhu shang lang	1
鸟儿搬家	niao er ban jia	1
鸟枪换炮	niao qiang huan pao	1
捏死手中鸟	nie si shou zhong niao	1
捏着鼻尖儿做梦	nie zhe bi jian er zuo meng	1
宁折不弯	ning zhe bu wan	1
牛背上翻踉头	niu bei shang fan liang tou	1
牛犊子叫街	niu du zi jiao jie	1
牛犊子上套	niu du zi shang tao	1
牛皮鼓湿水	niu pi gu shi shui	1
牛牵鼻子马抓鬃	niu qian bi zi ma zhua zong	1
牛头不对马嘴	niu tou bu dui ma zui	1
牛羊的肚腹	niu yang de du fu	1
弄不多柴禾	nong bu duo chai he	1
暖水瓶爆烈	nuan shui ping bao lie	1
女孩子打架	nv hai zi da jia	1
女人的手腕	nv ren de shou wan	1
女婿认不得丈人	nv xu ren bu de zhang ren	1
藕炒豆芽	ou chao dou ya	1
沤烂的花生	ou lan de hua sheng	1
偶像面前磕头	ou xiang mian qian ke tou	1
怕是真的	pa shi zhen de	1
怕死碰见鬼子兵	pa si peng jian gui zi bing	1
趴在磨子上睡觉	pa zai mo zi shang shui jiao	1
拍照片不上卷	pai zhao pian bu shang juan	1
判官拍照	pan guan pai zhao	1
判官敲门	pan guan qiao men	1
判官玩魔术	pan guan wan mo shu	1
潘仁美挂帅	pan ren mei gua shuai	1
盼月亮从西出	pan yue liang cong xi chu	1
盘子里生豆芽	pan zi li sheng dou ya	1
胖大海掉进黄连水	pang da hai diao jin huang lian shui	1
螃蟹过门槛	pang xie guo men kan	1
螃蟹爬到路上	pang xie pa dao lu shang	1
螃蟹上树	pang xie shang shu	1
胖子排横队	pang zi pai heng dui	1
跑不了	pao bu liao	1
炮打林中鸟	pao da lin zhong niao	1
跑得快	pao de kuai	1
跑马吃烤鸭	pao ma chi kao ya	1
跑马使绊子	pao ma shi ban zi	1
配得起你	pei de qi ni	1
喷云吐雾	pen yun tu wu	1
碰了一鼻灰	peng le yi bi hui	1
捧着泥鳅玩	peng zhe ni qiu wan	1
碰着啥咬啥	peng zhe sha yao sha	1
屁股上扫帚	pi gu shang sao zhou	1
屁股上捅一刀	pi gu shang tong yi dao	1
披虎皮上山	pi hu pi shang shan	1
皮匠不带锥子	pi jiang bu dai zhui zi	1
皮裤套棉裤	pi ku tao mian ku	1
皮老心不老	pi lao xin bu lao	1
琵琶断了弦	pi pa duan le xian	1
脾气不一样	pi qi bu yi yang	1
脾气相投	pi qi xiang tou	1
皮球上戳眼眼	pi qiu shang chuo yan yan	1
皮球上磨刀	pi qiu shang mo dao	1
砒霜拌大葱	pi shuang ban da cong	1
皮鞋打蜡	pi xie da la	1
便宜买回的处理品	pian yi mai hui de chu li pin	1
骗子碰到骗子	pian zi peng dao pian zi	1
贫血病人	pin xue bing ren	1
平地搭梯子	ping di da ti zi	1
瓶子里的苍蝇	ping zi li de cang ying	1
破罐子破摔	po guan zi po shuai	1
破棉袄套绸衫	po mian ao tao chou shan	1
破庙里的菩萨	po miao li de pu sa	1
破土的春笋	po tu de chun sun	1
破袜子补帽沿	po wa zi bu mao yan	1
破网打鱼	po wang da yu	1
婆媳吵架儿子劝	po xi chao jia er zi quan	1
破鞋帮	po xie bang	1
破蒸笼蒸馒头	po zheng long zheng man tou	1
剖腹献肝胆	pou fu xian gan dan	1
剖鱼得珠	pou yu de zhu	1
葡萄汁充花露水	pu tao zhi chong hua lu shui	1
扑腾不开	pu teng bu kai	1
七八月的南瓜	qi ba yue de nan gua	1
气不打一处来	qi bu da yi chu lai	1
七尺汉子六尺门	qi chi han zi liu chi men	1
气得嘣八丈高	qi de beng ba zhang gao	1
七颠八倒	qi dian ba dao	1
乞丐过日子	qi gai guo ri zi	1
乞丐跳舞	qi gai tiao wu	1
漆黑一团	qi hei yi tuan	1
齐桓公用管仲	qi huan gong yong guan zhong	1
气急败坏	qi ji bai huai	1
起了心	qi le xin	1
骑驴看唱本	qi lv kan chang ben	1
骑驴望着坐轿的	qi lv wang zhe zuo jiao de	1
骑马上天山	qi ma shang tian shan	1
骑马时间少擦镫时间多	qi ma shi jian shao ca deng shi jian duo	1
骑牛找牛	qi niu zhao niu	1
棋盘里的老将	qi pan li de lao jiang	1
砌墙的砖头	qi qiang de zhuan tou	1
七石缸里捞芝麻	qi shi gang li lao zhi ma	1
七手八脚	qi shou ba jiao	1
齐头并迸	qi tou bing beng	1
七仙女嫁董永	qi xian nv jia dong yong	1
骑着骆驼吃包子	qi zhe luo tuo chi bao zi	1
起重机吊鸡毛	qi zhong ji diao ji mao	1
钱串子脑袋	qian chuan zi nao dai	1
千斤顶干活	qian jin ding gan huo	1
千里送客	qian li song ke	1
千里姻缘一线牵	qian li yin yuan yi xian qian	1
千年的大树	qian nian de da shu	1
千年的铜钟	qian nian de tong zhong	1
浅滩上放木排	qian tan shang fang mu pai	1
钱塘江涨潮	qian tang jiang zhang chao	1
前途光明	qian tu guang ming	1
谦虚	qian xu	1
钱也有权也有	qian ye you quan ye you	1
前有强敌后有追兵	qian you qiang di hou you zhui bing	1
千真万真	qian zhen wan zhen	1
强盗发善心	qiang dao fa shan xin	1
强盗碰着贼爷爷	qiang dao peng zhe zei ye ye	1
强盗照镜子	qiang dao zhao jing zi	1
强拉媳妇成亲	qiang la xi fu cheng qin	1
强人所难	qiang ren suo nan	1
墙头上的种白菜	qiang tou shang de zhong bai cai	1
墙头上种菜	qiang tou shang zhong cai	1
强装有本事	qiang zhuang you ben shi	1
巧媳妇	qiao xi fu	1
巧言哄人	qiao yan hong ren	1
秦桧杀岳飞的罪名	qin hui sha yue fei de zui ming	1
亲肉一块	qin rou yi kuai	1
秦叔宝的黄骡马	qin shu bao de huang luo ma	1
亲员	qin yuan	1
轻而易举	qing er yi ju	1
清高	qing gao	1
清了吧	qing le ba	1
青石板上的青苔	qing shi ban shang de qing tai	1
青石板上摔鸟龟	qing shi ban shang shuai niao gui	1
青蛙吃黄蜂	qing wa chi huang feng	1
青蛙过冬	qing wa guo dong	1
青蛙求偶	qing wa qiu ou	1
青蛙拴生鞭梢上	qing wa shuan sheng bian shao shang	1
青娃望玉兔	qing wa wang yu tu	1
青娃笑蝌蚪	qing wa xiao ke dou	1
请小姨子作伴	qing xiao yi zi zuo ban	1
蜻蜒点水鱼打花	qing yan dian shui yu da hua	1
青竹竿掏茅坑	qing zhu gan tao mao keng	1
穷得叮当响	qiong de ding dang xiang	1
穷鬼们聚到一块了	qiong gui men ju dao yi kuai le	1
穷横	qiong heng	1
穷极了	qiong ji le	1
穷快活	qiong kuai huo	1
穷相毕露	qiong xiang bi lu	1
穷壮胆	qiong zhuang dan	1
求之不得	qiu zhi bu de	1
全靠别人施舍	quan kao bie ren shi she	1
全落空	quan luo kong	1
全凭手快	quan ping shou kuai	1
全凭一张嘴	quan ping yi zhang zui	1
全是酸的	quan shi suan de	1
拳头打跳蚤	quan tou da tiao zao	1
蜷腿带拱腰	quan tui dai gong yao	1
全仗嘴	quan zhang zui	1
缺牙啃西瓜	que ya ken xi gua	1
瘸子骑瞎驴	que zi qi xia lv	1
瘸子走山路	que zi zou shan lu	1
染布不匀	ran bu bu yun	1
染坊的常客	ran fang de chang ke	1
染坊的大缸	ran fang de da gang	1
染房里吹笛子	ran fang li chui di zi	1
染坊里的衣料	ran fang li de yi liao	1
染缸里的衣服	ran gang li de yi fu	1
染缸里落白布	ran gang li luo bai bu	1
染匠的衣服	ran jiang de yi fu	1
染匠下河	ran jiang xia he	1
让结巴念绕回令	rang jie ba nian rao hui ling	1
让了香瓜寻苦瓜	rang le xiang gua xun ku gua	1
饶舌的鸟鸦	rao she de niao ya	1
饶舌的乌鸦	rao she de wu ya	1
热锅爆米花	re guo bao mi hua	1
热锅里的鸭子	re guo li de ya zi	1
热锅上的蚂蚁	re guo shang de ma yi	1
热锅上的蒸笼	re guo shang de zheng long	1
热火盆里抽火炭	re huo pen li chou huo tan	1
热炕头上的白面	re kang tou shang de bai mian	1
热面孔碰到冷毛巾	re mian kong peng dao leng mao jin	1
热情在里头	re qing zai li tou	1
热水瓶	re shui ping	1
热水瓶脾气	re shui ping pi qi	1
热水瓶上系索子	re shui ping shang xi suo zi	1
热蹄子马	re ti zi ma	1
热窝炒豆子	re wo chao dou zi	1
热中送扇雪中送炭	re zhong song shan xue zhong song tan	1
人把狗咬死了	ren ba gou yao si le	1
人才市场填个表	ren cai shi chang tian ge biao	1
人到矮檐下	ren dao ai yan xia	1
人到古稀穿花衣	ren dao gu xi chuan hua yi	1
人各有志	ren ge you zhi	1
人急跳窗户	ren ji tiao chuang hu	1
人老心不老	ren lao xin bu lao	1
人面鬼心	ren mian gui xin	1
任人摆布	ren ren bai bu	1
任人解剖	ren ren jie pou	1
忍痛图好看	ren tong tu hao kan	1
人熊家伙笨	ren xiong jia huo ben	1
人在屋檐下	ren zai wu yan xia	1
人在心不在	ren zai xin bu zai	1
人造牛黄	ren zao niu huang	1
任重道远	ren zhong dao yuan	1
人走家散	ren zou jia san	1
扔下讨饭篮打乞丐	reng xia tao fan lan da qi gai	1
扔下铁锤拿灯草	reng xia tie chui na deng cao	1
日出西山水倒流	ri chu xi shan shui dao liu	1
日落西山	ri luo xi shan	1
日子难过	ri zi nan guo	1
容不得半点火垦	rong bu de ban dian huo ken	1
绒毛鸭子刚下水	rong mao ya zi gang xia shui	1
绒球打脸	rong qiu da lian	1
绒球打锣	rong qiu da luo	1
肉案上的买卖	rou an shang de mai mai	1
肉包子打狗	rou bao zi da gou	1
肉骨头擂大鼓	rou gu tou lei da gu	1
肉骨头落了锅	rou gu tou luo le guo	1
肉锅里煮元宵	rou guo li zhu yuan xiao	1
肉烂在汤里	rou lan zai tang li	1
肉烂嘴不烂	rou lan zui bu lan	1
肉丸子掉迸煤堆里	rou wan zi diao beng mei dui li	1
柔中有刚	rou zhong you gang	1
入伏的高梁	ru fu de gao liang	1
如来佛的手心	ru lai fo de shou xin	1
软面包饺子	ruan mian bao jiao zi	1
软弱无能	ruan ruo wu neng	1
软中有硬	ruan zhong you ying	1
撒了谷子拾稻草	sa le gu zi shi dao cao	1
仨钱买匹马	sa qian mai pi ma	1
赛马场上的冠军	sai ma chang shang de guan jun	1
三百斤的野猪	san bai jin de ye zhu	1
三本经书掉了两本	san ben jing shu diao le liang ben	1
三岔口的地保	san cha kou de di bao	1
三寸舌头是软的	san cun she tou shi ruan de	1
三分钱买个臭猪蹄	san fen qian mai ge chou zhu ti	1
三伏天的狗	san fu tian de gou	1
三伏天的馊豆腐	san fu tian de sou dou fu	1
三个鼻孔眼儿	san ge bi kong yan er	1
三个醉汉撒酒疯	san ge zui han sa jiu feng	1
三根缆绳拴两边	san gen lan sheng shuan liang bian	1
三顾茅庐	san gu mao lu	1
三合板上雕花	san he ban shang diao hua	1
三间瓦房不开门	san jian wa fang bu kai men	1
三角挫刀	san jiao cuo dao	1
三角砖头	san jiao zhuan tou	1
三斤半鸭子二斤半嘴	san jin ban ya zi er jin ban zui	1
三九天吃梅子	san jiu tian chi mei zi	1
三句话不离本行	san ju hua bu li ben hang	1
三令五申	san ling wu shen	1
三五成群	san wu cheng qun	1
三心二意	san xin er yi	1
丧胆	sang dan	1
色厉内荏	se li nei ren	1
煞风景	sha feng jing	1
砂锅里的火药	sha guo li de huo yao	1
扇阴风	shan yin feng	1
上不着天下不着地	shang bu zhao tian xia bu zhao di	1
上帝保佑	shang di bao you	1
上晃下摇	shang huang xia yao	1
上了大当	shang le da dang	1
上脸	shang lian	1
上梁不正下梁歪	shang liang bu zheng xia liang wai	1
上气不接下气	shang qi bu jie xia qi	1
上下两难	shang xia liang nan	1
烧不成个东西	shao bu cheng ge dong xi	1
少不了挨一刀	shao bu liao ai yi dao	1
少见	shao jian	1
少有	shao you	1
设底儿	she di er	1
神气来了	shen qi lai le	1
身子烂了踊头还硬	shen zi lan le yong tou hai ying	1
生了外心	sheng le wai xin	1
士兵搭帐篷	shi bing da zhang peng	1
实打实	shi da shi	1
时高时低	shi gao shi di	1
屎壳郎打喷嚏	shi ke lang da pen ti	1
屎壳郎戴面具	shi ke lang dai mian ju	1
失面子	shi mian zi	1
十拿九稳	shi na jiu wen	1
屎尿多	shi niao duo	1
使偏劲	shi pian jin	1
十五只小船出海	shi wu zhi xiao chuan chu hai	1
实心实意	shi xin shi yi	1
实心竹竿做笛子	shi xin zhu gan zuo di zi	1
实心竹子做笛子	shi xin zhu zi zuo di zi	1
十有九空	shi you jiu kong	1
施展不开	shi zhan bu kai	1
食之无味弃之可惜	shi zhi wu wei qi zhi ke xi	1
受潮的麻花	shou chao de ma hua	1
手电筒没灯泡	shou dian tong mei deng pao	1
受了冷气受热气	shou le leng qi shou re qi	1
瘦驴拉硬屎	shou lv la ying shi	1
手捧鸡蛋过河	shou peng ji dan guo he	1
受人牵连	shou ren qian lian	1
瘦死的骆驼	shou si de luo tuo	1
寿星出点子	shou xing chu dian zi	1
寿星娶小	shou xing qu xiao	1
瘦子光膀几	shou zi guang bang ji	1
树不起来	shu bu qi lai	1
属大肠的	shu da chang de	1
熟得早	shu de zao	1
属地瓜的	shu di gua de	1
属狗尾巴的	shu gou wei ba de	1
熟螃蟹	shu pang xie	1
树梢上吹喇叭	shu shao shang chui la ba	1
暑天下大雪	shu tian xia da xue	1
树叶子掉到河里	shu ye zi diao dao he li	1
熟一个蹦一个	shu yi ge beng yi ge	1
树桩上的鸟儿	shu zhuang shang de niao er	1
耍滑头	shua hua tou	1
耍皮影子的	shua pi ying zi de	1
甩不掉	shuai bu diao	1
甩不脱	shuai bu tuo	1
双胞胎比长相	shuang bao tai bi chang xiang	1
霜打的黄瓜	shuang da di huang gua	1
霜打的麻叶	shuang da di ma ye	1
双喜临门	shuang xi lin men	1
水壶里盛汤圆	shui hu li cheng tang yuan	1
水浸菩萨	shui jin pu sa	1
水里的蛤蟆	shui li de ha ma	1
水面打一棒	shui mian da yi bang	1
水牛吃活蟹	shui niu chi huo xie	1
水牛过河	shui niu guo he	1
水泡豆子	shui pao dou zi	1
水平太低	shui ping tai di	1
水平有限	shui ping you xian	1
水獭找泥鳅	shui ta zhao ni qiu	1
谁抬你啊	shui tai ni a	1
谁也甭想逃出去	shui ye beng xiang tao chu qu	1
谁也别说谁	shui ye bie shuo shui	1
谁也不吃亏	shui ye bu chi kui	1
谁也不正眼看谁	shui ye bu zheng yan kan shui	1
谁有吃就跟谁走	shui you chi jiu gen shui zou	1
说不出个好处来	shuo bu chu ge hao chu lai	1
说不出好话来	shuo bu chu hao hua lai	1
说不通	shuo bu tong	1
说得多	shuo de duo	1
说黑话	shuo hei hua	1
说亮话	shuo liang hua	1
死不放	si bu fang	1
死不甘心	si bu gan xin	1
死不了人	si bu liao ren	1
死不要脸	si bu yao lian	1
死尽忠心	si jin zhong xin	1
死心眼儿	si xin yan er	1
送福	song fu	1
送来一口肉	song lai yi kou rou	1
素不相识	su bu xiang shi	1
随波逐流	sui bo zhu liu	1
塌鼻子嫁个斜眼	ta bi zi jia ge xie yan	1
塔顶散步	ta ding san bu	1
塌锅干饭	ta guo gan fan	1
踏死蛤蟆肚子胀	ta si ha ma du zi zhang	1
太把自己看大了	tai ba zi ji kan da le	1
抬棺材的掉裤子	tai guan cai de diao ku zi	1
太极拳的功夫	tai ji quan de gong fu	1
太监出家	tai jian chu jia	1
太平洋搬家	tai ping yang ban jia	1
太平洋上的警察	tai ping yang shang de jing cha	1
泰山顶上唱大戏	tai shan ding shang chang da xi	1
台上唱戏台下打鼾	tai shang chang xi tai xia da han	1
太上老君开处方	tai shang lao jun kai chu fang	1
太岁乡头坐	tai sui xiang tou zuo	1
抬腿上楼梯	tai tui shang lou ti	1
太阳地里望星星	tai yang di li wang xing xing	1
太阳底下点灯	tai yang di xia dian deng	1
谈崩了	tan beng le	1
谈不上	tan bu shang	1
贪吃不留种	tan chi bu liu zhong	1
弹棉花胎的进官	tan mian hua tai de jin guan	1
贪便宜	tan pian yi	1
炭筛子筛芝麻	tan shai zi shai zhi ma	1
檀香木盖茅坑	tan xiang mu gai mao keng	1
谈心不点灯	tan xin bu dian deng	1
贪心鬼	tan xin gui	1
瘫子靠跛子	tan zi kao bo zi	1
坛子里的咸菜	tan zi li de xian cai	1
坛子里和面	tan zi li huo mian	1
瘫子请客	tan zi qing ke	1
贪嘴的鱼儿	tan zui de yu er	1
躺在功劳簿上睡大觉	tang zai gong lao bu shang shui da jiao	1
躺在棺材里想金条	tang zai guan cai li xiang jin tiao	1
躺着说话	tang zhe shuo hua	1
讨吃的喂猴	tao chi de wei hou	1
讨饭找马骑	tao fan zhao ma qi	1
陶工手里的粘上	tao gong shou li de zhan shang	1
讨媳妇嫁女儿	tao xi fu jia nv er	1
套袖改袜子	tao xiu gai wa zi	1
腾云驾雾	teng yun jia wu	1
替狗忙	ti gou mang	1
剃头的动手	ti tou de dong shou	1
剃头匠发火	ti tou jiang fa huo	1
提心吊胆	ti xin diao dan	1
提着灯笼打柴	ti zhe deng long da chai	1
提着口袋倒核桃	ti zhe kou dai dao he tao	1
田埂上搭桥	tian geng shang da qiao	1
甜果都从苦根来	tian guo dou cong ku gen lai	1
天黑敬菩萨	tian hei jing pu sa	1
天花乱坠	tian hua luan zhui	1
天降良缘	tian jiang liang yuan	1
田里的庄稼	tian li de zhuang jia	1
填满肚子算事	tian man du zi suan shi	1
甜蜜	tian mi	1
天上的老鹰不吃脏东西	tian shang de lao ying bu chi zang dong xi	1
田鼠走亲戚	tian shu zou qin qi	1
天天向上	tian tian xiang shang	1
田头训子	tian tou xun zi	1
天下奇闻	tian xia qi wen	1
挑灯草走路	tiao deng cao zou lu	1
挑水骑单车	tiao shui qi dan che	1
铁面无私	tie mian wu si	1
铁蛇掉井里	tie she diao jing li	1
听见猫叫骨头酥	ting jian mao jiao gu tou su	1
听哑巴唱戏	ting ya ba chang xi	1
亭子里谈心	ting zi li tan xin	1
同行	tong hang	1
童养媳当媒人	tong yang xi dang mei ren	1
同一个马鞍上的人	tong yi ge ma an shang de ren	1
偷吃的猫儿	tou chi de mao er	1
偷吃海椒挨耳光	tou chi hai jiao ai er guang	1
偷鸡不成蚀把米	tou ji bu cheng shi ba mi	1
偷鸡摸蛋	tou ji mo dan	1
偷来的喇叭	tou lai de la ba	1
头破血流	tou po xue liu	1
头挑	tou tiao	1
头头是道	tou tou shi dao	1
突出	tu chu	1
屠夫说猪农夫说谷	tu fu shuo zhu nong fu shuo gu	1
屠夫送礼	tu fu song li	1
图个干脆	tu ge gan cui	1
土里来泥里去	tu li lai ni li qu	1
土生土长	tu sheng tu zhang	1
土腥味	tu xing wei	1
秃子脑袋当玩具	tu zi nao dai dang wan ju	1
秃子揍和尚	tu zi zou he shang	1
团团转	tuan tuan zhuan	1
挖苦	wa ku	1
挖一个少一个	wa yi ge shao yi ge	1
外辣里软	wai la li ruan	1
外面冷里头热	wai mian leng li tou re	1
外头凉里面热	wai tou liang li mian re	1
玩的骗人术	wan de pian ren shu	1
晚了迟了	wan le chi le	1
玩心不退	wan xin bu tui	1
忘本	wang ben	1
枉费心机	wang fei xin ji	1
忘了自己从哪来了	wang le zi ji cong na lai le	1
望洋兴叹	wang yang xing tan	1
往最坏处想	wang zui huai chu xiang	1
尾巴翘上天	wei ba qiao shang tian	1
为的是嘴	wei de shi zui	1
威风扫地	wei feng sao di	1
为民请命	wei min qing ming	1
未知经过多少风雨	wei zhi jing guo duo shao feng yu	1
蚊龙困在沙滩上	wen long kun zai sha tan shang	1
文明人不做文明事	wen ming ren bu zuo wen ming shi	1
闻声不见人	wen sheng bu jian ren	1
纹丝不动	wen si bu dong	1
窝脖	wo bo	1
握不住	wo bu zhu	1
无不识货	wu bu shi huo	1
无耻下流	wu chi xia liu	1
无出路	wu chu lu	1
无痕迹	wu hen ji	1
无可奈何	wu ke nai he	1
无奇不有	wu qi bu you	1
无牵无挂	wu qian wu gua	1
无情	wu qing	1
无人买	wu ren mai	1
无伤痕	wu shang hen	1
无事不来	wu shi bu lai	1
无事生非	wu shi sheng fei	1
武艺高	wu yi gao	1
无依无靠	wu yi wu kao	1
无用	wu yong	1
吸饱风的帆	xi bao feng de fan	1
喜出望外	xi chu wang wai	1
细吹细打	xi chui xi da	1
稀饭锅里扔铁砣	xi fan guo li reng tie tuo	1
膝盖头套袜子	xi gai tou tao wa zi	1
西瓜皮打鞋掌	xi gua pi da xie zhang	1
西瓜皮做帽子	xi gua pi zuo mao zi	1
细嚼馒咽	xi jiao man yan	1
洗脸盆里游泳	xi lian pen li you yong	1
喜马拉雅山上卖牛黄	xi ma la ya shan shang mai niu huang	1
西门庆请武大郎	xi men qing qing wu da lang	1
惜钱不治病	xi qian bu zhi bing	1
喜鹊落头上	xi que luo tou shang	1
西山猛虎不咬人	xi shan meng hu bu yao ren	1
西施坐飞机	xi shi zuo fei ji	1
蟋蟀斗公鸡	xi shuai dou gong ji	1
戏台后头的锣鼓	xi tai hou tou de luo gu	1
戏台上拜天地	xi tai shang bai tian di	1
戏台上堵枪眼	xi tai shang du qiang yan	1
嘻嘻哈哈年过十八	xi xi ha ha nian guo shi ba	1
西厢记作枕头	xi xiang ji zuo zhen tou	1
戏园子失火	xi yuan zi shi huo	1
惜债买藉吃	xi zhai mai ji chi	1
戏中有戏	xi zhong you xi	1
下不了口	xia bu liao kou	1
吓不住人	xia bu zhu ren	1
瞎逞能	xia cheng neng	1
下大雪找蹄印	xia da xue zhao ti yin	1
瞎打一阵	xia da yi zhen	1
下地不穿鞋	xia di bu chuan xie	1
瞎姑娘戴眼镜	xia gu niang dai yan jing	1
吓唬人	xia hu ren	1
吓唬人哩	xia hu ren li	1
下轿打轿夫	xia jiao da jiao fu	1
瞎了眼的癞皮狗	xia le yan de lai pi gou	1
瞎妹子当媒人	xia mei zi dang mei ren	1
虾吞礁石	xia tun jiao shi	1
瞎张罗	xia zhang luo	1
瞎子背瞎子	xia zi bei xia zi	1
瞎子吃黄瓜	xia zi chi huang gua	1
瞎子打过独林桥	xia zi da guo du lin qiao	1
瞎子逛商店	xia zi guang shang dian	1
虾子过河	xia zi guo he	1
瞎子夹豆腐	xia zi jia dou fu	1
瞎子救人	xia zi jiu ren	1
瞎子上街	xia zi shang jie	1
闲不住	xian bu zhu	1
咸菜拌豆腐	xian cai ban dou fu	1
咸菜缸里养白螺	xian cai gang li yang bai luo	1
咸菜煮豆腐	xian cai zhu dou fu	1
险乎得很	xian hu de hen	1
闲话不少	xian hua bu shao	1
咸肉里加酱油	xian rou li jia jiang you	1
咸鱼落塘	xian yu luo tang	1
想不透	xiang bu tou	1
香臭不分	xiang chou bu fen	1
香臭难分	xiang chou nan fen	1
想得倒美	xiang de dao mei	1
想得宽	xiang de kuan	1
享福又受苦	xiang fu you shou ku	1
象个人似的	xiang ge ren shi de	1
橡皮糖	xiang pi tang	1
想沾点仙气	xiang zhan dian xian qi	1
想转了	xiang zhuan le	1
小鬼的嘴里都冒烟	xiao gui de zui li dou mao yan	1
小题大作	xiao ti da zuo	1
小心过度	xiao xin guo du	1
鞋底打掌	xie di da zhang	1
鞋底抹油	xie di mo you	1
鞋壳篓里跑马	xie ke lou li pao ma	1
泄气	xie qi	1
鞋上绣金夙	xie shang xiu jin su	1
心到神知	xin dao shen zhi	1
新郎官戴孝	xin lang guan dai xiao	1
新郎官揭盖头	xin lang guan jie gai tou	1
新女婿请接生婆	xin nv xu qing jie sheng po	1
新上门的姑爷	xin shang men de gu ye	1
新上市的黄瓜	xin shang shi de huang gua	1
心碎	xin sui	1
新媳妇吃饭	xin xi fu chi fan	1
新媳妇哭公公	xin xi fu ku gong gong	1
新学	xin xue	1
心眼多	xin yan duo	1
心眼狭小	xin yan xia xiao	1
新衣服打补丁	xin yi fu da bu ding	1
行不通	xing bu tong	1
行不通走不通	xing bu tong zou bu tong	1
杏花村的酒	xing hua cun de jiu	1
兴师动众	xing shi dong zhong	1
星星跟着月亮走	xing xing gen zhe yue liang zou	1
凶多吉少	xiong duo ji shao	1
胸前划十字	xiong qian hua shi zi	1
凶神恶煞	xiong shen e sha	1
熊耍把戏狗叫唤	xiong shua ba xi gou jiao huan	1
秀才的手中	xiu cai de shou zhong	1
秀才偷笔	xiu cai tou bi	1
秀才遇到虎	xiu cai yu dao hu	1
绣花姑娘打架	xiu hua gu niang da jia	1
羞死人	xiu si ren	1
休想	xiu xiang	1
许不下羊羔许骆驼	xu bu xia yang gao xu luo tuo	1
虚度年华	xu du nian hua	1
虚情当成真意	xu qing dang cheng zhen yi	1
虚情假意	xu qing jia yi	1
许仙碰着白娘子	xu xian peng zhe bai niang zi	1
虚张声势	xu zhang sheng shi	1
宣统坐江山	xuan tong zuo jiang shan	1
雪堆的假山	xue dui de jia shan	1
薛仁贵的行头	xue ren gui de xing tou	1
薛仁贵征东	xue ren gui zheng dong	1
学人样	xue ren yang	1
鸭棚的老汉睡懒觉	ya peng de lao han shui lan jiao	1
眼馋	yan chan	1
言传身教	yan chuan shen jiao	1
烟袋锅烤手	yan dai guo kao shou	1
烟袋锅里煮饭	yan dai guo li zhu fan	1
盐堆里爬出来的人	yan dui li pa chu lai de ren	1
烟灰抹面皮	yan hui mo mian pi	1
眼睛上出芽了	yan jing shang chu ya le	1
眼里的灰尘	yan li de hui chen	1
腌萝卜拌黄瓜	yan luo bo ban huang gua	1
阎王开店	yan wang kai dian	1
阎王爷的扇子	yan wang ye de shan zi	1
阎王爷做的芝麻饼	yan wang ye zuo de zhi ma bing	1
唁闲嗑	yan xian ke	1
演员谢幕	yan yuan xie mu	1
严阵以待	yan zhen yi dai	1
杨继业数儿子	yang ji ye shu er zi	1
养麦地里藏秃子	yang mai di li cang tu zi	1
养麦地里抓王八	yang mai di li zhua wang ba	1
羊群里跑出个骆驼	yang qun li pao chu ge luo tuo	1
养在圈里的猪	yang zai quan li de zhu	1
杨志卖刀	yang zhi mai dao	1
样子神气	yang zi shen qi	1
药店里招手	yao dian li zhao shou	1
要饭的打狗	yao fan de da gou	1
要饭的拿饼子	yao fan de na bing zi	1
要饭的拿戳子	yao fan de na chuo zi	1
腰杆子硬	yao gan zi ying	1
腰里别钢筋	yao li bie gang jin	1
腰里别镰刀	yao li bie lian dao	1
腰里掖着个扁担	yao li ye zhe ge bian dan	1
药铺里卖棺材	yao pu li mai guan cai	1
妖言惑众	yao yan huo zhong	1
要也不是不要也不是	yao ye bu shi bu yao ye bu shi	1
咬着铁棍还说牙齿硬	yao zhe tie gun hai shuo ya chi ying	1
夜不关门	ye bu guan men	1
叶公好龙	ye gong hao long	1
夜壶打了把	ye hu da le ba	1
夜壶里洗澡	ye hu li xi zao	1
爷见孙猫见窜	ye jian sun mao jian cuan	1
野狸子舔虎鼻梁	ye li zi tian hu bi liang	1
野牛闯进火海里	ye niu chuang jin huo hai li	1
野兽当家	ye shou dang jia	1
夜莺配鹦鹉	ye ying pei ying wu	1
掖着个孙悟空	ye zhe ge sun wu kong	1
一辈子出不了头	yi bei zi chu bu liao tou	1
一本正经	yi ben zheng jing	1
一步登天	yi bu deng tian	1
一触即发	yi chu ji fa	1
一触即跳	yi chu ji tiao	1
一吹就散	yi chui jiu san	1
一错再错	yi cuo zai cuo	1
一对丑	yi dui chou	1
一付坏心肠	yi fu huai xin chang	1
一个比一个难看	yi ge bi yi ge nan kan	1
一个比一个凶	yi ge bi yi ge xiong	1
一个不留	yi ge bu liu	1
一个刁一个滑	yi ge diao yi ge hua	1
一个更比一个凶	yi ge geng bi yi ge xiong	1
一个师父一路拳	yi ge shi fu yi lu quan	1
一个样	yi ge yang	1
一个愿打一个愿挨	yi ge yuan da yi ge yuan ai	1
以功为守	yi gong wei shou	1
一鼓作气	yi gu zuo qi	1
一哄而散	yi hong er san	1
一伙更比一伙凶	yi huo geng bi yi huo xiong	1
一节也不通	yi jie ye bu tong	1
一进一出	yi jin yi chu	1
一举两得	yi ju liang de	1
一溜二抹	yi liu er mo	1
一马当先	yi ma dang xian	1
一模一样	yi mo yi yang	1
姨奶奶的枕头凤	yi nai nai de zhen tou feng	1
一年不如一年	yi nian bu ru yi nian	1
一篇大道理	yi pian da dao li	1
一窍不通	yi qiao bu tong	1
一去不回头	yi qu bu hui tou	1
一时光	yi shi guang	1
一双脚踏两只船	yi shuang jiao ta liang zhi chuan	1
一摊泥	yi tan ni	1
一套一套的	yi tao yi tao de	1
一条心	yi tiao xin	1
一头满意	yi tou man yi	1
一推就倒	yi tui jiu dao	1
一拖再拖	yi tuo zai tuo	1
一窝不如一窝	yi wo bu ru yi wo	1
一窝孙	yi wo sun	1
一泻千里	yi xie qian li	1
以怨报德	yi yuan bao de	1
引火上身	yin huo shang shen	1
硬按公鸡下蛋	ying an gong ji xia dan	1
硬棒槌弹棉花	ying bang chui tan mian hua	1
硬撑市面	ying cheng shi mian	1
鹰飞蓝天走夜路	ying fei lan tian zou ye lu	1
硬牛皮	ying niu pi	1
硬碰硬	ying peng ying	1
硬欺负人	ying qi fu ren	1
硬往上贴	ying wang shang tie	1
硬往死里逼	ying wang si li bi	1
硬要麻雀生鹅蛋	ying yao ma que sheng e dan	1
蝇子见了血	ying zi jian le xue	1
永不回头	yong bu hui tou	1
又长又臭	you chang you chou	1
有吹的了	you chui de le	1
又刺又痛	you ci you tong	1
有点五荤六素	you dian wu hun liu su	1
有点硬功夫	you dian ying gong fu	1
有点自大	you dian zi da	1
有肚量	you du liang	1
又毒又辣	you du you la	1
又恶又蠢	you e you chun	1
又高又贵	you gao you gui	1
有根有据	you gen you ju	1
有功之臣	you gong zhi chen	1
有货倒不出	you huo dao bu chu	1
有假无真	you jia wu zhen	1
有劲使不上	you jin shi bu shang	1
有来有往	you lai you wang	1
有了把柄	you le ba bing	1
有力无处使	you li wu chu shi	1
有命没毛	you ming mei mao	1
有你不多没你不少	you ni bu duo mei ni bu shao	1
有去无回	you qu wu hui	1
由人摆布	you ren bai bu	1
有日子的人了	you ri zi de ren le	1
有声有色	you sheng you se	1
又属百灵鸟又属袋鼠	you shu bai ling niao you shu dai shu	1
有无地之别	you wu di zhi bie	1
有眼不识泰山	you yan bu shi tai shan	1
有眼无珠	you yan wu zhu	1
有言在先	you yan zai xian	1
有也不多	you ye bu duo	1
有用是亲无用是仇	you yong shi qin wu yong shi chou	1
玉皇大帝拜财神一有钱大三辈	yu huang da di bai cai shen yi you qian da san bei	1
鱼篓里的螃蟹	yu lou li de pang xie	1
鱼盆里的螃蟹	yu pen li de pang xie	1
遇上了好人	yu shang le hao ren	1
渔网当伞	yu wang dang san	1
与我无关	yu wo wu guan	1
雨夜打灯笼	yu ye da deng long	1
与众不同	yu zhong bu tong	1
远处有灯	yuan chu you deng	1
袁世凯当皇帝	yuan shi kai dang huang di	1
冤枉死人	yuan wang si ren	1
圆珠笔蘸墨水一多事	yuan zhu bi zhan mo shui yi duo shi	1
圆桌会议	yuan zhuo hui yi	1
远走高飞	yuan zou gao fei	1
越吃越糟	yue chi yue zao	1
越打越下	yue da yue xia	1
越弹越乱	yue dan yue luan	1
越管越光	yue guan yue guang	1
越来越凶	yue lai yue xiong	1
月亮当镜子	yue liang dang jing zi	1
月亮下看书	yue liang xia kan shu	1
越摸越翘	yue mo yue qiao	1
越闹越臭	yue nao yue chou	1
越弄越糟	yue nong yue zao	1
越数越少	yue shu yue shao	1
越掏越臭	yue tao yue chou	1
越小越凶	yue xiao yue xiong	1
越选越差	yue xuan yue cha	1
云里张口袋	yun li zhang kou dai	1
云南老虎蒙古骆驼	yun nan lao hu meng gu luo tuo	1
砸锅卖铁	za guo mai tie	1
杂货铺卸货	za huo pu xie huo	1
杂种	za zhong	1
宰个鸽鸽也要请屠夫提刀	zai ge ge ge ye yao qing tu fu ti dao	1
在劫难逃	zai jie nan tao	1
宰相的千金皇帝的女	zai xiang de qian jin huang di de nv	1
再也洗不清	zai ye xi bu qing	1
再吟诗也跑不脱	zai yin shi ye pao bu tuo	1
脏水罐子掉到茅坑里	zang shui guan zi diao dao mao keng li	1
早春的桃花	zao chun de tao hua	1
枣核儿解板	zao he er jie ban	1
遭驴拉重协	zao lv la zhong xie	1
灶门前拿竹筒	zao men qian na zhu tong	1
枣木做烧柴	zao mu zuo shao chai	1
早晚要飞	zao wan yao fei	1
早晚要炸	zao wan yao zha	1
灶王爷上尺	zao wang ye shang chi	1
灶王爷贴在腿肚上	zao wang ye tie zai tui du shang	1
贼过才张弓	zei guo cai zhang gong	1
贼头贼脑	zei tou zei nao	1
贼娃子拾东西	zei wa zi shi dong xi	1
扎不下根	zha bu xia gen	1
蚱蜢碰上鸡	zha meng peng shang ji	1
扎实	zha shi	1
斋公吃羊肉	zhai gong chi yang rou	1
债主找到了负债的	zhai zhu zhao dao le fu zhai de	1
站不稳	zhan bu wen	1
斩草不除根	zhan cao bu chu gen	1
粘豆粥糊锅	zhan dou zhou hu guo	1
沾光	zhan guang	1
粘米煮山芋	zhan mi zhu shan yu	1
沾你的光了	zhan ni de guang le	1
粘牙的烧饼	zhan ya de shao bing	1
站在岸边看翻船	zhan zai an bian kan fan chuan	1
站在海边打咳声	zhan zai hai bian da ke sheng	1
站在河岸捞月亮	zhan zai he an lao yue liang	1
沾沾自喜	zhan zhan zi xi	1
站着身子正	zhan zhe shen zi zheng	1
战争贩子唱和平	zhan zheng fan zi chang he ping	1
张飞摆屠案	zhang fei bai tu an	1
张飞的妈妈	zhang fei de ma ma	1
张果老骑驴	zhang guo lao qi lv	1
长了兔子腿	zhang le tu zi tui	1
张驴儿上公堂	zhang lv er shang gong tang	1
丈母娘跺脚	zhang mu niang duo jiao	1
张生回头望莺莺	zhang sheng hui tou wang ying ying	1
张天师得了哑病	zhang tian shi de le ya bing	1
张天师画符	zhang tian shi hua fu	1
张勋复辟	zhang xun fu bi	1
找错了人	zhao cuo le ren	1
赵匡胤穿龙袍	zhao kuang yin chuan long pao	1
照明弹上天	zhao ming dan shang tian	1
找死	zhao si	1
赵云大战长板坡	zhao yun da zhan chang ban po	1
照住屁股蹬一脚	zhao zhu pi gu deng yi jiao	1
这把骨头不知往哪	zhe ba gu tou bu zhi wang na	1
遮不住阳光	zhe bu zhu yang guang	1
这山看着那山高	zhe shan kan zhe na shan gao	1
砧板上的鱼	zhen ban shang de yu	1
侦察员破案	zhen cha yuan po an	1
针锋相对	zhen feng xiang dui	1
真好	zhen hao	1
真灵	zhen ling	1
针挑黄连	zhen tiao huang lian	1
真相大白	zhen xiang da bai	1
枕着扁担睡觉	zhen zhe bian dan shui jiao	1
正大光明	zheng da guang ming	1
正合适	zheng he shi	1
整筐丢西瓜	zheng kuang diu xi gua	1
正是时候	zheng shi shi hou	1
睁眼瞎看告示	zheng yan xia kan gao shi	1
睁只眼闭只眼	zheng zhi yan bi zhi yan	1
直尺量曲线	zhi chi liang qu xian	1
知道迟到了	zhi dao chi dao le	1
知道你是哪块地里有呢	zhi dao ni shi na kuai di li you ne	1
趾高气扬	zhi gao qi yang	1
纸糊的老虎	zhi hu de lao hu	1
只可远看不能近瞧	zhi ke yuan kan bu neng jin qiao	1
肢皮人烤火	zhi pi ren kao huo	1
只说不练的把式	zhi shuo bu lian de ba shi	1
只图表面好看	zhi tu biao mian hao kan	1
只图眼前快活	zhi tu yan qian kuai huo	1
指望不上	zhi wang bu shang	1
直性子对直性子	zhi xing zi dui zhi xing zi	1
只有三年	zhi you san nian	1
只有一个心眼	zhi you yi ge xin yan	1
指着秃子骂和尚	zhi zhe tu zi ma he shang	1
置之不理	zhi zhi bu li	1
周瑜打黄盖	zhou yu da huang gai	1
皱皱巴巴的	zhou zhou ba ba de	1
主次不分	zhu ci bu fen	1
诸葛亮吊孝	zhu ge liang diao xiao	1
诸葛亮三气周瑜	zhu ge liang san qi zhou yu	1
诸葛亮用空城计	zhu ge liang yong kong cheng ji	1
煮熟的鸭子飞上天	zhu shu de ya zi fei shang tian	1
抓小辫子	zhua xiao bian zi	1
抓住了关键	zhua zhu le guan jian	1
拽着树叶打滴溜	zhuai zhe shu ye da di liu	1
装百子	zhuang bai zi	1
装疯	zhuang feng	1
装滑头	zhuang hua tou	1
装模作样	zhuang mo zuo yang	1
装什么蒜	zhuang shen me suan	1
装相	zhuang xiang	1
装样	zhuang yang	1
追查到底	zhui cha dao di	1
桌子缝里舔芝麻	zhuo zi feng li tian zhi ma	1
桌子上唱大戏	zhuo zi shang chang da xi	1
自暴自弃	zi bao zi qi	1
自吹	zi chui	1
自大	zi da	1
自焚	zi fen	1
自顾不暇	zi gu bu xia	1
自己跟自己过不去	zi ji gen zi ji guo bu qu	1
自己吓唬自己	zi ji xia hu zi ji	1
自来红	zi lai hong	1
自鸣得意	zi ming de yi	1
自骑自夸	zi qi zi kua	1
自身难保	zi shen nan bao	1
自讨苦吃	zi tao ku chi	1
自我膨胀	zi wo peng zhang	1
自我推销	zi wo tui xiao	1
自找苦吃	zi zhao ku chi	1
自找麻烦	zi zhao ma fan	1
自找难看	zi zhao nan kan	1
总有一别	zong you yi bie	1
走不动	zou bu dong	1
走不通	zou bu tong	1
走错了门	zou cuo le men	1
走到哪儿于到哪儿	zou dao na er yu dao na er	1
走的是一个方向	zou de shi yi ge fang xiang	1
走对了路子	zou dui le lu zi	1
走路算账	zou lu suan zhang	1
走投无路	zou tou wu lu	1
钻不进	zuan bu jin	1
钻进鸟笼里的猫	zuan jin niao long li de mao	1
钻子头上加钢针	zuan zi tou shang jia gang zhen	1
嘴馋上了当	zui chan shang le dang	1
醉汉过铁索桥	zui han guo tie suo qiao	1
醉翁之意不在酒	zui weng zhi yi bu zai jiu	1
坐不稳	zuo bu wen	1
坐不住	zuo bu zhu	1
坐等	zuo deng	1
作用不全	zuo yong bu quan	1
左右为难	zuo you wei nan	1
