阿苯达唑	a ben da zuo	1
阿拉斯加狭鳕	a la si jia xia xue	1
阿洛西林钠	a luo xi lin na	1
阿莫西林	a mo xi lin	1
阿莫西林钠	a mo xi lin na	1
阿奇霉素	a qi mei su	1
阿司匹林	a si pi lin	1
阿魏	a wei	1
阿昔洛韦	a xi luo wei	1
爱迪	ai di	1
矮地茶	ai di cha	1
艾姆氏实验	ai mu shi shi yan	1
艾叶	ai ye	1
艾叶油	ai ye you	1
爱滋病	ai zi bing	1
氨苄西林	an bian xi lin	1
氨苄西林钠	an bian xi lin na	1
氨茶碱	an cha jian	1
安宫黄体酮	an gong huang ti tong	1
暗鳜	an gui	1
安基比林	an ji bi lin	1
鮟鱇	an kang	1
鮟鱇鱼	an kang yu	1
安络血	an luo xue	1
安乃近	an nai jin	1
暗色东方鲀	an se dong fang tun	1
安替比林	an ti bi lin	1
暗纹东方鲀	an wen dong fang tun	1
安息香	an xi xiang	1
桉油	an you	1
奥酚达唑	ao fen da zuo	1
奥美普林	ao mei pu lin	1
奥硝唑	ao xiao zuo	1
巴豆	ba dou	1
巴豆霜	ba dou shuang	1
巴戟肉	ba ji rou	1
巴戟天	ba ji tian	1
八角枫	ba jiao feng	1
八角茴香	ba jiao hui xiang	1
八角茴香油	ba jiao hui xiang you	1
八厘麻	ba li ma	1
巴斯德消毒	ba si de xiao du	1
八月札	ba yue zha	1
白斑星鲨	bai ban xing sha	1
白扁豆	bai bian dou	1
白边锯鳞鱼	bai bian ju lin yu	1
白边鮠	bai bian wei	1
百部	bai bu	1
百草霜	bai cao shuang	1
白鲳	bai chang	1
白鳄科	bai e ke	1
白矾	bai fan	1
白茯苓	bai fu ling	1
白附片	bai fu pian	1
白附子	bai fu zi	1
白果	bai guo	1
白果仁	bai guo ren	1
百合	bai he	1
白花蛇舌草	bai hua she she cao	1
白芨	bai ji	1
白及	bai ji	1
白甲鱼	bai jia yu	1
白僵蚕	bai jiang can	1
败酱草	bai jiang cao	1
白降丹	bai jiang dan	1
白芥子	bai jie zi	1
白蔹	bai lian	1
白茅根	bai mao gen	1
白前	bai qian	1
白屈菜	bai qu cai	1
百蕊草	bai rui cao	1
白芍	bai shao	1
白舌尾甲鲹	bai she wei jia shen	1
白石港	bai shi gang	1
白氏银汉鱼	bai shi yin han yu	1
白首乌	bai shou wu	1
白苏	bai su	1
白头鳜	bai tou gui	1
白头翁	bai tou weng	1
白土苓	bai tu ling	1
白薇	bai wei	1
白鲜皮	bai xian pi	1
白鲟	bai xun	1
白药子	bai yao zi	1
白英	bai ying	1
白云花根	bai yun hua gen	1
白芷	bai zhi	1
白术	bai zhu	1
柏子仁	bai zi ren	1
半边莲	ban bian lian	1
斑柄天竺鲷	ban bing tian zhu diao	1
斑点叉尾鮰	ban dian cha wei hui	1
斑点鸡笼鲳	ban dian ji long chang	1
斑鳜	ban gui	1
半滑舌蹋	ban hua she ta	1
斑鰶	ban ji	1
瓣结鱼	ban jie yu	1
板蓝根	ban lan gen	1
板兰根	ban lan gen	1
斑蝥	ban mao	1
半夏	ban xia	1
半支莲	ban zhi lian	1
半枝莲	ban zhi lian	1
棒花鱼	bang hua yu	1
宝刀鱼	bao dao yu	1
豹骨	bao gu	1
暴马子	bao ma zi	1
包膜病毒	bao mo bing du	1
孢囊	bao nang	1
宝石石斑鱼	bao shi shi ban yu	1
被动扩散	bei dong kuo san	1
北豆根	bei dou gen	1
贝母花	bei mu hua	1
北沙参	bei sha shen	1
苯丙酸诺龙	ben bing suan nuo long	1
苯海拉明	ben hai la ming	1
苯甲酸雌二醇	ben jia suan ci er chun	1
苯甲酸钠	ben jia suan na	1
苯扎氯胺	ben zha lv an	1
苯扎溴胺	ben zha xiu an	1
荜茇	bi ba	1
荜澄茄	bi cheng jia	1
吡喹酮	bi kui tong	1
蓖麻油	bi ma you	1
蓖麻子	bi ma zi	1
比目鱼	bi mu yu	1
比赛可灵	bi sai ke ling	1
臂尾轮虫	bi wei lun chong	1
萆薢	bi xie	1
扁豆花	bian dou hua	1
鞭蝴蝶鱼	bian hu die yu	1
鞭毛	bian mao	1
扁头哈那鲨	bian tou ha na sha	1
苄星邻氯青霉素	bian xing lin lv qing mei su	1
萹蓄	bian xu	1
扁蓄	bian xu	1
鳊鱼	bian yu	1
表型	biao xing	1
鳖甲	bie jia	1
丙二醇	bing er chun	1
槟榔	bing lang	1
冰凉花	bing liang hua	1
丙硫咪唑	bing liu mi zuo	1
冰片	bing pian	1
丙三醇	bing san chun	1
丙酸睾丸素	bing suan gao wan su	1
病原体	bing yuan ti	1
病原学	bing yuan xue	1
驳骨丹	bo gu dan	1
薄荷	bo he	1
薄荷脑	bo he nao	1
薄荷油	bo he you	1
玻甲鱼	bo jia yu	1
补骨脂	bu gu zhi	1
补克博士	bu ke bo shi	1
补体	bu ti	1
布渣叶	bu zha ye	1
菜饼	cai bing	1
彩石鲥	cai shi shi	1
餐	can	1
参芪颗粒	can qi ke li	1
苍耳子	cang er zi	1
苍术	cang zhu	1
草豆蔻	cao dou kou	1
草果	cao guo	1
草红藤	cao hong teng	1
草乌	cao wu	1
草血竭	cao xue jie	1
草鱼	cao yu	1
侧柏叶	ce bai ye	1
茶碱	cha jian	1
叉尾斗鱼	cha wei dou yu	1
岔尾黄颡鱼	cha wei huang sang yu	1
叉纹蝴蝶鱼	cha wen hu die yu	1
茶油	cha you	1
柴胡	chai hu	1
燀苦杏仁	chan ku xing ren	1
蟾酥	chan su	1
蝉蜕	chan tui	1
蝉衣	chan yi	1
颤蚓	chan yin	1
长薄鳅	chang bao qiu	1
长春鳊	chang chun bian	1
长春花	chang chun hua	1
常德基地	chang de ji di	1
常德湘大	chang de xiang da	1
长颌鰆鯵	chang he chun shen	1
长颌鰆鲹	chang he chun shen	1
长江鲟	chang jiang xun	1
长鳍金枪鱼	chang qi jin qiang yu	1
长鳍吻鮈	chang qi wen ju	1
常山	chang shan	1
长蛇鮈	chang she ju	1
长蛇鯔	chang she zi	1
长蛇鲻	chang she zi	1
长体鲂	chang ti fang	1
长体鳜	chang ti gui	1
长条蛇鲻	chang tiao she zi	1
长尾大眼鲷	chang wei da yan diao	1
长吻丝鲹	chang wen si shen	1
长吻鮠	chang wen wei	1
长须片唇鮈	chang xu pian chun ju	1
炒白扁豆	chao bai bian dou	1
炒白芍	chao bai shao	1
炒白术	chao bai zhu	1
炒扁豆	chao bian dou	1
炒苍耳子	chao cang er zi	1
炒茺蔚子	chao chong wei zi	1
炒楮实子	chao chu shi zi	1
炒川楝子	chao chuan lian zi	1
炒丹皮	chao dan pi	1
炒稻芽	chao dao ya	1
炒蜂房	chao feng fang	1
炒谷芽	chao gu ya	1
炒瓜蒌子	chao gua lou zi	1
炒黄柏	chao huang bo	1
炒火麻仁	chao huo ma ren	1
炒蒺藜	chao ji li	1
炒鸡内金	chao ji nei jin	1
炒芥子	chao jie zi	1
炒决明子	chao jue ming zi	1
炒莱菔	chao lai fu	1
炒莱菔子	chao lai fu zi	1
炒麦芽	chao mai ya	1
炒蔓荆子	chao man jing zi	1
炒米仁	chao mi ren	1
炒没药	chao mo yao	1
炒南鹤虱	chao nan he shi	1
炒内金	chao nei jin	1
炒牛蒡子	chao niu bang zi	1
炒蒲黄	chao pu huang	1
炒牵牛子	chao qian niu zi	1
炒青葙子	chao qing xiang zi	1
炒乳香	chao ru xiang	1
炒山桅	chao shan wei	1
炒山楂	chao shan zha	1
炒酸枣仁	chao suan zao ren	1
朝天罐	chao tian guan	1
炒葶苈子	chao ting li zi	1
炒王不留行	chao wang bu liu xing	1
炒桅子	chao wei zi	1
超氧离子	chao yang li zi	1
炒栀子	chao zhi zi	1
炒紫苏子	chao zi su zi	1
车前草	che qian cao	1
车前子	che qian zi	1
陈佛手	chen fo shou	1
陈皮	chen pi	1
沉香	chen xiang	1
沉香曲	chen xiang qu	1
陈香薷	chen xiang ru	1
成都鱲	cheng du la	1
成都暇虎鱼	cheng du xia hu yu	1
称钩风	cheng gou feng	1
呈签	cheng qian	1
成鱼期	cheng yu qi	1
赤白芍	chi bai shao	1
赤点石斑鱼	chi dian shi ban yu	1
赤茯苓	chi fu ling	1
赤魟	chi hong	1
赤芍	chi shao	1
赤石脂	chi shi zhi	1
池塘网箱	chi tang wang xiang	1
赤小豆	chi xiao dou	1
赤眼梭鲻	chi yan suo zi	1
赤眼鳟	chi yan zun	1
虫白蜡	chong bai la	1
重楼	chong lou	1
茺蔚子	chong wei zi	1
虫纹东方鲀	chong wen dong fang tun	1
冲账	chong zhang	1
臭灵丹草	chou ling dan cao	1
楮实子	chu shi zi	1
川贝母	chuan bei mu	1
川独活	chuan du huo	1
川厚朴	chuan hou po	1
川黄连	chuan huang lian	1
川楝子	chuan lian zi	1
川明参	chuan ming can	1
川木通	chuan mu tong	1
川木香	chuan mu xiang	1
川牛膝	chuan niu xi	1
穿破石茄根	chuan po shi qie gen	1
穿山甲	chuan shan jia	1
穿山龙	chuan shan long	1
川石斛	chuan shi hu	1
船体网箱	chuan ti wang xiang	1
川桐皮	chuan tong pi	1
川乌	chuan wu	1
穿心莲	chuan xin lian	1
川芎	chuan xiong	1
川续断	chuan xu duan	1
川射干	chuan ye gan	1
垂盆草	chui pen cao	1
椿根皮	chun gen pi	1
椿皮	chun pi	1
刺鲃	ci ba	1
刺鲳	ci chang	1
雌二醇	ci er chun	1
刺鳅	ci qiu	1
刺鳅科	ci qiu ke	1
雌三醇	ci san chun	1
磁石	ci shi	1
刺突	ci tu	1
刺猬皮	ci wei pi	1
刺五加	ci wu jia	1
次硝酸铋	ci xiao suan bi	1
葱白	cong bai	1
醋艾炭	cu ai tan	1
醋艾叶	cu ai ye	1
醋鳖甲	cu bie jia	1
醋柴胡	cu chai hu	1
粗唇鮠	cu chun wei	1
醋甘遂	cu gan sui	1
醋龟甲	cu gui jia	1
醋三棱	cu san leng	1
醋商陆	cu shang lu	1
醋酸可的松	cu suan ke di song	1
醋酸泼尼松	cu suan po ni song	1
醋酸氢化可的松	cu suan qing hua ke di song	1
醋五味子	cu wu wei zi	1
醋香附	cu xiang fu	1
醋延胡索	cu yan hu suo	1
醋元胡	cu yuan hu	1
醋芫花	cu yuan hua	1
大斑花鳅	da ban hua qiu	1
大斑石鲈	da ban shi lu	1
大豆黄卷	da dou huang juan	1
大肺筋草	da fei jin cao	1
大飞扬草	da fei yang cao	1
大风子	da feng zi	1
大腹皮	da fu pi	1
大红袍	da hong pao	1
大黄	da huang	1
大黄鱼	da huang yu	1
大蓟	da ji	1
大甲鯵	da jia shen	1
大理裂腹鱼	da li lie fu yu	1
大鳞副泥鳅	da lin fu ni qiu	1
大泷线鱼	da long xian yu	1
大马哈鱼	da ma ha yu	1
大鳍刺鰟鮍	da qi ci pang pi	1
大鳍镬	da qi huo	1
大青叶	da qing ye	1
大生	da sheng	1
大生地	da sheng di	1
达氏鲟	da shi xun	1
大熟地	da shu de	1
大蒜	da suan	1
大弹涂鱼	da tan tu yu	1
大头陈	da tou chen	1
大西洋神仙	da xi yang shen xian	1
大小蓟	da xiao ji	1
大血藤	da xue teng	1
大眼鲷	da yan diao	1
大眼鳜	da yan gui	1
大眼金枪鱼	da yan jin qiang yu	1
大银鱼	da yin yu	1
大圆鄂针鱼	da yuan e zhen yu	1
大枣	da zao	1
带半刺厚唇鱼	dai ban ci hou chun yu	1
代代花	dai dai hua	1
玳玳花	dai dai hua	1
黛蛤散	dai ha san	1
戴家岭	dai jia ling	1
玳瑁	dai mao	1
代乳料	dai ru liao	1
带纹条鳎	dai wen tiao ta	1
带鱼	dai yu	1
代赭石	dai zhe shi	1
单带绯鲤	dan dai fei li	1
淡豆豉	dan dou chi	1
胆矾	dan fan	1
淡附片	dan fu pian	1
单核细胞	dan he xi bao	1
蛋鸡料	dan ji liao	1
单克隆抗体	dan ke long kang ti	1
胆木	dan mu	1
胆南星	dan nan xing	1
丹参	dan shen	1
单细胞蛋白	dan xi bao dan bai	1
胆汁	dan zhi	1
淡竹茹	dan zhu ru	1
淡竹叶	dan zhu ye	1
当归	dang gui	1
党参	dang shen	1
当药	dang yao	1
刀豆	dao dou	1
刀鲚	dao ji	1
倒扣草	dao kou cao	1
稻芽	dao ya	1
德林	de lin	1
灯台细辛	deng tai xi xin	1
灯台叶	deng tai ye	1
灯心草	deng xin cao	1
敌百虫	di bai chong	1
地必虫	di bi chong	1
地不容	di bu rong	1
敌草隆	di cao long	1
地胆草	di dan cao	1
地耳草	di er cao	1
地枫皮	di feng pi	1
地肤子	di fu zi	1
底改素	di gai su	1
地骨皮	di gu pi	1
地黄	di huang	1
地椒	di jiao	1
地锦草	di jin cao	1
敌菌净	di jun jing	1
地克珠利	di ke zhu li	1
地龙	di long	1
地美硝唑	di mei xiao zuo	1
地塞米松	di sai mi song	1
地塞米松醋酸酯	di sai mi song cu suan zhi	1
地图鱼	di tu yu	1
地榆	di yu	1
地榆炭	di yu tan	1
碘解磷定	dian jie lin ding	1
碘醚柳胺	dian mi liu an	1
颠茄草	dian qie cao	1
丁公藤	ding gong teng	1
丁癸草	ding gui cao	1
丁香	ding xiang	1
丢了棒	diu le bang	1
冬虫夏草	dong chong xia cao	1
东方狐鲣	dong fang hu jian	1
冬瓜皮	dong gua pi	1
冬瓜子	dong gua zi	1
冬葵果	dong kui guo	1
冬葵子	dong kui zi	1
冬凌草	dong ling cao	1
洞庭棒花鱼	dong ting bang hua yu	1
豆蔻	dou kou	1
杜父鱼科	du fu yu ke	1
杜衡	du heng	1
独活	du huo	1
杜鹃花叶	du juan hua ye	1
杜仲	du zhong	1
煅磁石	duan ci shi	1
煅浮海石	duan fu hai shi	1
短颌鲚	duan he ji	1
煅龙牡	duan long mu	1
煅牡蛎	duan mu li	1
短鳍红娘鱼	duan qi hong niang yu	1
煅青礞石	duan qing meng shi	1
短身间吸鳅	duan shen jian xi qiu	1
短身鳅鮀	duan shen qiu tuo	1
煅石膏	duan shi gao	1
短体条鳅	duan ti tiao qiu	1
短臀近红鮈	duan tun jin hong ju	1
煅瓦楞	duan wa leng	1
煅瓦楞子	duan wa leng zi	1
短尾大眼鲷	duan wei da yan diao	1
短尾突吻鳗	duan wei tu wen man	1
短尾鮠	duan wei wei	1
短须颌须鮈	duan xu he xu ju	1
断血流	duan xue liu	1
短鯒	duan yong	1
煅自燃铜	duan zi ran tong	1
对硫磷	dui liu lin	1
钝吻棒花鱼	dun wen bang hua yu	1
钝吻黄盖鲽	dun wen huang gai die	1
钝吻鮠	dun wen wei	1
多菌灵	duo jun ling	1
多抗甲素	duo kang jia su	1
多鳞刺鰟鮍	duo lin ci pang pi	1
多鳞鱚	duo lin xi	1
多潘立酮	duo pan li tong	1
多西环素	duo xi huan su	1
鹅不食草	e bu shi cao	1
鹅管石	e guan shi	1
阿胶	e jiao	1
恶喹酸钠	e kui suan na	1
峨嵋刺鰟鮍	e mei ci pang pi	1
峨嵋后平鳅	e mei hou ping qiu	1
鳄形短体鳗	e xing duan ti man	1
鳄鯒	e yong	1
莪术	e zhu	1
莪术油	e zhu you	1
恩诺沙星	en nuo sha xing	1
恩诺沙星钠	en nuo sha xing na	1
儿茶	er cha	1
二长刺鲷	er chang ci diao	1
二长棘鲷	er chang ji diao	1
二带双锯鱼	er dai shuang ju yu	1
二分裂	er fen lie	1
二氟沙星	er fu sha xing	1
二氟沙星口服	er fu sha xing kou fu	1
二甲基甲酰胺	er jia ji jia xian an	1
二甲基亚砜	er jia ji ya feng	1
二甲基乙酰胺	er jia ji yi xian an	1
二甲硝咪唑	er jia xiao mi zuo	1
二甲氧苄啶	er jia yang bian ding	1
二氯异氰尿酸钠	er lv yi qing niao suan na	1
儿脾醒	er pi xing	1
二羟丙茶碱	er qiang bing cha jian	1
二嗪农	er qin nong	1
二色大鹦嘴鱼	er se da ying zui yu	1
儿童草	er tong cao	1
二硝托胺	er xiao tuo an	1
二溴海因	er xiu hai yin	1
二氧丙嗪	er yang bing qin	1
法半夏	fa ban xia	1
法国神仙	fa guo shen xian	1
法落海	fa luo hai	1
发展中心	fa zhan zhong xin	1
番红花	fan hong hua	1
番泻叶	fan xie ye	1
防风	fang feng	1
防腐剂	fang fu ji	1
防己	fang ji	1
防已	fang yi	1
方正银鲫	fang zheng yin ji	1
飞琥珀	fei hu po	1
飞滑石	fei hua shi	1
鲱科	fei ke	1
飞廉草	fei lian cao	1
肺形草	fei xing cao	1
飞杨草	fei yang cao	1
肥知母	fei zhi mu	1
榧子	fei zi	1
芬苯达唑	fen ben da zuo	1
粉萆薢	fen bi xie	1
粉葛	fen ge	1
粉葛根	fen ge gen	1
粉红鲑	fen hong gui	1
分解代谢	fen jie dai xie	1
分生孢子	fen sheng bao zi	1
粉条儿菜	fen tiao er cai	1
蜂巢石斑鱼	feng chao shi ban yu	1
蜂房	feng fang	1
凤凰衣	feng huang yi	1
蜂蜡	feng la	1
丰鲤	feng li	1
蜂蜜	feng mi	1
丰年虫	feng nian chong	1
凤尾草	feng wei cao	1
凤仙花	feng xian hua	1
佛甲草	fo jia cao	1
佛手	fo shou	1
氟苯尼考	fu ben ni kao	1
麸炒苍术	fu chao cang zhu	1
麸炒僵蚕	fu chao jiang can	1
麸炒枳实	fu chao zhi shi	1
副蝴蝶鱼	fu hu die yu	1
副瑚蝶鱼	fu hu die yu	1
氟甲砜霉素	fu jia feng mei su	1
茯苓	fu ling	1
茯苓皮	fu ling pi	1
伏龙肝	fu long gan	1
氟氯西林钠	fu lv xi lin na	1
呋喃西林	fu nan xi lin	1
呋喃唑酮	fu nan zuo tong	1
氟哌酸	fu pai suan	1
覆盆子	fu pen zi	1
复盆子	fu pen zi	1
浮萍	fu ping	1
负染色	fu ran se	1
芙蓉花	fu rong hua	1
芙蓉鲤	fu rong li	1
芙蓉叶	fu rong ye	1
茯神	fu shen	1
伏神	fu shen	1
浮石	fu shi	1
浮小麦	fu xiao mai	1
浮游动物	fu you dong wu	1
浮游生物	fu you sheng wu	1
浮游植物	fu you zhi wu	1
福泽泻	fu ze xie	1
附子	fu zi	1
伽楠香	ga nan xiang	1
鱤	gan	1
甘草	gan cao	1
干姜	gan jiang	1
泔茅术	gan mao shu	1
干漆	gan qi	1
感染性疾病	gan ran xing ji bing	1
干扰素	gan rao su	1
甘松	gan song	1
甘遂	gan sui	1
杠板归	gang ban gui	1
岗梅	gang mei	1
岗松	gang song	1
藁本	gao ben	1
高良姜	gao liang jiang	1
高体白甲鱼	gao ti bai jia yu	1
高体近红鮈	gao ti jin hong ju	1
高新区	gao xin qu	1
高眼鲽	gao yan die	1
葛根	ge gen	1
葛花	ge hua	1
蛤蚧	ge jie	1
蛤壳	ge ke	1
革兰氏染色	ge lan shi ran se	1
隔山撬	ge shan qiao	1
梗通草	geng tong cao	1
工程鲫	gong cheng ji	1
公丁香	gong ding xiang	1
功劳木	gong lao mu	1
狗宝	gou bao	1
狗肝草	gou gan cao	1
狗脊	gou ji	1
枸杞子	gou qi zi	1
沟鯵	gou shen	1
沟鲹	gou shen	1
钩藤	gou teng	1
古大桥	gu da qiao	1
固氮	gu dan	1
谷精草	gu jing cao	1
谷麦芽	gu mai ya	1
古山龙	gu shan long	1
骨碎补	gu sui bu	1
谷芽	gu ya	1
瓜蒂	gua di	1
寡鳞刺鰟鮍	gua lin ci pang pi	1
寡鳞飘鱼	gua lin piao yu	1
瓜蒌	gua lou	1
瓜蒌皮	gua lou pi	1
瓜蒌仁	gua lou ren	1
瓜蒌子	gua lou zi	1
寡毛类	gua mao lei	1
瓜子金	gua zi jin	1
鳤	guan	1
关白附	guan bai fu	1
关木通	guan mu tong	1
贯众	guan zhong	1
广陈皮	guang chen pi	1
光唇蛇鮈	guang chun she ju	1
光慈姑	guang ci gu	1
广地龙	guang di long	1
广防已	guang fang yi	1
光魟	guang hong	1
广藿香	guang huo xiang	1
广霍香	guang huo xiang	1
广金钱草	guang jin qian cao	1
光能自养菌	guang neng zi yang jun	1
广谱	guang pu	1
光桃仁	guang tao ren	1
广郁金	guang yu jin	1
光泽黄颡鱼	guang ze huang sang yu	1
光枝勾	guang zhi gou	1
鳜	gui	1
龟甲	gui jia	1
龟甲胶	gui jia jiao	1
龟甲轮虫	gui jia lun chong	1
鬼箭羽	gui jian yu	1
鬼鲉	gui you	1
鳜鱼	gui yu	1
硅藻	gui zao	1
桂枝	gui zhi	1
桂枝尖	gui zhi jian	1
过岗龙	guo gang long	1
国雄	guo xiong	1
海大	hai da	1
海风藤	hai feng teng	1
海浮石	hai fu shi	1
海狗肾	hai gou shen	1
海鲫	hai ji	1
海金砂	hai jin sha	1
海鲢	hai lian	1
海龙	hai long	1
海马	hai ma	1
海鳗	hai man	1
海南霉素	hai nan mei su	1
海鲇	hai nian	1
海鲶	hai nian	1
海螵蛸	hai piao xiao	1
海桐皮	hai tong pi	1
海藻	hai zao	1
蔊菜	han cai	1
寒水石	han shui shi	1
汉桃叶	han tao ye	1
杭白菊	hang bai ju	1
貉狐料	hao hu liao	1
好氧微生物	hao yang wei sheng wu	1
鹤草酚	he cao fen	1
鹤草芽	he cao ya	1
褐菖鲉	he chang you	1
合成代谢	he cheng dai xie	1
禾丰	he feng	1
合欢花	he huan hua	1
合欢皮	he huan pi	1
贺家土	he jia tu	1
鹤虱	he shi	1
何首乌	he shou wu	1
核桃仁	he tao ren	1
褐牙鲆	he ya ping	1
荷叶	he ye	1
核衣壳	he yi ke	1
荷沅鲤	he yuan li	1
诃子	he zi	1
诃子肉	he zi rou	1
黑背圆颌针鱼	hei bei yuan he zhen yu	1
黑边石斑鱼	hei bian shi ban yu	1
黑点裸胸鳝	hei dian luo xiong shan	1
黑鲷	hei diao	1
黑风藤	hei feng teng	1
黑老虎根	hei lao hu gen	1
黑皮旗鱼	hei pi qi yu	1
黑鳍鮈	hei qi ju	1
黑裙	hei qun	1
黑鳃梅童鱼	hei sai mei tong yu	1
黑顺片	hei shun pian	1
黑尾近红鮈	hei wei jin hong ju	1
黑线银鲛	hei xian yin jiao	1
黑鳕	hei xue	1
黑印真鲨	hei yin zhen sha	1
黑芝麻	hei zhi ma	1
横带刺尾鱼	heng dai ci wei yu	1
横带髭鲷	heng dai zi diao	1
恒惠	heng hui	1
恒兴	heng xing	1
衡阳薄鳅	heng yang bao qiu	1
红唇薄鳅	hong chun bao qiu	1
红大戟	hong da ji	1
红笛鲷	hong di diao	1
红豆蔻	hong dou kou	1
红粉	hong fen	1
红根草	hong gen cao	1
红管药	hong guan yao	1
红鲑	hong gui	1
红花	hong hua	1
红鲫	hong ji	1
红狼牙鰕虎鱼	hong lang ya xia hu yu	1
红毛七	hong mao qi	1
红毛五加皮	hong mao wu jia pi	1
红霉素	hong mei su	1
红娘花	hong niang hua	1
红鳍鲌	hong qi ba	1
红鳍笛鲷	hong qi di diao	1
红鳍东方鲀	hong qi dong fang tun	1
红鳍裸颊鲷	hong qi luo jia diao	1
虹桥	hong qiao	1
红肉旗鱼	hong rou qi yu	1
红参	hong shen	1
红头草	hong tou cao	1
红烟管鱼	hong yan guan yu	1
红药子	hong yao zi	1
喉咙草	hou long cao	1
厚朴	hou po	1
厚朴花	hou pu hua	1
猴枣	hou zao	1
虎刺	hu ci	1
虎耳草	hu er cao	1
护肝片	hu gan pian	1
虎骨	hu gu	1
胡黄连	hu huang lian	1
槲寄生	hu ji sheng	1
胡椒	hu jiao	1
胡椒鲷	hu jiao diao	1
葫芦巴	hu lu ba	1
葫芦茶	hu lu cha	1
琥珀	hu po	1
胡荽	hu sui	1
呼吸链	hu xi lian	1
虎鲉	hu you	1
虎杖	hu zhang	1
虎掌草	hu zhang cao	1
花斑副沙鳅	hua ban fu sha qiu	1
花槟榔	hua bing lang	1
华港	hua gang	1
花椒	hua jiao	1
化橘红	hua ju hong	1
华鲮	hua ling	1
花鳗鲡	hua man li	1
化能自养菌	hua neng zi yang jun	1
花蕊石	hua rui shi	1
华山参	hua shan shen	1
华生	hua sheng	1
华氏	hua shi	1
滑石	hua shi	1
花尾胡椒鲷	hua wei hu jiao diao	1
华西希望	hua xi xi wang	1
槐花	huai hua	1
槐花米	huai hua mi	1
槐角	huai jiao	1
怀牛膝	huai niu xi	1
淮山药	huai shan yao	1
环丙沙星	huan bing sha xing	1
獾油	huan you	1
磺胺二甲氧嘧啶	huang an er jia yang mi ding	1
磺胺二甲氧嘧啶钠	huang an er jia yang mi ding na	1
磺胺甲恶唑钠	huang an jia e zuo na	1
磺胺甲氧吡嗪	huang an jia yang bi qin	1
磺胺间甲嘧啶	huang an jian jia mi ding	1
黄鮟鱇	huang an kang	1
磺胺喹噁啉钠	huang an kui e lin na	1
磺胺氯吡嗪钠	huang an lv bi qin na	1
磺胺氯哒嗪钠	huang an lv da qin na	1
磺胺眯	huang an mi	1
磺胺嘧啶	huang an mi ding	1
磺胺嘧啶钠	huang an mi ding na	1
磺胺噻唑	huang an sai zuo	1
磺胺噻唑钠	huang an sai zuo na	1
磺胺五甲嘧啶	huang an wu jia mi ding	1
黄斑燕鳐	huang ban yan yao	1
黄柏	huang bo	1
黄点龙	huang dian long	1
黄鲷	huang diao	1
黄粉虫	huang fen chong	1
黄姑鱼	huang gu yu	1
黄瓜	huang gua	1
黄鲫	huang ji	1
黄精	huang jing	1
黄荆子	huang jing zi	1
黄连	huang lian	1
黄连素	huang lian su	1
黄栌	huang lu	1
黄霉素	huang mei su	1
黄芪	huang qi	1
黄鳍金枪鱼	huang qi jin qiang yu	1
黄鳍马面鲀	huang qi ma mian tun	1
黄芩	huang qin	1
黄曲霉毒素	huang qu mei du su	1
黄颡鱼	huang sang yu	1
黄鳝	huang shan	1
黄藤	huang teng	1
黄体酮	huang ti tong	1
黄尾鲴	huang wei gu	1
黄纹拟鲈	huang wen ni lu	1
黄药子	huang yao zi	1
黄芫花	huang yuan hua	1
汇海	hui hai	1
灰裸顶鲷	hui luo ding diao	1
灰星鲨	hui xing sha	1
混合培养	hun he pei yang	1
火麻仁	huo ma ren	1
霍佩兰	huo pei lan	1
火炭母	huo tan mu	1
藿香	huo xiang	1
鲫	ji	1
肌醇	ji chun	1
几丁质	ji ding zhi	1
鸡骨草	ji gu cao	1
鸡冠花	ji guan hua	1
蒺藜	ji li	1
檵木叶	ji mu ye	1
鸡内金	ji nei jin	1
鸡矢藤	ji shi teng	1
鸡苏散	ji su san	1
棘头梅童鱼	ji tou mei tong yu	1
己烯雌酚	ji xi ci fen	1
急性子	ji xing zi	1
积雪草	ji xue cao	1
鸡血藤	ji xue teng	1
鲫鱼	ji yu	1
鲫鱼料	ji yu liao	1
甲苯咪唑	jia ben mi zuo	1
甲砜霉素	jia feng mei su	1
加富培养基	jia fu pei yang ji	1
嘉好	jia hao	1
甲磺酸达氟沙星	jia huang suan da fu sha xing	1
甲磺酸丹诺沙星	jia huang suan dan nuo sha xing	1
甲磺酸加替沙星	jia huang suan jia ti sha xing	1
甲磺酸培氟沙星	jia huang suan pei fu sha xing	1
甲磺酸左旋氧氟沙星	jia huang suan zuo xuan yang fu sha xing	1
甲基纤维素	jia ji xian wei su	1
假睛东方鲀	jia jing dong fang tun	1
假菌丝	jia jun si	1
加乐	jia le	1
甲硫酸新斯的明	jia liu suan xin si de ming	1
荚膜	jia mo	1
甲氰菊脂	jia qing ju zhi	1
甲氰咪胍	jia qing mi gua	1
加替沙星	jia ti sha xing	1
甲硝唑	jia xiao zuo	1
甲氧苄啶	jia yang bian ding	1
鉴别培养基	jian bie pei yang ji	1
鉴别染色	jian bie ran se	1
建德棒花鱼	jian de bang hua yu	1
尖海龙	jian hai long	1
肩环刺盖鱼	jian huan ci gai yu	1
建鲤	jian li	1
尖裸鲤	jian luo li	1
建曲	jian qu	1
剑水蚤	jian shui zao	1
尖吻鲈	jian wen lu	1
尖吻蛇鳗	jian wen she man	1
鲣鱼	jian yu	1
姜半夏	jiang ban xia	1
僵蚕	jiang can	1
姜草果仁	jiang cao guo ren	1
姜厚朴	jiang hou po	1
姜黄	jiang huang	1
江黄颡鱼	jiang huang sang yu	1
鳉科	jiang ke	1
降香	jiang xiang	1
教槽料	jiao cao liao	1
绞股蓝	jiao gu lan	1
绞股兰	jiao gu lan	1
胶囊	jiao nang	1
焦三仙	jiao san xian	1
焦山楂	jiao shan zha	1
节孢子	jie bao zi	1
桔梗	jie geng	1
锦灯笼	jin deng long	1
金沸草	jin fei cao	1
金狗脊	jin gou ji	1
筋骨草	jin gu cao	1
金果榄	jin guo lan	1
金锦香	jin jin xiang	1
金精石	jin jing shi	1
金莲花	jin lian hua	1
金霉素	jin mei su	1
金礞石	jin meng shi	1
金钱白花蛇	jin qian bai hua she	1
金钱草	jin qian cao	1
金钱鱼	jin qian yu	1
金荞麦	jin qiao mai	1
金乔麦	jin qiao mai	1
金丝桃素	jin si tao su	1
金铁销	jin tie xiao	1
金线鱼	jin xian yu	1
金叶金兰	jin ye jin lan	1
金银花	jin yin hua	1
金樱子	jin ying zi	1
金缨子	jin ying zi	1
金樱子肉	jin ying zi rou	1
金鱼翁	jin yu weng	1
京半夏	jing ban xia	1
京大戟	jing da ji	1
镜蝴蝶鱼	jing hu die yu	1
荆芥	jing jie	1
荆芥炭	jing jie tan	1
镜鲤	jing li	1
荆三棱	jing san leng	1
京三棱	jing san leng	1
鲸鲨	jing sha	1
景天三七	jing tian san qi	1
荆州海大	jing zhou hai da	1
荆州基地	jing zhou ji di	1
荆州湘大	jing zhou xiang da	1
荆州湘大骆驼水产饲料有限公司	jing zhou xiang da luo tuo shui chan si liao you xian gong si	1
荆州湘大骆驼饲料有限公司	jing zhou xiang da luo tuo si liao you xian gong si	1
救必应	jiu bi ying	1
韭菜子	jiu cai zi	1
酒常山	jiu chang shan	1
酒川芎	jiu chuan xiong	1
酒大黄	jiu da huang	1
酒丹参	jiu dan shen	1
酒当归	jiu dang gui	1
酒黄连	jiu huang lian	1
酒黄芩	jiu huang qin	1
九节菖蒲	jiu jie chang pu	1
九里香	jiu li xiang	1
酒女贞子	jiu nv zhen zi	1
酒石酸北里霉素	jiu shi suan bei li mei su	1
酒石酸泰乐菌素	jiu shi suan tai le jun su	1
九头狮子草	jiu tou shi zi cao	1
酒乌梢蛇	jiu wu shao she	1
酒仙茅	jiu xian mao	1
九香虫	jiu xiang chong	1
九岳	jiu yue	1
橘核	ju he	1
橘红	ju hong	1
菊花	ju hua	1
橘络	ju luo	1
巨石斑鱼	ju shi ban yu	1
桔尾蝴蝶鱼	ju wei hu die yu	1
聚维酮碘	ju wei tong dian	1
卷柏	juan bai	1
爵床	jue chuang	1
决明子	jue ming zi	1
军曹鱼	jun cao yu	1
菌株	jun zhu	1
康达尔	kang da er	1
抗代谢物	kang dai xie wu	1
抗毒素	kang du su	1
抗生素	kang sheng su	1
抗体	kang ti	1
抗血清	kang xue qing	1
抗原	kang yuan	1
抗原决定基	kang yuan jue ding ji	1
克拉霉素	ke la mei su	1
可拉明	ke la ming	1
颗粒犁头鳐	ke li li tou yao	1
克霉唑	ke mei zuo	1
克氏棘赤刀鱼	ke shi ji chi dao yu	1
科洋	ke yang	1
孔鳐	kong yao	1
苦地丁	ku di ding	1
苦丁茶	ku ding cha	1
苦豆草	ku dou cao	1
苦楝皮	ku lian pi	1
苦木	ku mu	1
苦参	ku shen	1
苦石莲	ku shi lian	1
苦杏仁	ku xing ren	1
苦杏仁酸	ku xing ren suan	1
苦竹叶	ku zhu ye	1
快育宝	kuai yu bao	1
款冬花	kuan dong hua	1
宽鳍鲻	kuan qi zi	1
宽体舌鳎	kuan ti she ta	1
宽吻鱵	kuan wen zhen	1
喹烯酮	kui xi tong	1
喹乙醇	kui yi chun	1
昆布	kun bu	1
腊梅花	la mei hua	1
莱菔子	lai fu zi	1
蓝布正	lan bu zheng	1
蓝点马鲛	lan dian ma jiao	1
蓝花参	lan hua shen	1
蓝鳍金枪鱼	lan qi jin qiang yu	1
蓝枪鱼	lan qiang yu	1
蓝圆鯵	lan yuan shen	1
蓝圆鲹	lan yuan shen	1
蓝藻水华	lan zao shui hua	1
狼把草	lang ba cao	1
莨菪子	lang dang zi	1
狼毒	lang du	1
狼牙鰕虎鱼	lang ya xia hu yu	1
老鹳草	lao guan cao	1
鰳鱼	le yu	1
类毒素	lei du su	1
雷公藤	lei gong teng	1
雷尼替丁	lei ni ti ding	1
雷丸	lei wan	1
鲤	li	1
利巴韦林	li ba wei lin	1
立翅旗鱼	li chi qi yu	1
利福平	li fu ping	1
漓江副沙鳅	li jiang fu sha qiu	1
痢菌净	li jun jing	1
藜芦	li lu	1
犁头鳅	li tou qiu	1
粒细胞	li xi bao	1
鲤鱼	li yu	1
荔枝核	li zhi he	1
鲢	lian	1
莲房	lian fang	1
莲花	lian hua	1
链霉素	lian mei su	1
连钱草	lian qian cao	1
连翘	lian qiao	1
莲须	lian xu	1
镰鱼	lian yu	1
鲢鱼	lian yu	1
莲子	lian zi	1
莲子心	lian zi xin	1
两面针	liang mian zhen	1
两头尖	liang tou jian	1
蓼大青叶	liao da qing ye	1
辽藁本	liao gao ben	1
了哥王	liao ge wang	1
膦甲酸钠	lin jia suan na	1
林可霉素	lin ke mei su	1
林氏细鲫	lin shi xi ji	1
磷酸苯丙哌林	lin suan ben bing pai lin	1
磷酸泰乐菌素	lin suan tai le jun su	1
鳞烟管鱼	lin yan guan yu	1
凌霄花	ling xiao hua	1
羚羊角	ling yang jiao	1
灵芝	ling zhi	1
六齿金线鱼	liu chi jin xian yu	1
六带鲹	liu dai shen	1
六带石斑鱼	liu dai shi ban yu	1
六带线纹鱼	liu dai xian wen yu	1
六和	liu he	1
刘寄奴	liu ji nu	1
六甲嘧啶钠	liu jia mi ding na	1
硫氰酸红霉素	liu qing suan hong mei su	1
流水养鱼	liu shui yang yu	1
硫酸阿米卡星	liu suan a mi ka xing	1
硫酸阿托品	liu suan a tuo pin	1
硫酸安普霉素	liu suan an pu mei su	1
硫酸大观霉素	liu suan da guan mei su	1
硫酸丁胺卡那霉素	liu suan ding an ka na mei su	1
硫酸卡那霉素	liu suan ka na mei su	1
硫酸链霉素	liu suan lian mei su	1
硫酸庆大霉素	liu suan qing da mei su	1
硫酸双氢链霉素	liu suan shuang qing lian mei su	1
硫酸小诺霉素	liu suan xiao nuo mei su	1
硫酸新霉素	liu suan xin mei su	1
硫酸伊替咪星	liu suan yi ti mi xing	1
硫酸粘杆菌素	liu suan zhan gan jun su	1
六线鱼	liu xian yu	1
六一散	liu yi san	1
六月雪	liu yue xue	1
龙齿	long chi	1
龙胆	long dan	1
龙胆草	long dan cao	1
龙骨	long gu	1
龙葵	long kui	1
龙头鱼	long tou yu	1
龙涎香	long xian xiang	1
龙眼肉	long yan rou	1
漏芦	lou lu	1
鲈	lu	1
卤虫	lu chong	1
炉甘石	lu gan shi	1
芦根	lu gen	1
芦荟	lu hui	1
卤碱	lu jian	1
鹿角	lu jiao	1
鹿角霜	lu jiao shuang	1
鲈鲤	lu li	1
路路通	lu lu tong	1
鹿茸	lu rong	1
鹿肉	lu rou	1
鹿肾	lu shen	1
路氏双髻鲨	lu shi shuang ji sha	1
芦淞市场	lu song shi chang	1
鹿胎	lu tai	1
鹿尾	lu wei	1
鹿衔草	lu xian cao	1
鹿血	lu xue	1
鲈鱼	lu yu	1
芦竹根	lu zhu gen	1
轮虫	lun chong	1
罗布麻叶	luo bu ma ye	1
罗汉果	luo han guo	1
络合碘	luo he dian	1
罗红霉素	luo hong mei su	1
螺菌	luo jun	1
络石藤	luo shi teng	1
裸体鳅鮀	luo ti qiu tuo	1
骆驼	luo tuo	1
骆驼饲料	luo tuo si liao	1
螺旋体	luo xuan ti	1
葎草	lv cao	1
绿豆	lv dou	1
绿萼梅	lv e mei	1
氯氟氰菊酯	lv fu qing ju zhi	1
氯化铵	lv hua an	1
氯化胆碱	lv hua dan jian	1
氯磷定	lv lin ding	1
绿鳍马面鲀	lv qi ma mian tun	1
绿鳍鱼	lv qi yu	1
氯羟吡啶	lv qiang bi ding	1
氯氰碘柳胺钠	lv qing dian liu an na	1
驴肾	lv shen	1
绿藻	lv zao	1
绿藻水华	lv zao shui hua	1
马宝	ma bao	1
马鞭草	ma bian cao	1
马槟榔	ma bing lang	1
马勃	ma bo	1
马齿苋	ma chi xian	1
马兜铃	ma dou ling	1
马杜霉素铵	ma du mei su an	1
马夫鱼	ma fu yu	1
麻黄	ma huang	1
麻黄粉	ma huang fen	1
麻黄根	ma huang gen	1
麻黄碱	ma huang jian	1
麻黄绒	ma huang rong	1
马家河	ma jia he	1
马拉硫磷	ma la liu lin	1
马兰草	ma lan cao	1
马兰头	ma lan tou	1
马钱子	ma qian zi	1
马苏金枪鱼	ma su jin qiang yu	1
马蹄金	ma ti jin	1
马尾黄连	ma yi huang lian	1
麻油	ma you	1
麦白霉素	mai bai mei su	1
麦冬	mai dong	1
麦饭石	mai fan shi	1
麦麸	mai fu	1
麦穗鱼	mai sui yu	1
麦芽	mai ya	1
满江红	man jiang hong	1
蔓荆子	man jing zi	1
鳗鲡	man li	1
鳗鲡科	man li ke	1
芒硝	mang xiao	1
毛躄鱼	mao bi yu	1
毛冬青	mao dong qing	1
茅莓	mao mei	1
矛尾复鰕虎鱼	mao wei fu xia hu yu	1
猫眼草	mao yan cao	1
毛烟管鱼	mao yan guan yu	1
猫爪草	mao zhao cao	1
玫瑰花	mei gui hua	1
美国红鱼	mei guo hong yu	1
梅花	mei hua	1
酶联免疫	mei lian mian yi	1
美洛西林钠	mei luo xi lin na	1
美鳐	mei yao	1
虻虫	meng chong	1
蒙古红鲌	meng gu hong ba	1
虻鲉	meng you	1
蜜百部	mi bai bu	1
蜜白前	mi bai qian	1
猕猴桃	mi hou tao	1
咪康唑	mi kang zuo	1
密蒙花	mi meng hua	1
蜜枇杷叶	mi pi pa ye	1
蜜前胡	mi qian hu	1
蜜桑白皮	mi sang bai pi	1
密陀僧	mi tuo seng	1
蜜紫菀	mi zi wan	1
咪唑苯脲	mi zuo ben niao	1
绵萆薢	mian bi xie	1
棉花根	mian hua gen	1
绵马贯众	mian ma guan zhong	1
绵鳚	mian wei	1
免疫法	mian yi fa	1
免疫球蛋白	mian yi qiu dan bai	1
免疫系统	mian yi xi tong	1
免疫原	mian yi yuan	1
绵茵陈	mian yin chen	1
鮸鱼	mian yu	1
鮸状黄姑鱼	mian zhuang huang gu yu	1
灭苔净	mie tai jing	1
明党参	ming dang shen	1
明天麻	ming tian ma	1
墨旱莲	mo han lian	1
茉莉花	mo li hua	1
摩鹿加绯鲤	mo lu jia fei li	1
莫能霉素	mo neng mei su	1
墨头鱼	mo tou yu	1
没药	mo yao	1
墨元参	mo yuan can	1
木鳖子	mu bie zi	1
牡丹皮	mu dan pi	1
母丁香	mu ding xiang	1
木瓜	mu gua	1
木蝴蝶	mu hu die	1
木蝴喋	mu hu die	1
木槿花	mu jin hua	1
木槿子	mu jin zi	1
牡荆叶	mu jing ye	1
牡蛎	mu li	1
木棉花	mu mian hua	1
木通	mu tong	1
木香	mu xiang	1
木腰子	mu yao zi	1
木叶鲽	mu ye die	1
木贼	mu zei	1
南沙参	na sha shen	1
奶牛料	nai niu liao	1
萘普生	nai pu sheng	1
南北沙参	nan bei sha shen	1
南方大口鲶	nan fang da kou nian	1
南瓜子	nan gua zi	1
南蛇藤果	nan she teng guo	1
硇砂	nao sha	1
闹羊花	nao yang hua	1
内毒素	nei du su	1
内含物	nei han wu	1
拟核	ni he	1
拟尖头红鲌	ni jian tou hong ba	1
尼卡巴嗪	ni ka ba qin	1
尼可刹米	ni ke sha mi	1
逆鱼	ni yu	1
逆转录酶	ni zhuan lu mei	1
鲶	nian	1
鲶科	nian ke	1
鲶鱼	nian yu	1
聂氏无刺鲼	nie shi wu ci fen	1
牛蒡子	niu bang zi	1
牛黄	niu huang	1
牛磺酸	niu huang suan	1
牛膝	niu xi	1
牛至	niu zhi	1
农吉利	nong ji li	1
农吉利总碱	nong ji li zong jian	1
浓缩料	nong suo liao	1
糯稻根	nuo dao gen	1
诺氟沙星	nuo fu sha xing	1
糯米藤根	nuo mi teng gen	1
糯米须	nuo mi xu	1
女贞子	nv zhen zi	1
藕节	ou jie	1
藕节炭	ou jie tan	1
排风藤	pai feng teng	1
攀鲈科	pan lu ke	1
胖大海	pang da hai	1
鰟鮍	pang pi	1
炮姜	pao jiang	1
炮山甲	pao shan jia	1
胚宝胶囊	pei bao jiao nang	1
佩兰	pei lan	1
培养物	pei yang wu	1
蟛蜞菊	peng qi ju	1
硼砂	peng sha	1
彭泽鲫	peng ze ji	1
啤酒花浸膏	pi jiu hua jin gao	1
枇杷叶	pi pa ye	1
皮氏叫姑鱼	pi shi jiao gu yu	1
砒霜	pi shuang	1
片姜黄	pian jiang huang	1
平鳍鳅科	ping qi qiu ke	1
泼尼松	po ni song	1
破碎料	po sui liao	1
扑尔敏	pu er min	1
葡伏堇	pu fu jin	1
蒲公英	pu gong ying	1
朴蝴蝶鱼	pu hu die yu	1
蒲黄	pu huang	1
蒲黄炭	pu huang tan	1
普鲁卡因青霉素	pu lu ka yin qing mei su	1
扑热息痛	pu re xi tong	1
普瑞纳	pu rui na	1
蛴螬	qi cao	1
齐口裂腹鱼	qi kou lie fu yu	1
鲯鳅	qi qiu	1
蕲蛇	qi she	1
七叶一枝花	qi ye yi zhi hua	1
茜草	qian cao	1
茜草炭	qian cao tan	1
铅丹	qian dan	1
铅点东方鲀	qian dian dong fang tun	1
潜伏	qian fu	1
前肛鳗	qian gang man	1
前胡	qian hu	1
千里光	qian li guang	1
千里花	qian li hua	1
千年健	qian nian jian	1
牵牛子	qian niu zi	1
千日红	qian ri hong	1
芡实	qian shi	1
前噬菌体	qian shi jun ti	1
羌活	qiang huo	1
蜣螂	qiang lang	1
翘嘴红鲌	qiao zui hong ba	1
翘嘴鲤	qiao zui li	1
切尾鮠	qie wei wei	1
秦艽	qin jiao	1
禽料	qin liao	1
秦皮	qin pi	1
清半夏	qing ban xia	1
青黛	qing dai	1
轻粉	qing fen	1
青风藤	qing feng teng	1
青干金枪鱼	qing gan jin qiang yu	1
青果	qing guo	1
青蒿	qing hao	1
氢化可的松	qing hua ke di song	1
氢化泼尼松	qing hua po ni song	1
青鳉	qing jiang	1
青连翘	qing lian qiao	1
青鳞鱼	qing lin yu	1
青霉素	qing mei su	1
青礞石	qing meng shi	1
青年鸡料	qing nian ji liao	1
青皮	qing pi	1
青梢红鲌	qing shao hong ba	1
青石斑鱼	qing shi ban yu	1
青腾	qing teng	1
青天葵	qing tian kui	1
氰戊菊脂	qing wu ju zhi	1
青葙子	qing xiang zi	1
青箱子	qing xiang zi	1
青叶胆	qing ye dan	1
青鱼	qing yu	1
青鱼料	qing yu liao	1
鳅科	qiu ke	1
球痢灵	qiu li ling	1
球形体	qiu xing ti	1
趋化性	qu hua xing	1
瞿麦	qu mai	1
苣荬菜	qu mai cai	1
全虫	quan chong	1
全当归	quan dang gui	1
全瓜蒌	quan gua lou	1
拳参	quan shen	1
泉水鱼	quan shui yu	1
全蝎	quan xie	1
桡足类	rao zu lei	1
忍冬藤	ren dong teng	1
人参	ren shen	1
人参芦	ren shen lu	1
人参叶	ren shen ye	1
日本海鲂	ri ben hai fang	1
日本黄姑鱼	ri ben huang gu yu	1
日本金线鱼	ri ben jin xian yu	1
日本七鳃鳗	ri ben qi sai man	1
日本腾	ri ben teng	1
日本须鲨	ri ben xu sha	1
荣丰	rong feng	1
溶酶体	rong mei ti	1
溶原性	rong yuan xing	1
肉苁蓉	rou cong rong	1
肉豆蔻	rou dou kou	1
肉桂	rou gui	1
肉鸡料	rou ji liao	1
鞣酸	rou suan	1
肉鸭料	rou ya liao	1
乳清粉	ru qing fen	1
乳酸恩诺沙星	ru suan en nuo sha xing	1
乳酸环丙沙星	ru suan huan bing sha xing	1
乳酸诺氟沙星	ru suan nuo fu sha xing	1
乳酸左旋氧氟沙星	ru suan zuo xuan yang fu sha xing	1
乳香	ru xiang	1
乳猪料	ru zhu liao	1
蕤仁	rui ren	1
洒石酸胆碱	sa shi suan dan jian	1
赛拉唑	sai la zuo	1
赛胃安	sai wei an	1
三白草	san bai cao	1
三叉苦	san cha ku	1
三氮脒	san dan mi	1
三角鲂	san jiao fang	1
三颗针	san ke zhen	1
三棱	san leng	1
散鳞镜鲤	san lin jing li	1
三氯化铁	san lv hua tie	1
三氯异氰尿酸	san lv yi qing niao suan	1
三七	san qi	1
三七粉	san qi fen	1
三色龙	san se long	1
三色鹦嘴鱼	san se ying zui yu	1
三线舌鳎	san xian she ta	1
散养	san yang	1
三叶青	san ye qing	1
三元禾丰	san yuan he feng	1
三肢轮虫	san zhi lun chong	1
桑白皮	sang bai pi	1
桑寄生	sang ji sheng	1
桑螵蛸	sang piao xiao	1
桑普生化	sang pu sheng hua	1
桑椹	sang shen	1
桑椹子	sang shen zi	1
桑叶	sang ye	1
桑枝	sang zhi	1
沙棘	sha ji	1
沙拉沙星	sha la sha xing	1
沙鳢	sha li	1
杀螟丹	sha ming dan	1
砂仁	sha ren	1
沙市通威	sha shi tong wei	1
沙苑子	sha yuan zi	1
沙枣	sha zao	1
沙枣叶	sha zao ye	1
山慈菇	shan ci gu	1
山慈姑	shan ci gu	1
山豆根	shan dou gen	1
山茛菪碱	shan gen dang jian	1
山柰	shan nai	1
山药	shan yao	1
栅藻	shan zao	1
山楂	shan zha	1
山芝麻	shan zhi ma	1
山枝仁	shan zhi ren	1
山茱萸	shan zhu yu	1
商陆	shang lu	1
少女鱼	shao nv yu	1
蛇床子	she chuang zi	1
蛇胆	she dan	1
蛇毒	she du	1
蛇鮈	she ju	1
舌鳎科	she ta ke	1
蛇蜕	she tui	1
麝香	she xiang	1
麝香草	she xiang cao	1
神丰	shen feng	1
伸筋草	shen jin cao	1
伸口鱼	shen kou yu	1
神曲	shen qu	1
生白芍	sheng bai shao	1
生大黄	sheng da huang	1
生地黄	sheng di huang	1
生地榆	sheng di yu	1
生杜仲	sheng du zhong	1
生贯众	sheng guan zhong	1
生黄芪	sheng huang qi	1
生姜	sheng jiang	1
升麻	sheng ma	1
生麻黄	sheng ma huang	1
生内金	sheng nei jin	1
生蒲黄	sheng pu huang	1
生石膏	sheng shi gao	1
生首乌	sheng shou wu	1
生熟地	sheng shu di	1
生物料	sheng wu liao	1
生长因子	sheng zhang yin zi	1
鲥	shi	1
蓍草	shi cao	1
石菖蒲	shi chang pu	1
十大功劳叶	shi da gong lao ye	1
柿蒂	shi di	1
石吊兰	shi diao lan	1
石鲽	shi die	1
石膏	shi gao	1
石斛	shi hu	1
石灰	shi hui	1
石见穿	shi jian chuan	1
石椒草	shi jiao cao	1
石决明	shi jue ming	1
噬菌体	shi jun ti	1
使君子	shi jun zi	1
嗜冷菌	shi leng jun	1
石榴皮	shi liu pi	1
石南藤	shi nan teng	1
石楠藤	shi nan teng	1
石楠叶	shi nan ye	1
嗜热菌	shi re jun	1
噬人鲨	shi ren sha	1
施氏鲟	shi shi xun	1
石苇	shi wei	1
石韦	shi wei	1
石苇叶	shi wei ye	1
食盐	shi yan	1
石燕	shi yan	1
嗜盐菌	shi yan jun	1
鲥鱼	shi yu	1
石钻子	shi zuan zi	1
手参	shou shen	1
首乌藤	shou wu teng	1
熟地	shu de	1
熟地黄	shu di huang	1
舒筋草	shu jin cao	1
薯莨	shu liang	1
鼠曲草	shu qu cao	1
双带绯鲤	shuang dai fei li	1
双钩藤	shuang gou teng	1
双佳	shuang jia	1
双甲脒	shuang jia mi	1
双链季胺盐	shuang lian ji an yan	1
双氯芬酸钾	shuang lv fen suan jia	1
双氯芬酸钠	shuang lv fen suan na	1
双氯西林	shuang lv xi lin	1
双氯西林钠	shuang lv xi lin na	1
双咪苯脲	shuang mi ben niao	1
水菖蒲	shui chang pu	1
水红花子	shui hong hua zi	1
水葫芦	shui hu lu	1
水华	shui hua	1
水花生	shui hua sheng	1
水蔓青	shui man qing	1
水牛角	shui niu jiao	1
水牛角浓缩粉	shui niu jiao nong suo fen	1
水蚯蚓	shui qiu yin	1
水生维管束植物	shui sheng wei guan shu zhi wu	1
水苏	shui su	1
水蜈蚣	shui wu gong	1
水杨梅	shui yang mei	1
水杨酸钠	shui yang suan na	1
水银	shui yin	1
水蛭	shui zhi	1
四川白甲鱼	si chuan bai jia yu	1
四川半餐	si chuan ban can	1
四川华鳊	si chuan hua bian	1
四川华吸鳅	si chuan hua xi qiu	1
似刺鳊鲍	si ci bian bao	1
四带河鲀	si dai he tun	1
四方藤	si fang teng	1
丝瓜络	si gua luo	1
四季青	si ji qing	1
似鲛	si jiao	1
似鮈	si ju	1
似鲇高原鳅	si nian gao yuan qiu	1
四线天竺鲷	si xian tian zhu diao	1
四叶参	si ye shen	1
四长棘鲷	si zhang ji diao	1
四指马鲅	si zhi ma ba	1
松花粉	song hua fen	1
松江鲈	song jiang lu	1
淞江鲈	song jiang lu	1
松节油	song jie you	1
松萝	song luo	1
松球鱼	song qiu yu	1
松塔	song ta	1
松香	song xiang	1
松香脂	song xiang zhi	1
苏板兰	su ban lan	1
苏薄荷	su bo he	1
苏合香	su he xiang	1
苏木	su mu	1
速脲	su niao	1
素馨花	su xin hua	1
酸枣仁	suan zao ren	1
缩宫素	suo gong su	1
娑罗子	suo luo zi	1
锁阳	suo yang	1
蓑鲉	suo you	1
梭鱼	suo yu	1
塔里木裂腹鱼	ta li mu lie fu yu	1
太湖短吻银鱼	tai hu duan wen yin yu	1
酞磺胺噻唑	tai huang an sai zuo	1
泰乐菌素	tai le jun su	1
泰联	tai lian	1
泰妙菌素	tai miao jun su	1
泰诺林	tai nuo lin	1
泰诺宁康胶囊	tai nuo ning kang jiao nang	1
太平洋大比目鱼	tai ping yang da bi mu yu	1
泰氏	tai shi	1
台乌药	tai wu yao	1
鲐鱼	tai yu	1
太子参	tai zi shen	1
弹涂鱼	tan tu yu	1
檀香	tan xiang	1
烫狗脊	tang gou ji	1
烫骨碎补	tang gu sui bu	1
糖酵解	tang jiao jie	1
塘鳢科	tang li ke	1
唐人神	tang ren shen	1
唐人神集团	tang ren shen ji tuan	1
唐人神家园	tang ren shen jia yuan	1
烫水蛭	tang shui zhi	1
唐鱼	tang yu	1
桃儿七	tao er qi	1
桃金娘根	tao jin niang gen	1
桃仁	tao ren	1
套养	tao yang	1
藤梨根	teng li gen	1
鯷	ti	1
鯷科	ti ke	1
替米考星	ti mi kao xing	1
鯷鱼	ti yu	1
甜地丁	tian di ding	1
天冬	tian dong	1
甜瓜子	tian gua zi	1
天花粉	tian hua fen	1
天佳	tian jia	1
天葵子	tian kui zi	1
天龙	tian long	1
天马	tian ma	1
天麻	tian ma	1
天名精	tian ming jing	1
天南星	tian nan xing	1
田三七	tian san qi	1
天仙藤	tian xian teng	1
天元超市	tian yuan chao shi	1
天元区	tian yuan qu	1
天竺黄	tian zhu huang	1
条鳎	tiao ta	1
条纹东方鲀	tiao wen dong fang tun	1
铁落	tie luo	1
铁骑列士	tie qi lie shi	1
铁苋菜	tie xian cai	1
葶苈子	ting li zi	1
通草	tong cao	1
通程	tong cheng	1
通威	tong wei	1
铜鱼	tong yu	1
头孢氨苄	tou bao an bian	1
头孢拉定	tou bao la ding	1
头孢米诺钠	tou bao mi nuo na	1
头孢曲松钠	tou bao qu song na	1
头孢噻吩钠	tou bao sai fen na	1
头孢噻呋	tou bao sai fu	1
头孢噻呋钠	tou bao sai fu na	1
头孢噻肟钠	tou bao sai wo na	1
头孢他啶	tou bao ta ding	1
头孢唑啉钠	tou bao zuo lin na	1
头孢唑肟钠	tou bao zuo wo na	1
透骨草	tou gu cao	1
土贝母	tu bei mu	1
土鳖虫	tu bie chong	1
土大黄	tu dai huang	1
土党参	tu dang shen	1
突额鹦嘴鱼	tu e ying zui yu	1
土茯苓	tu fu ling	1
土荆皮	tu jing pi	1
土霉素碱	tu mei su jian	1
土牛膝	tu niu xi	1
菟丝子	tu si zi	1
团头鲂	tuan tou fang	1
鲀科	tun ke	1
驼背三棱箱鲀	tuo bei san leng xiang tun	1
妥布霉素	tuo bu mei su	1
妥曲珠利	tuo qu zhu li	1
瓦楞子	wa leng zi	1
瓦松	wa song	1
外毒素	wai du su	1
万年青	wan nian qing	1
王不留行	wang bu liu xing	1
王鲑	wang gui	1
网纹裸胸鳝	wang wen luo xiong shan	1
网纹石班鱼	wang wen shi ban yu	1
网箱养殖	wang xiang yang zhi	1
鮠科	wei ke	1
煨柯子	wei ke zi	1
围栏养殖	wei lan yang zhi	1
委陵菜	wei ling cai	1
威灵仙	wei ling xian	1
煨肉豆蔻	wei rou dou kou	1
纹腹叉鼻鲀	wen fu cha bi tun	1
纹缟鰕虎鱼	wen gao xia hu yu	1
吻沟双髻鲨	wen gou shuang ji sha	1
温和噬菌体	wen he shi jun ti	1
吻鮈	wen ju	1
温氏	wen shi	1
温郁金	wen yu jin	1
五倍子	wu bei zi	1
乌鲳	wu chang	1
武昌副沙鳅	wu chang fu sha qiu	1
武昌鱼	wu chang yu	1
戊二醛	wu er quan	1
蜈蚣	wu gong	1
乌骨鸡	wu gu ji	1
五家岭	wu jia ling	1
五甲嘧啶钠	wu jia mi ding na	1
五加皮	wu jia pi	1
无节幼体	wu jie you ti	1
乌韭	wu jiu	1
乌桕	wu jiu	1
无菌	wu jun	1
乌鳢	wu li	1
无鳞甲三刺鱼	wu lin jia san ci yu	1
五灵脂	wu ling zhi	1
乌洛托品	wu luo tuo pin	1
乌梅	wu mei	1
污染物	wu ran wu	1
乌梢蛇	wu shao she	1
无水枸橼酸	wu shui ju yuan suan	1
乌苏里白鲑	wu su li bai gui	1
五味子	wu wei zi	1
乌药	wu yao	1
芜荑	wu yi	1
五指毛桃	wu zhi mao tao	1
吴茱萸	wu zhu yu	1
细胞介导免疫	xi bao jie dao mian yi	1
西党参	xi dang shen	1
西瓜	xi gua	1
西瓜皮	xi gua pi	1
西瓜霜	xi gua shuang	1
西河柳	xi he liu	1
西湖颌须鮈	xi hu he xu ju	1
犀角	xi jiao	1
希杰	xi jie	1
细鳞斜颌鲴	xi lin xie he gu	1
昔咪替丁	xi mi ti ding	1
西青果	xi qing guo	1
喜树	xi shu	1
细体鮠	xi ti wei	1
豨莶草	xi xian cao	1
细辛	xi xin	1
西洋参	xi yang shen	1
稀有白甲鱼	xi you bai jia yu	1
暇虎鱼科	xia hu yu ke	1
夏枯草	xia ku cao	1
夏天无	xia tian wu	1
狭纹虎鲨	xia wen hu sha	1
仙发	xian fa	1
仙鹤草	xian he cao	1
仙茅	xian mao	1
仙桃草	xian tao cao	1
鲜竹沥	xian zhu li	1
香白芷	xiang bai zhi	1
湘北	xiang bei	1
湘北大区	xiang bei da qu	1
湘北大区荆州鱼料专线	xiang bei da qu jing zhou yu liao zhuan xian	1
湘大	xiang da	1
香附	xiang fu	1
香果脂	xiang guo zhi	1
湘华鲮	xiang hua ling	1
香加皮	xiang jia pi	1
湘江蛇鮈	xiang jiang she ju	1
湘江野鲤	xiang jiang ye li	1
象皮	xiang pi	1
香薷	xiang ru	1
响石岭	xiang shi ling	1
向天盏	xiang tian zhan	1
象牙	xiang ya	1
香橼	xiang yuan	1
湘云鲫	xiang yun ji	1
小春花	xiao chun hua	1
小带鱼	xiao dai yu	1
小飞扬草	xiao fei yang cao	1
小浮萍	xiao fu ping	1
小公鱼	xiao gong yu	1
小红参	xiao hong shen	1
小茴香	xiao hui xiang	1
小蓟	xiao ji	1
小口白甲鱼	xiao kou bai jia yu	1
小口棒花鱼	xiao kou bang hua yu	1
小鳞鱵	xiao lin zhen	1
硝氯酚	xiao lv fen	1
小球藻	xiao qiu zao	1
小肽	xiao tai	1
小通草	xiao tong cao	1
小头栉孔鰕虎鱼	xiao tou zhi kong xia hu yu	1
小野鸡尾	xiao ye ji wei	1
薤白	xie bai	1
缬草	xie cao	1
蟹壳	xie ke	1
斜纹蝴蝶鱼	xie wen hu die yu	1
新洁而灭	xin jie er mie	1
辛硫磷	xin liu lin	1
新诺明	xin nuo ming	1
信前期	xin qian qi	1
新希望	xin xi wang	1
新杨	xin yang	1
辛夷	xin yi	1
新月锦鱼	xin yue jin yu	1
新月藻	xin yue zao	1
星斑裸颊鲷	xing ban luo jia diao	1
星点东方鲀	xing dian dong fang tun	1
兴国红鲤	xing guo hong li	1
兴凯刺鰟鮍	xing kai ci pang pi	1
星鳗	xing man	1
性丝	xing si	1
熊胆	xiong dan	1
雄黄	xiong huang	1
溴氯海	xiu lv hai	1
溴氢菊脂	xiu qing ju zhi	1
徐长卿	xu chang qing	1
续断	xu duan	1
须鱲	xu la	1
许氏平鲉	xu shi ping you	1
续随子	xu sui zi	1
萱草根	xuan cao gen	1
旋覆花	xuan fu hua	1
旋复花	xuan fu hua	1
玄明粉	xuan ming fen	1
宣木瓜	xuan mu gua	1
玄参	xuan shen	1
选择培养基	xuan ze pei yang ji	1
雪胆	xue dan	1
血粉	xue fen	1
血竭	xue jie	1
雪梨干	xue li gan	1
雪莲花	xue lian hua	1
血清型	xue qing xing	1
雪上一枝蒿	xue shang yi zhi hao	1
血余炭	xue yu tan	1
寻骨风	xun gu feng	1
循环水养鱼	xun huan shui yang yu	1
鲟科	xun ke	1
芽孢	ya bao	1
亚单位疫苗	ya dan wei yi miao	1
鸦胆子	ya dan zi	1
丫啶黄	ya ding huang	1
亚甲基蓝	ya jia ji lan	1
鸭料	ya liao	1
亚麻子	ya ma zi	1
鸦片	ya pian	1
牙鲆	ya ping	1
鸭跖草	ya zhi cao	1
岩白菜	yan bai cai	1
岩白菜素	yan bai cai su	1
盐补骨脂	yan bu gu zhi	1
盐车前子	yan che qian zi	1
盐杜仲	yan du zhong	1
延胡索	yan hu suo	1
盐黄柏	yan huang bo	1
盐橘核	yan ju he	1
盐荔枝核	yan li zhi he	1
盐霉素	yan mei su	1
盐盘	yan pan	1
盐沙苑子	yan sha yuan zi	1
烟酸	yan suan	1
盐酸氨丙啉	yan suan an bing lin	1
盐酸氨溴索	yan suan an xiu suo	1
盐酸苯海拉明	yan suan ben hai la ming	1
盐酸大观霉素	yan suan da guan mei su	1
盐酸地芬诺脂	yan suan di fen nuo zhi	1
盐酸敌菌净	yan suan di jun jing	1
盐酸恩诺沙星	yan suan en nuo sha xing	1
盐酸二甲弗林	yan suan er jia fu lin	1
盐酸氟哌酸	yan suan fu pai suan	1
盐酸甲烯土霉素	yan suan jia xi tu mei su	1
盐酸金刚烷胺	yan suan jin gang wan an	1
盐酸金刚乙胺	yan suan jin gang yi an	1
盐酸克林霉素	yan suan ke lin mei su	1
盐酸洛哌丁胺	yan suan luo pai ding an	1
盐酸氯苯胍	yan suan lv ben gua	1
盐酸氯丙嗪口服	yan suan lv bing qin kou fu	1
盐酸氯丙嗪注射	yan suan lv bing qin zhu she	1
盐酸吗啉胍	yan suan ma lin gua	1
烟酸诺氟沙星	yan suan nuo fu sha xing	1
盐酸强力霉素	yan suan qiang li mei su	1
盐酸肾上腺素	yan suan shen shang xian su	1
盐酸四环素	yan suan si huan su	1
盐酸四咪唑	yan suan si mi zuo	1
盐酸土霉素	yan suan tu mei su	1
盐酸胃复安	yan suan wei fu an	1
盐酸溴已新	yan suan xiu yi xin	1
盐酸异丙嗪	yan suan yi bing qin	1
盐酸左旋咪唑	yan suan zuo xuan mi zuo	1
盐菟丝子	yan tu si zi	1
盐吴茱萸	yan wu zhu yu	1
盐小茴香	yan xiao hui xiang	1
厌氧微生物	yan yang wei sheng wu	1
燕鳐鱼	yan yao yu	1
盐益智仁	yan yi zhi ren	1
岩原鲤	yan yuan li	1
胭脂鲫	yan zhi ji	1
盐知母	yan zhi mu	1
胭脂鱼	yan zhi yu	1
胭脂鱼科	yan zhi yu ke	1
洋地黄叶	yang di huang ye	1
羊耳菊	yang er ju	1
羊肝	yang gan	1
洋金花	yang jin hua	1
阳起石	yang qi shi	1
羊肉	yang rou	1
杨树花	yang shu hua	1
扬翔	yang xiang	1
摇蚊	yao wen	1
摇蚊幼虫	yao wen you chong	1
射干	ye gan	1
野菊花	ye ju hua	1
野马追	ye ma zhui	1
夜明砂	ye ming sha	1
野木瓜	ye mu gua	1
叶酸	ye suan	1
伊贝母	yi bei mu	1
异鳔鳅鮀	yi biao qiu tuo	1
异丙肾上腺素	yi bing shen shang xian su	1
宜昌鳅鮀	yi chang qiu tuo	1
乙醇发酵	yi chun fa jiao	1
一点红	yi dian hong	1
溢多利	yi duo li	1
异恶草松原药	yi e cao song yuan yao	1
抑菌	yi jun	1
衣壳	yi ke	1
衣壳粒	yi ke li	1
异鱲	yi la	1
益母草	yi mu cao	1
饴糖	yi tang	1
伊维菌素	yi wei jun su	1
乙酰螺旋霉素	yi xian luo xuan mei su	1
异烟肼	yi yan jing	1
益阳基地	yi yang ji di	1
异养菌	yi yang jun	1
乙氧酰胺苯甲酯	yi yang xian an ben jia zhi	1
益阳湘大	yi yang xiang da	1
一叶荻	yi ye di	1
薏苡仁	yi yi ren	1
异育银鲫	yi yu yin ji	1
伊元	yi yuan	1
一枝黄花	yi zhi huang hua	1
益智仁	yi zhi ren	1
银柴胡	yin chai hu	1
茵陈	yin chen	1
阴地蕨	yin di jue	1
印度无齿鲳	yin du wu chi chang	1
吲哚美辛	yin duo mei xin	1
银耳	yin er	1
银方头鱼	yin fang tou yu	1
银鲴	yin gu	1
银鲑	yin gui	1
银鲫	yin ji	1
银飘鱼	yin piao yu	1
银色颌须鮈	yin se he xu ju	1
阴性草	yin xing cao	1
银杏叶	yin xing ye	1
淫羊藿	yin yang huo	1
银鱼	yin yu	1
鮣鱼	yin yu	1
莹斑篮子鱼	ying ban lan zi yu	1
蝇毒磷	ying du lin	1
罂粟壳	ying su ke	1
营销	ying xiao	1
营养物质	ying yang wu zhi	1
鳙	yong	1
永惠	yong hui	1
鲬鱼	yong yu	1
鳙鱼	yong yu	1
诱变剂	you bian ji	1
幼鳖	you bie	1
油餐	you can	1
油鲱	you fei	1
优氯净	you lv jing	1
油松节	you song jie	1
有性繁殖	you xing fan zhi	1
右旋泛酸钙	you xuan fan suan gai	1
右旋泛酸钠	you xuan fan suan na	1
右旋糖酐	you xuan tang gan	1
右旋糖酐铁	you xuan tang gan tie	1
幼鱼期	you yu qi	1
鱼蚌混养	yu bang hun yang	1
预混料	yu hun liao	1
玉桔梗	yu jie geng	1
郁金	yu jin	1
郁李仁	yu li ren	1
鱼料专线	yu liao zhuan xian	1
育灵	yu ling	1
玉米须	yu mi xu	1
羽鳃鲐	yu sai tai	1
雨伞旗鱼	yu san qi yu	1
羽纹蝴蝶鱼	yu wen hu die yu	1
玉屑	yu xie	1
鱼腥草	yu xing cao	1
禹余粮	yu yu liang	1
预知子	yu zhi zi	1
玉竹	yu zhu	1
元宝草	yuan bao cao	1
远东拟沙丁鱼	yuan dong ni sha ding yu	1
原核细胞	yuan he xi bao	1
芫花	yuan hua	1
圆口铜鱼	yuan kou tong yu	1
原生质体	yuan sheng zhi ti	1
圆筒吻鮈	yuan tong wen ju	1
圆鮀鲣	yuan tuo jian	1
圆尾斗鱼	yuan wei dou yu	1
圆吻鲴	yuan wen gu	1
远志	yuan zhi	1
粤海	yue hai	1
月季花	yue ji hua	1
月见草	yue jian cao	1
岳鲤	yue li	1
月鳢	yue li	1
越南刺鰟鮍	yue nan ci pang pi	1
岳泰	yue tai	1
岳泰集团	yue tai ji tuan	1
云斑海猪鱼	yun ban hai zhu yu	1
孕马血清促性腺激素	yun ma xue qing cu xing xian ji su	1
云母石	yun mu shi	1
云实根	yun shi gen	1
云纹石斑鱼	yun wen shi ban yu	1
芸香草	yun xiang cao	1
皂角刺	zao jiao ci	1
藻类	zao lei	1
泽兰	ze lan	1
泽漆	ze qi	1
泽泻	ze xie	1
赠包	zeng bao	1
增养殖	zeng yang zhi	1
窄谱	zhai pu	1
窄体舌鳎	zhai ti she ta	1
樟脑	zhang nao	1
樟脑磺酸钠	zhang nao huang suan na	1
浙贝母	zhe bei mu	1
浙江原缨口鳅	zhe jiang yuan ying kou qiu	1
哲罗鱼	zhe luo yu	1
遮目鱼	zhe mu yu	1
赭石	zhe shi	1
真鲷	zhen diao	1
珍菊降压片	zhen ju jiang ya pian	1
真燕鳐	zhen yan yao	1
珍珠	zhen zhu	1
珍珠池	zhen zhu chi	1
珍珠母	zhen zhu mu	1
正邦	zheng bang	1
正大	zheng da	1
正丁精	zheng ding jing	1
正虹	zheng hong	1
正虹集团	zheng hong ji tuan	1
正圆	zheng yuan	1
炙百部	zhi bai bu	1
制白附子	zhi bai fu zi	1
炙必甲	zhi bi jia	1
稚鳖	zhi bie	1
致病性	zhi bing xing	1
制草乌	zhi cao wu	1
制川乌	zhi chuan wu	1
制大黄	zhi da huang	1
炙冬花	zhi dong hua	1
脂多糖	zhi duo tang	1
炙甘草	zhi gan cao	1
制龟板	zhi gui ban	1
制何首乌	zhi he shou wu	1
制黄精	zhi huang jing	1
制黄芪	zhi huang qi	1
炙黄芪	zhi huang qi	1
枳具子	zhi ju zi	1
枳壳	zhi ke	1
质粒	zhi li	1
制马兜铃	zhi ma dou ling	1
炙麻黄	zhi ma huang	1
制马钱子	zhi ma qian zi	1
知母	zhi mu	1
稚嫩	zhi nen	1
炙杷叶	zhi pa ye	1
炙桑皮	zhi sang pi	1
炙升麻	zhi sheng ma	1
枳实	zhi shi	1
致死温度	zhi si wen du	1
炙苏子	zhi su zi	1
制天南星	zhi tian nan xing	1
栉暇虎鱼	zhi xia hu yu	1
制香附	zhi xiang fu	1
稚鱼期	zhi yu qi	1
制远志	zhi yuan zhi	1
支柱蓼	zhi zhu liao	1
蜘蛛香	zhi zhu xiang	1
栀子	zhi zi	1
炙紫苑	zhi zi yuan	1
中国团扇鳐	zhong guo tuan shan yao	1
中华倒刺鲃	zhong hua dao ci ba	1
中华花鳅	zhong hua hua qiu	1
中华间吸鳅	zhong hua jian xi qiu	1
中华人名共和国	zhong hua ren ming gong he guo	1
中华绒螯蟹	zhong hua rong ao xie	1
中华沙鳅	zhong hua sha qiu	1
中华鲟	zhong hua xun	1
肿节风	zhong jie feng	1
重口裂腹鱼	zhong kou lie fu yu	1
钟乳石	zhong ru shi	1
皱唇鲨	zhou chun sha	1
周质空间	zhou zhi kong jian	1
主动免疫	zhu dong mian yi	1
主动运输	zhu dong yun shu	1
珠儿参	zhu er can	1
猪茯苓	zhu fu ling	1
竹节参	zhu jie shen	1
猪苓	zhu ling	1
苎麻根	zhu ma gen	1
竹茹	zhu ru	1
朱砂	zhu sha	1
朱砂冬	zhu sha dong	1
朱砂根	zhu sha gen	1
朱砂莲	zhu sha lian	1
朱砂七	zhu sha qi	1
猪蹄甲	zhu ti jia	1
猪牙皂	zhu ya zao	1
猪殃殃	zhu yang yang	1
竹叶柴胡	zhu ye chai hu	1
株洲湘大	zhu zhou xiang da	1
珠子参	zhu zi shen	1
猪鬃草	zhu zong cao	1
转导	zhuan dao	1
转化	zhuan hua	1
转座	zhuan zuo	1
紫薄鳅	zi bao qiu	1
紫贝齿	zi bei chi	1
紫草	zi cao	1
紫草根	zi cao gen	1
紫草茸	zi cao rong	1
紫丹参	zi dan shen	1
紫河车	zi he che	1
紫红笛鲷	zi hong di diao	1
紫花地丁	zi hua di ding	1
紫荆皮	zi jing pi	1
子囊	zi nang	1
紫萁贯众	zi qi guan zhong	1
自然铜	zi ran tong	1
紫色东方鲀	zi se dong fang tun	1
自身抗体	zi shen kang ti	1
自身抗原	zi shen kang yuan	1
自身免疫疾病	zi shen mian yi ji bing	1
紫石英	zi shi ying	1
紫苏	zi su	1
紫苏梗	zi su geng	1
紫苏叶	zi su ye	1
紫苏子	zi su zi	1
紫菀	zi wan	1
紫菀花	zi wan hua	1
鲻鱼	zi yu	1
紫竹	zi zhu	1
鯮	zong	1
纵带石斑鱼	zong dai shi ban yu	1
棕点石斑鱼	zong dian shi ban yu	1
棕榈	zong lv	1
棕榈炭	zong lv tan	1
祖司麻	zu si ma	1
左旋氧氟沙星	zuo xuan yang fu sha xing	1
