哀而不伤	ai er bu shang	1
哀公问	ai gong wen	1
哀公问社于宰我	ai gong wen she yu zai wo	1
哀公问于有若曰	ai gong wen yu you ruo yue	1
哀公问曰	ai gong wen yue	1
爱人	ai ren	1
爱之	ai zhi	1
爱之欲其生	ai zhi yu qi sheng	1
安见方六七十	an jian fang liu qi shi	1
安女安则为之	an nv an ze wei zhi	1
安无倾	an wu qing	1
奡荡舟	ao dang zhou	1
八佾第三	ba yi di san	1
八佾舞于庭	ba yi wu yu ting	1
霸诸侯	ba zhu hou	1
拜而受之	bai er shou zhi	1
百工居肆以成其事	bai gong ju si yi cheng qi shi	1
百官之富	bai guan zhi fu	1
百官总己以听于冢宰	bai guan zong ji yi ting yu zhong zai	1
百物生焉	bai wu sheng yan	1
拜下	bai xia	1
百姓不足	bai xing bu zu	1
百姓有过	bai xing you guo	1
百姓足	bai xing zu	1
版者	ban zhe	1
邦分崩离析	bang fen beng li xi	1
邦君树塞门	bang jun shu sai men	1
邦君为两君之好	bang jun wei liang jun zhi hao	1
邦君之妻	bang jun zhi qi	1
邦人称之曰君夫人	bang ren cheng zhi yue jun fu ren	1
邦无道	bang wu dao	1
邦无道如矢	bang wu dao ru shi	1
邦无道则可卷而怀之	bang wu dao ze ke juan er huai zhi	1
邦有道	bang you dao	1
邦有道如矢	bang you dao ru shi	1
邦有道则仕	bang you dao ze shi	1
邦曰寡小君	bang yue gua xiao jun	1
暴虎冯河	bao hu ping he	1
饱食终日	bao shi zhong ri	1
奔而殿	ben er dian	1
本立而道生	ben li er dao sheng	1
本之则无	ben zhi ze wu	1
必变	bi bian	1
必变色而作	bi bian se er zuo	1
必表而出之	bi biao er chu zhi	1
必不得已而去	bi bu de yi er qu	1
必察焉	bi cha yan	1
裨谌草创之	bi chen cao chuang zhi	1
必畜之	bi chu zhi	1
鄙夫可与事君也与哉	bi fu ke yu shi jun ye yu zai	1
必复命曰	bi fu ming yue	1
比干谏而死	bi gan jian er si	1
比及三年	bi ji san nian	1
必齐如也	bi qi ru ye	1
必趋	bi qu	1
必杀之	bi sha zhi	1
必世而后仁	bi shi er hou ren	1
必使反之	bi shi fan zhi	1
必失之	bi shi zhi	1
必熟而荐之	bi shu er jian zhi	1
必文	bi wen	1
必闻其政	bi wen qi zheng	1
必先利其器	bi xian li qi qi	1
必偃	bi yan	1
必也狂狷乎	bi ye kuang juan hu	1
必也临事而惧	bi ye lin shi er ju	1
必也亲丧乎	bi ye qin sang hu	1
必也射乎	bi ye she hu	1
必也圣乎	bi ye sheng hu	1
必也使无讼乎	bi ye shi wu song hu	1
必也正名乎	bi ye zheng ming hu	1
必以貌	bi yi mao	1
必有近忧	bi you jin you	1
必有可观者焉	bi you ke guan zhe yan	1
必有邻	bi you lin	1
必有明衣	bi you ming yi	1
必有寝衣	bi you qin yi	1
必有我师焉	bi you wo shi yan	1
鄙哉	bi zai	1
彼哉	bi zai	1
必正立执绥	bi zheng li zhi sui	1
必正席先尝之	bi zheng xi xian chang zhi	1
必作	bi zuo	1
便便言	bian bian yan	1
笾豆之事	bian dou zhi shi	1
辨惑	bian huo	1
卞庄子之勇	bian zhuang zi zhi yong	1
宾不顾矣	bin bu gu yi	1
宾退	bin tui	1
病间	bing jian	1
屏气似不息者	bing qi si bu xi zhe	1
伯牛有疾	bo niu you ji	1
勃如战色	bo ru zhan se	1
播鼗	bo tao	1
博我以文	bo wo yi wen	1
博学而笃志	bo xue er du zhi	1
博学而无所成名	bo xue er wu suo cheng ming	1
博学于文	bo xue yu wen	1
伯夷叔	bo yi shu	1
伯夷叔齐饿于首阳之下	bo yi shu qi e yu shou yang zhi xia	1
伯夷叔齐与	bo yi shu qi yu	1
不拜	bu bai	1
不保其往也	bu bao qi wang ye	1
不病人之不己知也	bu bing ren zhi bu ji zhi ye	1
不撤姜食	bu che jiang shi	1
不成人之恶	bu cheng ren zhi e	1
不处也	bu chu ye	1
不达	bu da	1
不得	bu de	1
不得大葬	bu de da zang	1
不得其酱	bu de qi jiang	1
不得其死然	bu de qi si ran	1
不得与之言	bu de yu zhi yan	1
不得中行而与之	bu de zhong hang er yu zhi	1
不多也	bu duo ye	1
不贰过	bu er guo	1
不悱不发	bu fei bu fa	1
不愤不启	bu fen bu qi	1
不敢不告也	bu gan bu gao ye	1
不敢尝	bu gan chang	1
不好犯上	bu hao fan shang	1
不恒其德	bu heng qi de	1
不患寡	bu huan gua	1
不患莫己知	bu huan mo ji zhi	1
不患贫而患不安	bu huan pin er huan bu an	1
不患人之不己知	bu huan ren zhi bu ji zhi	1
不患无位	bu huan wu wei	1
不几乎一言而	bu ji hu yi yan er	1
不几乎一言而兴邦乎	bu ji hu yi yan er xing bang hu	1
不及乱	bu ji luan	1
不疾言	bu ji yan	1
不践迹	bu jian ji	1
不见宗庙之美	bu jian zong miao zhi mei	1
不教而杀谓之虐	bu jiao er sha wei zhi nue	1
不戒视成谓之暴	bu jie shi cheng wei zhi bao	1
不敬	bu jing	1
不可	bu ke	1
不可不知也	bu ke bu zhi ye	1
不可废也	bu ke fei ye	1
不可好从事而亟失时	bu ke hao cong shi er ji shi shi	1
不可弃也	bu ke qi ye	1
不可使知之	bu ke shi zhi zhi	1
不可徒行也	bu ke tu xing ye	1
不可罔也	bu ke wang ye	1
不可陷也	bu ke xian ye	1
不可以长处乐	bu ke yi chang chu le	1
不可以为滕薛大夫	bu ke yi wei teng xue dai fu	1
不可以语上也	bu ke yi yu shang ye	1
不可以作巫医	bu ke yi zuo wu yi	1
不可与言而与之言	bu ke yu yan er yu zhi yan	1
不可则止	bu ke ze zhi	1
不令而行	bu ling er xing	1
不谋其政	bu mou qi zheng	1
不能	bu neng	1
不能死	bu neng si	1
不能以礼让为国	bu neng yi li rang wei guo	1
不能用也	bu neng yong ye	1
不能者止	bu neng zhe zhi	1
不能正其身	bu neng zheng qi shen	1
不能专对	bu neng zhuan dui	1
不逆诈	bu ni zha	1
不其	bu qi	1
布齐必变食	bu qi bi bian shi	1
不迁怒	bu qian nu	1
不亲指	bu qin zhi	1
不取乎	bu qu hu	1
不去也	bu qu ye	1
不然	bu ran	1
不仁者不可以久处约	bu ren zhe bu ke yi jiu chu yue	1
不仁者远矣	bu ren zhe yuan yi	1
不如好之者	bu ru hao zhi zhe	1
不辱君命	bu ru jun ming	1
不如乐之者	bu ru le zhi zhe	1
不辱其身	bu ru qi shen	1
不如仁人	bu ru ren ren	1
不如是之甚也	bu ru shi zhi shen ye	1
不如学也	bu ru xue ye	1
不如诸夏之亡也	bu ru zhu xia zhi wang ye	1
不善不能改	bu shan bu neng gai	1
不舍昼夜	bu she zhou ye	1
不食	bu shi	1
不时	bu shi	1
不使不仁者加乎其身	bu shi bu ren zhe jia hu qi shen	1
不使大臣怨乎不以	bu shi da chen yuan hu bu yi	1
不使胜食气	bu shi sheng shi qi	1
不仕无义	bu shi wu yi	1
不食之矣	bu shi zhi yi	1
不说也	bu shuo ye	1
不俟驾行矣	bu si jia xing yi	1
不宿肉	bu su rou	1
不图为乐之至于斯也	bu tu wei le zhi zhi yu si ye	1
不违	bu wei	1
不为酒困	bu wei jiu kun	1
不问马	bu wen ma	1
不吾知也如或知尔	bu wu zhi ye ru huo zhi er	1
不贤者识其小者	bu xian zhe shi qi xiao zhe	1
不降其志	bu xiang qi zhi	1
不相为谋	bu xiang wei mou	1
不笑	bu xiao	1
不幸短命死矣	bu xing duan ming si yi	1
不行焉	bu xing yan	1
不学礼	bu xue li	1
不学诗	bu xue shi	1
不以兵车	bu yi bing che	1
不亿不信	bu yi bu xin	1
不易得也	bu yi de ye	1
不义而富且贵	bu yi er fu qie gui	1
不亦君子乎	bu yi jun zi hu	1
不亦可乎	bu yi ke hu	1
不亦乐乎	bu yi le hu	1
不以礼节之	bu yi li jie zhi	1
不以其道得之	bu yi qi dao de zhi	1
不以人废言	bu yi ren fei yan	1
不亦善乎	bu yi shan hu	1
不亦宜乎	bu yi yi hu	1
不亦远乎	bu yi yuan hu	1
不亦说乎	bu yi yue hu	1
不亦重乎	bu yi zhong hu	1
不有博弈者乎	bu you bo yi zhe hu	1
不忧不惧	bu you bu ju	1
不尤人	bu you ren	1
不有祝鮀之佞	bu you zhu tuo zhi ning	1
不逾矩	bu yu ju	1
不与其退也	bu yu qi tui ye	1
不怨天	bu yuan tian	1
不远游	bu yuan you	1
不曰白乎	bu yue bai hu	1
不曰坚乎	bu yue jian hu	1
不曰如之何	bu yue ru zhi he	1
不在其位	bu zai qi wei	1
不在颛臾	bu zai zhuan yu	1
不占而已矣	bu zhan er yi yi	1
不忮不求	bu zhi bu qiu	1
不知老之将至云尔	bu zhi lao zhi jiang zhi yun er	1
不知礼	bu zhi li	1
不知命	bu zhi ming	1
不知其可也	bu zhi qi ke ye	1
不知为不知	bu zhi wei bu zhi	1
不知言	bu zhi yan	1
不知也	bu zhi ye	1
不至于谷	bu zhi yu gu	1
不庄	bu zhuang	1
不足以为士矣	bu zu yi wei shi yi	1
不坐	bu zuo	1
才不才	cai bu cai	1
才难	cai nan	1
参乎	can hu	1
参也鲁	can ye lu	1
草上之风	cao shang zhi feng	1
策其马曰	ce qi ma yue	1
曾是以为	ceng shi yi wei	1
曾谓泰山不如林放乎	ceng wei tai shan bu ru lin fang hu	1
曾皙后	ceng xi hou	1
曾皙曰	ceng xi yue	1
曾由	ceng you	1
察其所安	cha qi suo an	1
察言而观色	cha yan er guan se	1
柴也愚	chai ye yu	1
襜如也	chan ru ye	1
谄也	chan ye	1
尝独立	chang du li	1
长而无述焉	chang er wu shu yan	1
长沮桀溺耦而耕	chang ju jie ni ou er geng	1
长沮曰	chang ju yue	1
常师之有	chang shi zhi you	1
长一身有半	chang yi shen you ban	1
朝服而立于阼阶	chao fu er li yu zuo jie	1
车中不内顾	che zhong bu nei gu	1
陈成子弑简公	chen cheng zi shi jian gong	1
陈恒弑其君	chen heng shi qi jun	1
陈亢退而喜曰	chen kang tui er xi yue	1
陈亢问于伯鱼曰	chen kang wen yu bo yu yue	1
陈力就列	chen li jiu lie	1
晨门曰	chen men yue	1
臣事君	chen shi jun	1
陈司败问	chen si bai wen	1
陈子禽谓子贡曰	chen zi qin wei zi gong yue	1
诚不以富	cheng bu yi fu	1
乘肥马	cheng fei ma	1
称其德也	cheng qi de ye	1
成事不说	cheng shi bu shuo	1
逞颜	cheng yan	1
乘殷之辂	cheng yin zhi lu	1
成于乐	cheng yu le	1
诚哉是言也	cheng zai shi yan ye	1
称诸异	cheng zhu yi	1
赤尔何如	chi er he ru	1
耻躬之不逮也	chi gong zhi bu dai ye	1
耻也	chi ye	1
赤也惑	chi ye huo	1
赤也为之小	chi ye wei zhi xiao	1
赤之适齐也	chi zhi shi qi ye	1
崇德也	chong de ye	1
臭恶	chou e	1
出辞气	chu ci qi	1
楚狂接舆歌而过孔子曰	chu kuang jie yu ge er guo kong zi yue	1
出门如见大宾	chu men ru jian da bin	1
出纳之吝	chu na zhi lin	1
出三日	chu san ri	1
出曰	chu yue	1
出则事公卿	chu ze shi gong qing	1
出则悌	chu ze ti	1
传不习乎	chuan bu xi hu	1
春服既成	chun fu ji cheng	1
纯如也	chun ru ye	1
赐不受命	ci bu shou ming	1
辞达而已矣	ci da er yi yi	1
辞毋	ci wu	1
赐也	ci ye	1
赐也达	ci ye da	1
赐也可使从政也与	ci ye ke shi cong zheng ye yu	1
次矣	ci yi	1
赐之墙也及肩	ci zhi qiang ye ji jian	1
从而不改	cong er bu gai	1
从我于陈蔡者	cong wo yu chen cai zhe	1
从吾所好	cong wu suo hao	1
从者病	cong zhe bing	1
从者见之	cong zhe jian zhi	1
从者曰	cong zhe yue	1
从之	cong zhi	1
踧如也	cu ru ye	1
大车无輗	da che wu ni	1
大德不逾闲	da de bu yu xian	1
大事不成	da shi bu cheng	1
大师挚适齐	da shi zhi shi qi	1
达巷党人曰	da xiang dang ren yue	1
大哉孔子	da zai kong zi	1
大哉问	da zai wen	1
大哉尧之为君也	da zai yao zhi wei jun ye	1
荡荡乎	dang dang hu	1
当仁不让于师	dang ren bu rang yu shi	1
当洒扫应对进退	dang sa sao ying dui jin tui	1
当暑	dang shu	1
道不同	dao bu tong	1
道不忧贫	dao bu you pin	1
祷尔于	dao er yu	1
道千乘之国	dao qian sheng zhi guo	1
道听而途说	dao ting er tu shuo	1
道之不行	dao zhi bu xing	1
道之将废也与	dao zhi jiang fei ye yu	1
道之将行也与	dao zhi jiang xing ye yu	1
道之斯行	dao zhi si xing	1
道之以德	dao zhi yi de	1
道之以政	dao zhi yi zheng	1
德不孤	de bu gu	1
得见君子者	de jian jun zi zhe	1
得见有恒者	de jian you heng zhe	1
得其门者或寡矣	de qi men zhe huo gua yi	1
德行	de xing	1
德之不修	de zhi bu xiu	1
德之弃也	de zhi qi ye	1
德之贼也	de zhi zei ye	1
帝臣不蔽	di chen bu bi	1
弟也	di ye	1
弟子服其劳	di zi fu qi lao	1
禘自既灌而往者	di zi ji guan er wang zhe	1
弟子入则孝	di zi ru ze xiao	1
弟子孰为好学	di zi shu wei hao xue	1
颠而不扶	dian er bu fu	1
点尔何如	dian er he ru	1
颠沛必于是	dian pei bi yu shi	1
定公问	ding gong wen	1
侗而不愿	dong er bu yuan	1
东里子产润色	dong li zi chan run se	1
动容貌	dong rong mao	1
东首	dong shou	1
动之不以礼	dong zhi bu yi li	1
动之斯和	dong zhi si he	1
斗筲之人	dou shao zhi ren	1
笃信好学	du xin hao xue	1
短右袂	duan you mei	1
端章甫	duan zhang fu	1
对曰	dui yue	1
夺伯氏骈邑三百	duo bo shi pian yi san bai	1
多见而识	duo jian er shi	1
多见其不知量也	duo jian qi bu zhi liang ye	1
多见阙殆	duo jian que dai	1
多食	duo shi	1
多识于鸟兽草木之名	duo shi yu niao shou cao mu zhi ming	1
多闻	duo wen	1
多闻阙疑	duo wen que yi	1
多怨	duo yuan	1
恶不仁者	e bu ren zhe	1
恶不孙以为勇者	e bu sun yi wei yong zhe	1
恶称人之恶者	e cheng ren zhi e zhe	1
恶果敢而窒者	e guo gan er zhi zhe	1
恶乎成名	e hu cheng ming	1
恶徼以为知者	e jiao yi wei zhi zhe	1
恶讦以为直	e jie yi wei zhi	1
恶利口之覆邦家者	e li kou zhi fu bang jia zhe	1
恶衣服而致美乎黻冕	e yi fu er zhi mei hu fu mian	1
恶勇而无礼者	e yong er wu li zhe	1
恶郑声之乱雅乐也	e zheng sheng zhi luan ya yue ye	1
恶之欲其	e zhi yu qi	1
恶紫之夺朱也	e zi zhi duo zhu ye	1
尔爱其羊	er ai qi yang	1
而不	er bu	1
而不耻者	er bu chi zhe	1
而不能守也	er bu neng shou ye	1
而不三黜	er bu san chu	1
而不与立也	er bu yu li ye	1
而不愠	er bu yun	1
而朝齐	er chao qi	1
而耻恶衣恶食者	er chi e yi e shi zhe	1
而犯之	er fan zhi	1
而非邦也者	er fei bang ye zhe	1
而好犯上者	er hao fan shang zhe	1
而好作乱者	er hao zuo luan zhe	1
而和	er he	1
而后从之	er hou cong zhi	1
而后和之	er hou he zhi	1
而后其食	er hou qi shi	1
而患不均	er huan bu jun	1
而货殖焉	er huo zhi yan	1
而今而后	er jin er hou	1
而可大受也	er ke da shou ye	1
而可小知也	er ke xiao zhi ye	1
而乱大伦	er luan da lun	1
而谋动干戈于邦内	er mou dong gan ge yu bang nei	1
而岂徒哉	er qi tu zai	1
而亲仁	er qin ren	1
而求也为之聚敛而附益之	er qiu ye wei zhi ju lian er fu yi zhi	1
二三子	er san zi	1
二三子何患于丧乎	er san zi he huan yu sang hu	1
二三子以我为隐乎	er san zi yi wo wei yin hu	1
而谁以易之	er shui yi yi zhi	1
尔所不知	er suo bu zhi	1
尔所谓达者	er suo wei da zhe	1
而往拜之	er wang bai zhi	1
而行违	er xing wei	1
而学诗	er xue shi	1
而亦何	er yi he	1
而由人乎哉	er you ren hu zai	1
而有宋朝之美	er you song chao zhi mei	1
而在萧墙之内也	er zai xiao qiang zhi nei ye	1
迩之事父	er zhi shi fu	1
而子证之	er zi zheng zhi	1
发愤忘食	fa fen wang shi	1
法语之言	fa yu zhi yan	1
泛爱众	fan ai zhong	1
樊迟出	fan chi chu	1
樊迟从游于舞雩之下	fan chi cong you yu wu yu zhi xia	1
樊迟请学稼	fan chi qing xue jia	1
樊迟退	fan chi tui	1
樊迟未达	fan chi wei da	1
樊迟问仁	fan chi wen ren	1
樊迟问知	fan chi wen zhi	1
樊迟御	fan chi yu	1
樊迟曰	fan chi yue	1
犯而不校	fan er bu jiao	1
饭疏食	fan shu shi	1
樊须也	fan xu ye	1
方六七十	fang liu qi shi	1
放于利而行	fang yu li er xing	1
非不说子之道	fei bu shuo zi zhi dao	1
非崇德与	fei chong de yu	1
非达也	fei da ye	1
非道弘人	fei dao hong ren	1
非夫人之为恸而	fei fu ren zhi wei tong er	1
非敢后也	fei gan hou ye	1
非敢为	fei gan wei	1
非公事	fei gong shi	1
非惑与	fei huo yu	1
非祭肉	fei ji rou	1
非礼勿动	fei li wu dong	1
非礼勿视	fei li wu shi	1
非礼勿听	fei li wu ting	1
非礼勿言	fei li wu yan	1
非其鬼而祭之	fei qi gui er ji zhi	1
非求益者也	fei qiu yi zhe ye	1
非帷裳	fei wei shang	1
非我也	fei wo ye	1
非吾徒也	fei wu tu ye	1
非修慝与	fei xiu te yu	1
非也	fei ye	1
菲饮食而致孝乎鬼神	fei yin shi er zhi xiao hu gui shen	1
非曰能之	fei yue neng zhi	1
废中权	fei zhong quan	1
非诸侯而何	fei zhu hou er he	1
非助我者也	fei zhu wo zhe ye	1
忿思难	fen si nan	1
风乎舞雩	feng hu wu yu	1
凤鸟不至	feng niao bu zhi	1
凤兮凤兮	feng xi feng xi	1
佛肸以中牟畔	fo xi yi zhong mu pan	1
佛肸召	fo xi zhao	1
夫达也者	fu da ye zhe	1
富而好礼者也	fu er hao li zhe ye	1
富而可求也	fu er ke qiu ye	1
夫二三	fu er san	1
富而无骄	fu er wu jiao	1
富而无骄易	fu er wu jiao yi	1
富贵在天	fu gui zai tian	1
夫何	fu he	1
夫何为哉	fu he wei zai	1
夫何忧何惧	fu he you he ju	1
夫君	fu jun	1
父没	fu mei	1
父母唯其疾之忧	fu mu wei qi ji zhi you	1
父母在	fu mu zai	1
父母之年	fu mu zhi nian	1
复其位	fu qi wei	1
富且贵焉	fu qie gui yan	1
夫然后行	fu ran hou xing	1
夫人不言	fu ren bu yan	1
夫仁者	fu ren zhe	1
夫人自称曰小童	fu ren zi cheng yue xiao tong	1
夫如是	fu ru shi	1
夫三年之丧	fu san nian zhi sang	1
夫三子者之言何如	fu san zi zhe zhi yan he ru	1
肤受之愬	fu shou zhi shuo	1
父为子隐	fu wei zi yin	1
夫闻也者	fu wen ye zhe	1
夫我则不暇	fu wo ze bu xia	1
富有	fu you	1
富与贵	fu yu gui	1
富哉	fu zai	1
父在	fu zai	1
夫召我者	fu zhao wo zhe	1
富之	fu zhi	1
夫执舆者为谁	fu zhi yu zhe wei shui	1
服周之冕	fu zhou zhi mian	1
夫颛臾	fu zhuan yu	1
夫子	fu zi	1
夫子不答	fu zi bu da	1
夫子不为也	fu zi bu wei ye	1
夫子不言	fu zi bu yan	1
夫子固有惑志于公伯寮	fu zi gu you huo zhi yu gong bo liao	1
夫子何哂由也	fu zi he shen you ye	1
夫子何为	fu zi he wei	1
夫子喟然叹曰	fu zi kui ran tan yue	1
夫子哂之	fu zi shen zhi	1
夫子圣者与	fu zi sheng zhe yu	1
夫子时然后言	fu zi shi ran hou yan	1
夫子矢之曰	fu zi shi zhi yue	1
夫子莞尔而笑	fu zi wan er er xiao	1
夫子为卫君乎	fu zi wei wei jun hu	1
夫子温良恭俭让以得之	fu zi wen liang gong jian rang yi de zhi	1
夫子怃然曰	fu zi wu ran yue	1
夫子循循然	fu zi xun xun ran	1
夫子焉不学	fu zi yan bu xue	1
夫子欲之	fu zi yu zhi	1
夫子之道	fu zi zhi dao	1
夫子之得邦家者	fu zi zhi de bang jia zhe	1
夫子之墙数仞	fu zi zhi qiang shu ren	1
夫子之求之也	fu zi zhi qiu zhi ye	1
夫子之说君子	fu zi zhi shuo jun zi	1
夫子至于是邦也	fu zi zhi yu shi bang ye	1
夫子之云	fu zi zhi yun	1
夫子自道也	fu zi zi dao ye	1
盖均无贫	gai jun wu pin	1
盖阙如也	gai que ru ye	1
盖十世希不失矣	gai shi shi xi bu shi yi	1
盖有不知而作之者	gai you bu zhi er zuo zhi zhe	1
盖有之	gai you zhi	1
改之为贵	gai zhi wei gui	1
敢问	gan wen	1
敢问崇德	gan wen chong de	1
敢问其次	gan wen qi ci	1
敢问死	gan wen si	1
敢用玄牡	gan yong xuan mu	1
敢昭告于皇皇后帝	gan zhao gao yu huang huang hou di	1
刚毅木讷	gang yi mu ne	1
告夫三子	gao fu san zi	1
羔裘	gao qiu	1
羔裘玄冠不以吊	gao qiu xuan guan bu yi diao	1
告于哀公曰	gao yu ai gong yue	1
告诸往而知来者	gao zhu wang er zhi lai zhe	1
高宗	gao zong	1
高宗谅阴	gao zong liang yin	1
割不正	ge bu zheng	1
割鸡焉用牛刀	ge ji yan yong niu dao	1
各于其党	ge yu qi dang	1
耕也	geng ye	1
更也人皆仰之	geng ye ren jie yang zhi	1
公伯寮其如命何	gong bo liao qi ru ming he	1
公伯寮愬子路于季孙	gong bo liao shuo zi lu yu ji sun	1
公绰之不欲	gong chuo zhi bu yu	1
恭而安	gong er an	1
恭而无礼则劳	gong er wu li ze lao	1
攻乎异端	gong hu yi duan	1
恭己正南面而已矣	gong ji zheng nan mian er yi yi	1
恭近于礼	gong jin yu li	1
恭宽信敏惠	gong kuan xin min hui	1
公明贾对曰	gong ming jia dui yue	1
攻其恶	gong qi e	1
公山弗扰以费畔召	gong shan fu rao yi fei pan zhao	1
宫室而尽力乎沟洫	gong shi er jin li hu gou xu	1
公叔文子之臣大夫僎	gong shu wen zi zhi chen dai fu zhuan	1
公西华曰	gong xi hua yue	1
躬行君子	gong xing jun zi	1
工欲善其事	gong yu shan qi shi	1
公曰	gong yue	1
恭则不侮	gong ze bu wu	1
公则说	gong ze shuo	1
攻之	gong zhi	1
躬自厚而薄责于人	gong zi hou er bo ze yu ren	1
苟合矣	gou he yi	1
苟美矣	gou mei yi	1
苟完矣	gou wan yi	1
苟无所不至矣	gou wu suo bu zhi yi	1
苟有过	gou you guo	1
苟有用我者	gou you yong wo zhe	1
苟正其身矣	gou zheng qi shen yi	1
苟志于仁矣	gou zhi yu ren yi	1
苟子之不欲	gou zi zhi bu yu	1
觚不觚	gu bu gu	1
故不为也	gu bu wei ye	1
故多能鄙事	gu duo neng bi shi	1
固而近于费	gu er jin yu fei	1
鼓方叔入于河	gu fang shu ru yu he	1
故夫三桓之子孙微矣	gu fu san huan zhi zi sun wei yi	1
故进之	gu jin zhi	1
故旧不遗	gu jiu bu yi	1
沽酒市脯不食	gu jiu shi pu bu shi	1
故旧无大故	gu jiu wu da gu	1
故君子名之必可言也	gu jun zi ming zhi bi ke yan ye	1
谷克伐怨欲不行焉	gu ke fa yuan yu bu xing yan	1
鼓瑟希	gu se xi	1
固天纵之将圣	gu tian zong zhi jiang sheng	1
故退之	gu tui zhi	1
固相师之道也	gu xiang shi zhi dao ye	1
故艺	gu yi	1
故远人不服	gu yuan ren bu fu	1
觚哉	gu zai	1
古者民有三疾	gu zhe min you san ji	1
古者言之不出	gu zhe yan zhi bu chu	1
古之	gu zhi	1
古之道也	gu zhi dao ye	1
古之狂也肆	gu zhi kuang ye si	1
古之人皆然	gu zhi ren jie ran	1
古之贤人也	gu zhi xian ren ye	1
古之学者为己	gu zhi xue zhe wei ji	1
古之愚也直	gu zhi yu ye zhi	1
沽之哉	gu zhi zai	1
瓜祭	gua ji	1
观过	guan guo	1
关雎	guan ju	1
关雎之乱	guan ju zhi luan	1
观其所由	guan qi suo you	1
观其行	guan qi xing	1
观其志	guan qi zhi	1
官事不摄	guan shi bu she	1
管氏而知礼	guan shi er zhi li	1
管氏亦树塞门	guan shi yi shu sai men	1
管氏有三归	guan shi you san gui	1
冠者五六人	guan zhe wu liu ren	1
管仲不死	guan zhong bu si	1
管仲非仁者与	guan zhong fei ren zhe yu	1
管仲俭乎	guan zhong jian hu	1
管仲之力也	guan zhong zhi li ye	1
管仲之器小哉	guan zhong zhi qi xiao zai	1
归孔子豚	gui kong zi tun	1
龟玉毁于椟中	gui yu hui yu du zhong	1
过而不改	guo er bu gai	1
过位	guo wei	1
过也人皆见之	guo ye ren jie jian zhi	1
过犹不及	guo you bu ji	1
果哉	guo zai	1
过则勿惮改	guo ze wu dan gai	1
过之	guo zhi	1
好刚不好学	hao gang bu hao xue	1
好古	hao gu	1
好谋而成者也	hao mou er cheng zhe ye	1
好仁不好学	hao ren bu hao xue	1
好仁者	hao ren zhe	1
好信不好学	hao xin bu hao xue	1
好行小慧	hao xing xiao hui	1
好学也已	hao xue ye yi	1
好勇不好学	hao yong bu hao xue	1
好勇疾贫	hao yong ji pin	1
好直不好学	hao zhi bu hao xue	1
好知不好学	hao zhi bu hao xue	1
好之者	hao zhi zhe	1
何必	he bi	1
何必读书	he bi du shu	1
何必改作	he bi gai zuo	1
何必公山氏之之也	he bi gong shan shi zhi zhi ye	1
何必去父母之邦	he bi qu fu mu zhi bang	1
河不出图	he bu chu tu	1
盍彻乎	he che hu	1
何德之衰	he de zhi shuai	1
何陋之有	he lou zhi you	1
何莫由斯道也	he mo you si dao ye	1
何其多能也	he qi duo neng ye	1
何如	he ru	1
何如斯可谓之士矣	he ru si ke wei zhi shi yi	1
何如斯可以从政矣	he ru si ke yi cong zheng yi	1
何伤乎	he shang hu	1
何事于仁	he shi yu ren	1
何为	he wei	1
和为贵	he wei gui	1
何谓惠而不费	he wei hui er bu fei	1
何为其莫知子也	he wei qi mo zhi zi ye	1
何谓四恶	he wei si e	1
何谓五美	he wei wu mei	1
何谓也	he wei ye	1
何为则民服	he wei ze min fu	1
和无寡	he wu gua	1
何晏也	he yan ye	1
何以报德	he yi bao de	1
何以伐为	he yi fa wei	1
何以文为	he yi wen wei	1
何有	he you	1
何有于我哉	he you yu wo zai	1
何哉	he zai	1
何足算也	he zu suan ye	1
何足以臧	he zu yi zang	1
红紫不以为亵服	hong zi bu yi wei xie fu	1
后进于礼乐	hou jin yu li yue	1
后生可畏	hou sheng ke wei	1
后世必为子孙忧	hou shi bi wei zi sun you	1
后死者不得与	hou si zhe bu de yu	1
虎豹之鞟犹犬羊之鞟	hu bao zhi kuo you quan yang zhi kuo	1
狐貉之厚以居	hu he zhi hou yi ju	1
狐裘	hu qiu	1
虎兕出于柙	hu si chu yu xia	1
互乡难与言	hu xiang nan yu yan	1
忽焉在后	hu yan zai hou	1
怀其宝而迷其邦	huai qi bao er mi qi bang	1
患不知人也	huan bu zhi ren ye	1
患得之	huan de zhi	1
桓公九合诸侯	huan gong jiu he zhu hou	1
桓公杀公子纠	huan gong sha gong zi jiu	1
焕乎其有文章	huan hu qi you wen zhang	1
患其不能也	huan qi bu neng ye	1
患失之	huan shi zhi	1
患所以立	huan suo yi li	1
桓魋其如予何	huan tui qi ru yu he	1
黄衣	huang yi	1
回何敢死	hui he gan si	1
诲女知之乎	hui nv zhi zhi hu	1
诲人不倦	hui ren bu juan	1
惠人也	hui ren ye	1
绘事后素	hui shi hou su	1
回虽不敏	hui sui bu min	1
回也	hui ye	1
回也不改其乐	hui ye bu gai qi le	1
回也不愚	hui ye bu yu	1
回也其庶乎	hui ye qi shu hu	1
回也视予犹父也	hui ye shi yu you fu ye	1
惠则足以使人	hui ze zu yi shi ren	1
或承之羞	huo cheng zhi xiu	1
或谓孔子曰	huo wei kong zi yue	1
或问禘之说	huo wen di zhi shuo	1
或问之曰	huo wen zhi yue	1
或问子产	huo wen zi chan	1
或曰	huo yue	1
获罪于天	huo zui yu tian	1
骥不称其力	ji bu cheng qi li	1
既得之	ji de zhi	1
既而曰	ji er yue	1
既富矣	ji fu yi	1
疾固也	ji gu ye	1
季桓子受之	ji huan zi shou zhi	1
及阶	ji jie	1
既竭吾才	ji jie wu cai	1
继绝世	ji jue shi	1
季康子患盗	ji kang zi huan dao	1
季康子问	ji kang zi wen	1
季康子问政于孔子	ji kang zi wen zheng yu kong zi	1
季康子问政于孔子曰	ji kang zi wen zheng yu kong zi yue	1
既来之	ji lai zhi	1
季路问事鬼神	ji lu wen shi gui shen	1
及其老也	ji qi lao ye	1
及其使人也	ji qi shi ren ye	1
及其壮也	ji qi zhuang ye	1
击磬乎	ji qing hu	1
祭肉不出三日	ji rou bu chu san ri	1
祭如在	ji ru zai	1
祭神如神在	ji shen ru shen zai	1
季氏第十六	ji shi di shi liu	1
季氏富于周公	ji shi fu yu zhou gong	1
季氏将伐颛臾	ji shi jiang fa zhuan yu	1
季氏将有事于颛臾	ji shi jiang you shi yu zhuan yu	1
季氏旅于泰山	ji shi lv yu tai shan	1
季氏使闵子骞为费宰	ji shi shi min zi qian wei fei zai	1
既庶矣	ji shu yi	1
祭思敬	ji si jing	1
己所不欲	ji suo bu yu	1
既往不咎	ji wang bu jiu	1
及席	ji xi	1
己欲达而达人	ji yu da er da ren	1
祭于公	ji yu gong	1
己欲立而立人	ji yu li er li ren	1
既欲其生	ji yu qi sheng	1
吉月必朝服	ji yue bi chao fu	1
期月而已可也	ji yue er yi ke ye	1
即之也温	ji zhi ye wen	1
祭之以礼	ji zhi yi li	1
疾之已甚	ji zhi yi shen	1
棘子成曰	ji zi cheng yue	1
季子然问	ji zi ran wen	1
箕子为之奴	ji zi wei zhi nu	1
加朝服	jia chao fu	1
嘉善而矜不能	jia shan er jin bu neng	1
加我数年	jia wo shu nian	1
加之以师旅	jia zhi yi shi lv	1
见不善如探汤	jian bu shan ru tan tang	1
见不贤而内自省也	jian bu xian er nei zi xing ye	1
见得思义	jian de si yi	1
见利思义	jian li si yi	1
见冕者与瞽者	jian mian zhe yu gu zhe	1
见其二子焉	jian qi er zi yan	1
见齐衰者	jian qi shuai zhe	1
见其与	jian qi yu	1
见善如不及	jian shan ru bu ji	1
见危授	jian wei shou	1
见贤思齐焉	jian xian si qi yan	1
见小利则	jian xiao li ze	1
见义不为	jian yi bu wei	1
简在帝心	jian zai di xin	1
俭则固	jian ze gu	1
见之	jian zhi	1
见志不从	jian zhi bu cong	1
见子夏曰	jian zi xia yue	1
将命者出户	jiang ming zhe chu hu	1
将入门	jiang ru men	1
降一等	jiang yi deng	1
降志辱身矣	jiang zhi ru shen yi	1
皦如也	jiao ru ye	1
教之	jiao zhi	1
皆不及门也	jie bu ji men ye	1
皆能有养	jie neng you yang	1
桀溺曰	jie ni yue	1
借人乘之	jie ren cheng zhi	1
皆雅言也	jie ya yan ye	1
阶也	jie ye	1
节用而爱人	jie yong er ai ren	1
戒之在得	jie zhi zai de	1
戒之在斗	jie zhi zai dou	1
戒之在色	jie zhi zai se	1
皆坐	jie zuo	1
今拜乎上	jin bai hu shang	1
今不取	jin bu qu	1
谨而信	jin er xin	1
今夫颛臾	jin fu zhuan yu	1
尽美矣	jin mei yi	1
今女安	jin nv an	1
今女画	jin nv hua	1
谨权量	jin quan liang	1
近仁	jin ren	1
浸润之谮	jin run zhi zen	1
今亡矣夫	jin wang yi fu	1
晋文公谲而不正	jin wen gong jue er bu zheng	1
今也纯俭	jin ye chun jian	1
今也或是之亡也	jin ye huo shi zhi wang ye	1
矜也廉	jin ye lian	1
今也则亡	jin ye ze wang	1
今由与求也	jin you yu qiu ye	1
近者说	jin zhe shuo	1
今之成人者何必然	jin zhi cheng ren zhe he bi ran	1
今之从政者殆而	jin zhi cong zheng zhe dai er	1
今之从政者何如	jin zhi cong zheng zhe he ru	1
今之矜也忿戾	jin zhi jin ye fen li	1
今之狂也荡	jin zhi kuang ye dang	1
今之孝者	jin zhi xiao zhe	1
今之学者为人	jin zhi xue zhe wei ren	1
今之愚也诈而已矣	jin zhi yu ye zha er yi yi	1
近之则不孙	jin zhi ze bu sun	1
敬鬼神而远之	jing gui shen er yuan zhi	1
敬事而信	jing shi er xin	1
敬虽州里行乎哉	jing sui zhou li xing hu zai	1
井有仁焉	jing you ren yan	1
厩焚	jiu fen	1
旧谷既没	jiu gu ji mei	1
九人而已	jiu ren er yi	1
久要不忘平生之言	jiu yao bu wang ping sheng zhi yan	1
久矣吾不复梦见周公	jiu yi wu bu fu meng jian zhou gong	1
久矣哉	jiu yi zai	1
就有道而正焉	jiu you dao er zheng yan	1
居必迁坐	ju bi qian zuo	1
俱不得其死然	ju bu de qi si ran	1
居不容	ju bu rong	1
居处不安	ju chu bu an	1
居处恭	ju chu gong	1
举尔所知	ju er suo zhi	1
举皋陶	ju gao yao	1
鞠躬如也	ju gong ru ye	1
居简而行简	ju jian er xing jian	1
居敬而行简	ju jing er xing jian	1
居其所而众星共之	ju qi suo er zhong xing gong zhi	1
举善而教不能	ju shan er jiao bu neng	1
居上不宽	ju shang bu kuan	1
居是邦也	ju shi bang ye	1
举枉错诸	ju wang cuo zhu	1
居无求安	ju wu qiu an	1
居吾语女	ju wu yu nv	1
举贤才	ju xian cai	1
举逸民	ju yi min	1
举伊尹	ju yi yin	1
举一隅不以三隅反	ju yi yu bu yi san yu fan	1
据于德	ju yu de	1
居则曰	ju ze yue	1
居之不疑	ju zhi bu yi	1
举直错诸枉	ju zhi cuo zhu wang	1
居之无倦	ju zhi wu juan	1
狷者有所不为也	juan zhe you suo bu wei ye	1
君臣之义	jun chen zhi yi	1
君称之曰夫人	jun cheng zhi yue fu ren	1
君赐生	jun ci sheng	1
君赐食	jun ci shi	1
君赐腥	jun ci xing	1
君而知礼	jun er zhi li	1
君薨	jun hong	1
君祭	jun ji	1
君君臣臣父父子子	jun jun chen chen fu fu zi zi	1
军旅之事	jun lv zhi shi	1
君命召	jun ming zhao	1
君取于吴	jun qu yu wu	1
君使臣	jun shi chen	1
君使臣以礼	jun shi chen yi li	1
君视之	jun shi zhi	1
君孰与不足	jun shu yu bu zu	1
君孰与足	jun shu yu zu	1
君曰告夫三子者	jun yue gao fu san zi zhe	1
君在	jun zai	1
君召使摈	jun zhao shi bin	1
君子	jun zi	1
君子病无能焉	jun zi bing wu neng yan	1
君子博学于文	jun zi bo xue yu wen	1
君子不可小知	jun zi bu ke xiao zhi	1
君子不器	jun zi bu qi	1
君子不入也	jun zi bu ru ye	1
君子不施其亲	jun zi bu shi qi qin	1
君子不以绀緅饰	jun zi bu yi gan zou shi	1
君子不以言举人	jun zi bu yi yan ju ren	1
君子不忧不惧	jun zi bu you bu ju	1
君子不重	jun zi bu zhong	1
君子成人之美	jun zi cheng ren zhi mei	1
君子耻其言而过其行	jun zi chi qi yan er guo qi xing	1
君子道者三	jun zi dao zhe san	1
君子多乎哉	jun zi duo hu zai	1
君子而不仁者有矣夫	jun zi er bu ren zhe you yi fu	1
君子和而不同	jun zi he er bu tong	1
君子何患乎无兄	jun zi he huan hu wu xiong	1
君子怀德	jun zi huai de	1
君子怀刑	jun zi huai xing	1
君子惠而不费	jun zi hui er bu fei	1
君子疾夫舍曰欲之而必为之辞	jun zi ji fu she yue yu zhi er bi wei zhi ci	1
君子疾没世而名不称焉	jun zi ji mo shi er ming bu cheng yan	1
君子矜而不争	jun zi jin er bu zheng	1
君子敬而无失	jun zi jing er wu shi	1
君子居之	jun zi ju zhi	1
君子可逝也	jun zi ke shi ye	1
君子谋道不谋食	jun zi mou dao bu mou shi	1
君子求诸己	jun zi qiu zhu ji	1
君子去仁	jun zi qu ren	1
君子人	jun zi ren	1
君子三年不为礼	jun zi san nian bu wei li	1
君子上达	jun zi shang da	1
君子尚勇乎	jun zi shang yong hu	1
君子食无求饱	jun zi shi wu qiu bao	1
君子思不出其位	jun zi si bu chu qi wei	1
君子所贵乎道者三	jun zi suo gui hu dao zhe san	1
君子泰而不骄	jun zi tai er bu jiao	1
君子坦荡荡	jun zi tan dang dang	1
君子务本	jun zi wu ben	1
君子无所争	jun zi wu suo zheng	1
君子无众寡	jun zi wu zhong gua	1
君子无终食之间违仁	jun zi wu zhong shi zhi jian wei ren	1
君子信而后劳其民	jun zi xin er hou lao qi min	1
君子学道则爱人	jun zi xue dao ze ai ren	1
君子学以致其道	jun zi xue yi zhi qi dao	1
君子也	jun zi ye	1
君子亦党乎	jun zi yi dang hu	1
君子易事而难说也	jun zi yi shi er nan shuo ye	1
君子以文会友	jun zi yi wen hui you	1
君子一言以为知	jun zi yi yan yi wei zhi	1
君子义以为上	jun zi yi yi wei shang	1
君子义以为质	jun zi yi yi wei zhi	1
君子亦有恶乎	jun zi yi you e hu	1
君子亦有穷乎	jun zi yi you qiong hu	1
君子忧	jun zi you	1
君子有九思	jun zi you jiu si	1
君子有三变	jun zi you san bian	1
君子有三戒	jun zi you san jie	1
君子有三畏	jun zi you san wei	1
君子有勇而无义为乱	jun zi you yong er wu yi wei luan	1
君子欲讷于言而敏于行	jun zi yu ne yu yan er min yu xing	1
君子于其所不知	jun zi yu qi suo bu zhi	1
君子于其言	jun zi yu qi yan	1
君子喻于义	jun zi yu yu yi	1
君子哉	jun zi zai	1
君子哉蘧伯玉	jun zi zai qu bo yu	1
君子哉若人	jun zi zai ruo ren	1
君子者乎	jun zi zhe hu	1
君子贞而不谅	jun zi zhen er bu liang	1
君子之道	jun zi zhi dao	1
君子之德风	jun zi zhi de feng	1
君子质而已矣	jun zi zhi er yi yi	1
君子之过也	jun zi zhi guo ye	1
君子之仕也	jun zi zhi shi ye	1
君子之于天下也	jun zi zhi yu tian xia ye	1
君子之至于斯也	jun zi zhi zhi yu si ye	1
君子周而不比	jun zi zhou er bu bi	1
君子周急不继富	jun zi zhou ji bu ji fu	1
君子尊贤而容众	jun zi zun xian er rong zhong	1
侃侃如也	kan kan ru ye	1
康子馈药	kang zi kui yao	1
康子曰	kang zi yue	1
可而为之者与	ke er wei zhi zhe yu	1
克己复礼为仁	ke ji fu li wei ren	1
可欺也	ke qi ye	1
可使南面	ke shi nan mian	1
可使有勇	ke shi you yong	1
可使足民	ke shi zu min	1
可谓	ke wei	1
可谓大臣与	ke wei da chen yu	1
可谓好学也已矣	ke wei hao xue ye yi yi	1
可谓具臣矣	ke wei ju chen yi	1
可谓明也已矣	ke wei ming ye yi yi	1
可谓仁乎	ke wei ren hu	1
可谓仁矣	ke wei ren yi	1
可谓仁之方也已	ke wei ren zhi fang ye yi	1
可谓士	ke wei shi	1
可谓士矣	ke wei shi yi	1
可谓孝矣	ke wei xiao yi	1
可谓远也已矣	ke wei yuan ye yi yi	1
可谓知乎	ke wei zhi hu	1
可谓知矣	ke wei zhi yi	1
可也	ke ye	1
可以观	ke yi guan	1
可以寄百里之命	ke yi ji bai li zhi ming	1
可以群	ke yi qun	1
可以托六尺之孤	ke yi tuo liu chi zhi gu	1
可以为难矣	ke yi wei nan yi	1
可以为仁矣	ke yi wei ren yi	1
可以为师矣	ke yi wei shi yi	1
可以为文矣	ke yi wei wen yi	1
可以无大过矣	ke yi wu da guo yi	1
可以语上也	ke yi yu shang ye	1
可以怨	ke yi yuan	1
可与共学	ke yu gong xue	1
可与立	ke yu li	1
可与适道	ke yu shi dao	1
可与言而不与言	ke yu yan er bu yu yan	1
可者与之	ke zhe yu zhi	1
可知也	ke zhi ye	1
铿尔	keng er	1
硁硁乎	keng keng hu	1
硁硁然	keng keng ran	1
悾悾而不信	kong kong er bu xin	1
空空如也	kong kong ru ye	1
孔子不见	kong zi bu jian	1
孔子辞以疾	kong zi ci yi ji	1
孔子对曰	kong zi dui yue	1
孔子过之	kong zi guo zhi	1
孔子沐浴而朝	kong zi mu yu er chao	1
孔子时其亡也	kong zi shi qi wang ye	1
孔子退	kong zi tui	1
孔子谓季氏	kong zi wei ji shi	1
孔子下	kong zi xia	1
孔子行	kong zi xing	1
孔子以其兄之子妻之	kong zi yi qi xiong zhi zi qi zhi	1
孔子于乡党	kong zi yu xiang dang	1
孔子与之坐而问焉	kong zi yu zhi zuo er wen yan	1
孔子曰	kong zi yue	1
叩其胫	kou qi jing	1
脍不厌细	kuai bu yan xi	1
宽则得众	kuan ze de zhong	1
狂而不直	kuang er bu zhi	1
匡人其如予何	kuang ren qi ru yu he	1
狂者进取	kuang zhe jin qu	1
窥见室家之好	kui jian shi jia zhi hao	1
困而不学	kun er bu xue	1
困而学之	kun er xue zhi	1
来予与尔言	lai yu yu er yan	1
来者犹可追	lai zhe you ke zhui	1
老而不死	lao er bu si	1
劳而不怨	lao er bu yuan	1
牢曰	lao yue	1
乐必崩	le bi beng	1
乐道人之善	le dao ren zhi shan	1
乐多贤友	le duo xian you	1
乐而不淫	le er bu yin	1
乐骄乐	le jiao le	1
乐其可知也	le qi ke zhi ye	1
乐然后笑	le ran hou xiao	1
乐宴乐	le yan le	1
乐以忘忧	le yi wang you	1
乐佚游	le yi you	1
乐亦在其中矣	le yi zai qi zhong yi	1
乐云乐云	le yun le yun	1
乐则韶	le ze shao	1
诔曰	lei yue	1
礼必坏	li bi huai	1
立不中门	li bu zhong men	1
力不足也	li bu zu ye	1
力不足者	li bu zu zhe	1
礼后乎	li hou hu	1
犁牛之子骍且角	li niu zhi zi xing qie jiao	1
鲤趋而过庭	li qu er guo ting	1
里仁第四	li ren di si	1
里仁为美	li ren wei mei	1
鲤退	li tui	1
鲤退而学礼	li tui er xue li	1
礼也	li ye	1
鲤也死	li ye si	1
礼以行之	li yi xing zhi	1
立于礼	li yu li	1
礼与其奢也	li yu qi she ye	1
礼乐不兴	li yue bu xing	1
礼云礼云	li yun li yun	1
立则见其参于前也	li ze jian qi can yu qian ye	1
礼之用	li zhi yong	1
临大节而不可夺也	lin da jie er bu ke duo ye	1
林放问礼之本	lin fang wen li zhi ben	1
临丧不哀	lin sang bu ai	1
临之以庄	lin zhi yi zhuang	1
六十而耳顺	liu shi er er shun	1
柳下惠为士师	liu xia hui wei shi shi	1
鲁人为长府	lu ren wei zhang fu	1
鲁卫之政	lu wei zhi zheng	1
路文学	lu wen xue	1
鲁一变	lu yi bian	1
禄在其中矣	lu zai qi zhong yi	1
禄之去公室五世矣	lu zhi qu gong shi wu shi yi	1
乱邦不居	luan bang bu ju	1
乱也	luan ye	1
论笃是与	lun du shi yu	1
屡空	lv kong	1
虑以下人	lv yi xia ren	1
马不进也	ma bu jin ye	1
麻冕	ma mian	1
慢令致期谓之贼	man ling zhi qi wei zhi zei	1
貌思恭	mao si gong	1
没阶	mei jie	1
美目盼兮	mei mu pan xi	1
每事问	mei shi wen	1
门人不敬子路	men ren bu jing zi lu	1
门人厚葬之	men ren hou zang zhi	1
门人惑	men ren huo	1
门人问曰	men ren wen yue	1
门人欲厚葬之	men ren yu hou zang zhi	1
孟公绰为赵魏老则优	meng gong chuo wei zhao wei lao ze you	1
孟敬子问之	meng jing zi wen zhi	1
孟氏使阳肤为士师	meng shi shi yang fu wei shi shi	1
孟孙问孝于我	meng sun wen xiao yu wo	1
孟武伯问孝	meng wu bo wen xiao	1
孟懿子问孝	meng yi zi wen xiao	1
孟之反不伐	meng zhi fan bu fa	1
孟庄子之孝也	meng zhuang zi zhi xiao ye	1
苗而不秀者有矣夫	miao er bu xiu zhe you yi fu	1
民到	min dao	1
民到于今受其赐	min dao yu jin shou qi ci	1
民德归厚矣	min de gui hou yi	1
民可使由之	min ke shi you zhi	1
民免而无耻	min mian er wu chi	1
民散久矣	min san jiu yi	1
民食丧祭	min shi sang ji	1
民斯为下矣	min si wei xia yi	1
民无得而称焉	min wu de er cheng yan	1
民无德而称焉	min wu de er cheng yan	1
民无能	min wu neng	1
民无信不立	min wu xin bu li	1
民鲜久矣	min xian jiu yi	1
民信之矣	min xin zhi yi	1
敏以求之者也	min yi qiu zhi zhe ye	1
敏于事而慎于言	min yu shi er shen yu yan	1
敏则有功	min ze you gong	1
民之于仁也	min zhi yu ren ye	1
闵子骞	min zi qian	1
闵子骞曰	min zi qian yue	1
闵子侍侧	min zi shi ce	1
名不正	ming bu zheng	1
明日	ming ri	1
明日遂行	ming ri sui xing	1
名焉	ming yan	1
命也	ming ye	1
命矣夫	ming yi fu	1
莫不有文武之道焉	mo bu you wen wu zhi dao yan	1
没齿无怨言	mo chi wu yuan yan	1
莫春者	mo chun zhe	1
磨而不磷	mo er bu lin	1
默而识之	mo er shi zhi	1
莫敢不服	mo gan bu fu	1
莫己知也	mo ji zhi ye	1
莫能兴	mo neng xing	1
莫我知也夫	mo wo zhi ye fu	1
莫吾犹人也	mo wu you ren ye	1
末由也已	mo you ye yi	1
莫予违也	mo yu wei ye	1
末之难矣	mo zhi nan yi	1
末之也	mo zhi ye	1
某在斯	mou zai si	1
南宫适出	nan gong shi chu	1
南宫适问于孔子曰	nan gong shi wen yu kong zi yue	1
难乎免于今之世矣	nan hu mian yu jin zhi shi yi	1
难乎有恒矣	nan hu you heng yi	1
南人有言曰	nan ren you yan yue	1
南容三复白圭	nan rong san fu bai gui	1
难矣哉	nan yi zai	1
难与并为仁矣	nan yu bing wei ren yi	1
内省不疚	nei xing bu jiu	1
馁在其中矣	nei zai qi zhong yi	1
能恶人	neng e ren	1
能竭其力	neng jie qi li	1
能近取譬	neng jin qu pi	1
能来也	neng lai ye	1
能使	neng shi	1
能使枉者直	neng shi wang zhe zhi	1
能无从乎	neng wu cong hu	1
能勿诲乎	neng wu hui hu	1
能勿劳乎	neng wu lao hu	1
能无说乎	neng wu shuo hu	1
能行五者于天下为仁矣	neng xing wu zhe yu tian xia wei ren yi	1
能以礼让为国乎	neng yi li rang wei guo hu	1
能致其身	neng zhi qi shen	1
麑裘	ni qiu	1
年饥	nian ji	1
年四十而见恶焉	nian si shi er jian e yan	1
鸟兽不可与同群	niao shou bu ke yu tong qun	1
鸟之将死	niao zhi jiang si	1
涅而不缁	nie er bu zi	1
宁固	ning gu	1
宁俭	ning jian	1
宁媚于灶	ning mei yu zao	1
宁戚	ning qi	1
佞人殆	ning ren dai	1
佞也	ning ye	1
女得人焉耳乎	nv de ren yan er hu	1
女弗能救与	nv fu neng jiu yu	1
女为君子儒	nv wei jun zi ru	1
女为周南召南矣乎	nv wei zhou nan zhao nan yi hu	1
女闻六言六蔽矣乎	nv wen liu yan liu bi yi hu	1
女奚不曰	nv xi bu yue	1
女以予为多学而识之者与	nv yi yu wei duo xue er shi zhi zhe yu	1
匏瓜也哉	pao gua ye zai	1
陪臣执国命	pei chen zhi guo ming	1
朋友切切偲偲	peng you qie qie si si	1
朋友数	peng you shu	1
朋友死	peng you si	1
朋友之馈	peng you zhi kui	1
匹夫不可夺志也	pi fu bu ke duo zhi ye	1
譬如北辰	pi ru bei chen	1
譬如平地	pi ru ping di	1
譬如为山	pi ru wei shan	1
譬之宫墙	pi zhi gong qiang	1
譬诸草木	pi zhu cao mu	1
譬诸小人	pi zhu xiao ren	1
偏其反而	pian qi fan er	1
贫而无谄	pin er wu chan	1
贫而无怨难	pin er wu yuan nan	1
贫且贱焉	pin qie jian yan	1
贫与贱	pin yu jian	1
屏四恶	ping si e	1
其蔽也荡	qi bi ye dang	1
其蔽也绞	qi bi ye jiao	1
其蔽也狂	qi bi ye kuang	1
其蔽也乱	qi bi ye luan	1
其蔽也愚	qi bi ye yu	1
其蔽也贼	qi bi ye zei	1
岂不尔思	qi bu er si	1
其不改父之臣	qi bu gai fu zhi chen	1
其不可者拒之	qi bu ke zhe ju zhi	1
其不善者恶之	qi bu shan zhe e zhi	1
其不善者而改之	qi bu shan zhe er gai zhi	1
杞不足征也	qi bu zu zheng ye	1
其次辟地	qi ci pi di	1
其次辟色	qi ci pi se	1
其次辟言	qi ci pi yan	1
其从之也	qi cong zhi ye	1
其父攘羊	qi fu rang yang	1
齐何人也	qi he ren ye	1
其何伤于日月乎	qi he shang yu ri yue hu	1
其何以行之哉	qi he yi xing zhi zai	1
齐桓公正而不谲	qi huan gong zheng er bu jue	1
其回也与	qi hui ye yu	1
其或继周者	qi huo ji zhou zhe	1
齐景公待孔子曰	qi jing gong dai kong zi yue	1
齐景公问政于孔子	qi jing gong wen zheng yu kong zi	1
齐景公有马千驷	qi jing gong you ma qian si	1
其可谓至德也已矣	qi ke wei zhi de ye yi yi	1
其可已矣	qi ke yi yi	1
期可已矣	qi ke yi yi	1
其门而入	qi men er ru	1
其鸣也哀	qi ming ye ai	1
岂其然乎	qi qi ran hu	1
其亲	qi qin	1
其然	qi ran	1
其然也	qi ran ye	1
齐人归女乐	qi ren gui nv yue	1
其如示诸斯乎	qi ru shi zhu si hu	1
岂若从辟世之士哉	qi ruo cong pi shi zhi shi zai	1
岂若匹夫匹妇之为谅也	qi ruo pi fu pi fu zhi wei liang ye	1
其身不正	qi shen bu zheng	1
其身正	qi shen zheng	1
其生也荣	qi sheng ye rong	1
七十而从心所欲	qi shi er cong xin suo yu	1
其事也	qi shi ye	1
其恕乎	qi shu hu	1
其舜也与	qi shun ye yu	1
其斯而已矣	qi si er yi yi	1
其死也哀	qi si ye ai	1
其斯之谓与	qi si zhi wei yu	1
其他可能也	qi ta ke neng ye	1
欺天乎	qi tian hu	1
其未得之也	qi wei de zhi ye	1
其为仁	qi wei ren	1
其为人也	qi wei ren ye	1
其为人也孝弟	qi wei ren ye xiao di	1
其为仁之本与	qi wei ren zhi ben yu	1
其惟圣人乎	qi wei sheng ren hu	1
其心三月不违仁	qi xin san yue bu wei ren	1
其言不让	qi yan bu rang	1
其言似不足者	qi yan si bu zu zhe	1
其言也讱	qi yan ye ren	1
其言也善	qi yan ye shan	1
其言之不怍	qi yan zhi bu zuo	1
齐一变	qi yi bian	1
期已久矣	qi yi jiu yi	1
其犹穿窬之盗也与	qi you chuan yu zhi dao ye yu	1
其有所试矣	qi you suo shi yi	1
其由也与	qi you ye yu	1
其犹正墙面而立也与	qi you zheng qiang mian er li ye yu	1
其余不足观也已	qi yu bu zu guan ye yi	1
启予手	qi yu shou	1
其余则日月至焉而已矣	qi yu ze ri yue zhi yan er yi yi	1
起予者商也	qi yu zhe shang ye	1
启予足	qi yu zu	1
其在宗庙朝廷	qi zai zong miao chao ting	1
其争也君子	qi zheng ye jun zi	1
器之	qi zhi	1
其至矣乎	qi zhi yi hu	1
齐之以礼	qi zhi yi li	1
齐之以刑	qi zhi yi xing	1
其终也已	qi zhong ye yi	1
其诸异乎人之求之与	qi zhu yi hu ren zhi qiu zhi yu	1
千乘之国	qian sheng zhi guo	1
前言戏之耳	qian yan xi zhi er	1
浅则揭	qian ze jie	1
巧笑倩兮	qiao xiao qian xi	1
巧言令色	qiao yan ling se	1
巧言乱德	qiao yan luan de	1
窃比于我老彭	qie bi yu wo lao peng	1
且尔言过矣	qie er yan guo yi	1
且而与其从辟人之士	qie er yu qi cong pi ren zhi shi	1
切切偲偲	qie qie si si	1
切问而近思	qie wen er jin si	1
且予与其死于臣之手也	qie yu yu qi si yu chen zhi shou ye	1
且予纵	qie yu zong	1
且在邦域之	qie zai bang yu zhi	1
且知方也	qie zhi fang ye	1
寝不尸	qin bu shi	1
寝不言	qin bu yan	1
亲于其身为不善者	qin yu qi shen wei bu shan zhe	1
请事斯语矣	qing shi si yu yi	1
请讨之	qing tao zhi	1
请问其目	qing wen qi mu	1
请问之	qing wen zhi	1
请学为圃	qing xue wei pu	1
请益	qing yi	1
求备焉	qiu bei yan	1
丘不	qiu bu	1
求尔何如	qiu er he ru	1
丘何为是栖栖者与	qiu he wei shi xi xi zhe yu	1
丘陵	qiu ling	1
求其志	qiu qi zhi	1
求仁而得仁	qiu ren er de ren	1
求善贾而沽诸	qiu shan jia er gu zhu	1
丘未达	qiu wei da	1
求为可知也	qiu wei ke zhi ye	1
求无乃尔是过与	qiu wu nai er shi guo yu	1
求也可使从政也与	qiu ye ke shi cong zheng ye yu	1
求也退	qiu ye tui	1
求也为之	qiu ye wei zhi	1
求也问闻斯行诸	qiu ye wen wen si xing zhu	1
丘也闻有国有家者	qiu ye wen you guo you jia zhe	1
丘也幸	qiu ye xing	1
求也艺	qiu ye yi	1
丘之祷久矣	qiu zhi dao jiu yi	1
求之与	qiu zhi yu	1
去兵	qu bing	1
蘧伯玉使人于孔子	qu bo yu shi ren yu kong zi	1
趋而辟之	qu er pi zhi	1
曲肱而枕之	qu gong er zhen zhi	1
趋进	qu jin	1
去丧	qu sang	1
取瑟而歌	qu se er ge	1
去食	qu shi	1
区以别矣	qu yi bie yi	1
阙党童子将命	que dang tong zi jiang ming	1
群而不党	qun er bu dang	1
群居终日	qun ju zhong ri	1
然而未仁	ran er wei ren	1
然非与	ran fei yu	1
然后君子	ran hou jun zi	1
然后免于父母之怀	ran hou mian yu fu mu zhi huai	1
然后为学	ran hou wei xue	1
然后乐正	ran hou yue zheng	1
然乎	ran hu	1
冉求曰	ran qiu yue	1
冉求之艺	ran qiu zhi yi	1
冉有季	ran you ji	1
冉有季路见于孔子曰	ran you ji lu jian yu kong zi yue	1
冉有仆	ran you pu	1
冉有问	ran you wen	1
冉有曰	ran you yue	1
冉有子贡侃侃如也	ran you zi gong kan kan ru ye	1
然则从之者与	ran ze cong zhi zhe yu	1
然则管	ran ze guan	1
然则师愈与	ran ze shi yu yu	1
冉子退朝	ran zi tui chao	1
冉子为其母请粟	ran zi wei qi mu qing su	1
冉子与之粟五秉	ran zi yu zhi su wu bing	1
人必知之	ren bi zhi zhi	1
人不	ren bu	1
人不间于其父母昆弟之言	ren bu jian yu qi fu mu kun di zhi yan	1
人不堪其忧	ren bu kan qi you	1
仁不能守之	ren bu neng shou zhi	1
人不厌其取	ren bu yan qi qu	1
人不厌其言	ren bu yan qi yan	1
人不知	ren bu zhi	1
人而不仁	ren er bu ren	1
人而不为周南召南	ren er bu wei zhou nan zhao nan	1
人而无恒	ren er wu heng	1
人而无信	ren er wu xin	1
人将拒我	ren jiang ju wo	1
人洁己以进	ren jie ji yi jin	1
人皆有兄弟	ren jie you xiong di	1
人能弘道	ren neng hong dao	1
仁能守之	ren neng shou zhi	1
人其舍诸	ren qi she zhu	1
人虽欲自绝	ren sui yu zi jue	1
人未有自致者也	ren wei you zi zhi zhe ye	1
人无远虑	ren wu yuan lv	1
人焉廋哉	ren yan sou zai	1
人也	ren ye	1
人以为谄也	ren yi wei chan ye	1
仁以为己任	ren yi wei ji ren	1
仁远乎哉	ren yuan hu zai	1
人曰	ren yue	1
仁在其中矣	ren zai qi zhong yi	1
仁则吾不	ren ze wu bu	1
仁者	ren zhe	1
仁者安仁	ren zhe an ren	1
仁者必有勇	ren zhe bi you yong	1
仁者不忧	ren zhe bu you	1
仁者静	ren zhe jing	1
仁者乐山	ren zhe le shan	1
仁者寿	ren zhe shou	1
仁者先难而后获	ren zhe xian nan er hou huo	1
人之过也	ren zhi guo ye	1
人之将死	ren zhi jiang si	1
人之生也直	ren zhi sheng ye zhi	1
人之言曰	ren zhi yan yue	1
任重而道远	ren zhong er dao yuan	1
仍旧贯	reng jiu guan	1
日月逝矣	ri yue shi yi	1
日月也	ri yue ye	1
日知其所亡	ri zhi qi suo wang	1
肉虽多	rou sui duo	1
孺悲欲见孔子	ru bei yu jian kong zi	1
如不祭	ru bu ji	1
如不可求	ru bu ke qiu	1
如不容	ru bu rong	1
如不如乡人之善者好之	ru bu ru xiang ren zhi shan zhe hao zhi	1
如不善而莫之违也	ru bu shan er mo zhi wei ye	1
如不胜	ru bu sheng	1
如得其情	ru de qi qing	1
如浮云	ru fu yun	1
入公门	ru gong men	1
如会同	ru hui tong	1
如乐何	ru le he	1
如礼何	ru li he	1
如临	ru lin	1
如履薄冰	ru lv bo bing	1
如其礼乐	ru qi li yue	1
如其仁	ru qi ren	1
如其善而莫之违也	ru qi shan er mo zhi wei ye	1
如日月之食焉	ru ri yue zhi shi yan	1
如杀无道	ru sha wu dao	1
如斯而已乎	ru si er yi hu	1
入太庙	ru tai miao	1
如五六十	ru wu liu shi	1
如也	ru ye	1
如用之	ru yong zhi	1
如有博施于民而能济众	ru you bo shi yu min er neng ji zhong	1
如有所立卓尔	ru you suo li zhuo er	1
如有所誉者	ru you suo yu zhe	1
如有王者	ru you wang zhe	1
如有用我者	ru you yong wo zhe	1
如有政	ru you zheng	1
如有周公之才之美	ru you zhou gong zhi cai zhi mei	1
如愚	ru yu	1
入曰	ru yue	1
入则事父兄	ru ze shi fu xiong	1
如正人何	ru zheng ren he	1
如之何	ru zhi he	1
如之何其彻也	ru zhi he qi che ye	1
如之何其废之	ru zhi he qi fei zhi	1
如之何其拒人也	ru zhi he qi ju ren ye	1
如之何其可及也	ru zhi he qi ke ji ye	1
如之何其闻斯行之	ru zhi he qi wen si xing zhi	1
如之何者	ru zhi he zhe	1
如知为君之难也	ru zhi wei jun zhi nan ye	1
如琢如磨	ru zhuo ru mo	1
若季氏则吾不能	ruo ji shi ze wu bu neng	1
若圣与仁	ruo sheng yu ren	1
若由也	ruo you ye	1
若臧武仲之知	ruo zang wu zhong zhi zhi	1
三黜	san chu	1
三代	san dai	1
三饭缭适蔡	san fan liao shi cai	1
三分天下有其二	san fen tian xia you qi er	1
三家者	san jia zhe	1
三军可夺帅也	san jun ke duo shuai ye	1
三年	san nian	1
三年不为乐	san nian bu wei le	1
三年不言	san nian bu yan	1
三年无改于父之道	san nian wu gai yu fu zhi dao	1
三年学	san nian xue	1
三年有成	san nian you cheng	1
三年之丧	san nian zhi sang	1
三人行	san ren xing	1
三日不朝	san ri bu chao	1
三世	san shi	1
三十而立	san shi er li	1
三嗅而作	san xiu er zuo	1
三以天下让	san yi tian xia rang	1
三月不知肉味	san yue bu zhi rou wei	1
三子者出	san zi zhe chu	1
丧邦乎	sang bang hu	1
丧事不敢不勉	sang shi bu gan bu mian	1
丧思哀	sang si ai	1
丧与其易也	sang yu qi yi ye	1
丧致乎哀而止	sang zhi hu ai er zhi	1
色勃如也	se bo ru ye	1
色恶	se e	1
色厉而内荏	se li er nei ren	1
色难	se nan	1
色取仁	se qu ren	1
色斯举矣	se si ju yi	1
色思温	se si wen	1
色庄者乎	se zhuang zhe hu	1
杀鸡为黍而食之	sha ji wei shu er shi zhi	1
山川其舍诸	shan chuan qi she zhu	1
善夫	shan fu	1
善居室	shan ju shi	1
山梁雌雉	shan liang ci zhi	1
善人教民七年	shan ren jiao min qi nian	1
善人是富	shan ren shi fu	1
善人为邦百年	shan ren wei bang bai nian	1
善人吾不得而见之矣	shan ren wu bu de er jian zhi yi	1
善为我辞焉如有复我者	shan wei wo ci yan ru you fu wo zhe	1
善诱人	shan you ren	1
善哉	shan zai	1
善哉问	shan zai wen	1
尚德哉若人	shang de zai ruo ren	1
上好礼	shang hao li	1
上好信	shang hao xin	1
上好义	shang hao yi	1
伤人乎	shang ren hu	1
上如揖	shang ru yi	1
上失其道	shang shi qi dao	1
商闻之矣	shang wen zhi yi	1
上下神只	shang xia shen zhi	1
商也不及	shang ye bu ji	1
上矣	shang yi	1
上者	shang zhe	1
少师阳击磬襄入于海	shao shi yang ji qing xiang ru yu hai	1
少有	shao you	1
少之时	shao zhi shi	1
射不主皮	she bu zhu pi	1
摄乎大国之间	she hu da guo zhi jian	1
摄齐升堂	she qi sheng tang	1
舍瑟而作	she se er zuo	1
赦小过	she xiao guo	1
奢则不孙	she ze bu sun	1
舍之则藏	she zhi ze cang	1
慎而无礼则葸	shen er wu li ze xi	1
审法度	shen fa du	1
申申如也	shen shen ru ye	1
慎行其余	shen xing qi yu	1
慎言其余	shen yan qi yu	1
甚矣吾衰也	shen yi wu shuai ye	1
甚于水火	shen yu shui huo	1
深渊	shen yuan	1
深则厉	shen ze li	1
身中清	shen zhong qing	1
慎终追远	shen zhong zhui yuan	1
升车	sheng che	1
生而知之者上也	sheng er zhi zhi zhe shang ye	1
圣人吾不得而见之矣	sheng ren wu bu de er jian zhi yi	1
事不成	shi bu cheng	1
士不可以不弘毅	shi bu ke yi bu hong yi	1
食不厌精	shi bu yan jing	1
食不语	shi bu yu	1
是道也	shi dao ye	1
士而怀居	shi er huai ju	1
仕而优则学	shi er you ze xue	1
式负	shi fu	1
食夫稻	shi fu dao	1
事父母	shi fu mu	1
事父母几谏	shi fu mu ji jian	1
弑父与君	shi fu yu jun	1
是故恶夫佞者	shi gu e fu ning zhe	1
是故哂之	shi gu shen zhi	1
士何如斯可谓之达矣	shi he ru si ke wei zhi da yi	1
使乎	shi hu	1
是惑也	shi huo ye	1
士见危致命	shi jian wei zhi ming	1
使骄且吝	shi jiao qie lin	1
事君	shi jun	1
事君尽礼	shi jun jin li	1
事君敬其事	shi jun jing qi shi	1
事君数	shi jun shu	1
是可忍也	shi ke ren ye	1
诗可以兴	shi ke yi xing	1
始可与言诗已矣	shi ke yu yan shi yi yi	1
是礼也	shi li ye	1
是鲁孔丘与	shi lu kong qiu yu	1
是鲁孔丘之徒与	shi lu kong qiu zhi tu yu	1
师冕出	shi mian chu	1
师冕见	shi mian jian	1
使民敬忠以劝	shi min jing zhong yi quan	1
使民如承大祭	shi min ru cheng da ji	1
使民以时	shi min yi shi	1
使民战栗	shi min zhan li	1
是难能也	shi nan neng ye	1
事其大夫之贤者	shi qi dai fu zhi xian zhe	1
视其所以	shi qi suo yi	1
是丘也	shi qiu ye	1
失饪	shi ren	1
失人	shi ren	1
是人之	shi ren zhi	1
是人之所欲也	shi ren zhi suo yu ye	1
实若虚	shi ruo xu	1
诗三百	shi san bai	1
是社稷之臣也	shi she ji zhi chen ye	1
十世可知也	shi shi ke zhi ye	1
侍食于君	shi shi yu jun	1
室是远而	shi shi yuan er	1
世叔讨论之	shi shu tao lun zhi	1
诗书执礼	shi shu zhi li	1
是谁之过与	shi shui zhi guo yu	1
事思	shi si	1
视思明	shi si ming	1
是谓过矣	shi wei guo yi	1
是谓能养	shi wei neng yang	1
是谓弃之	shi wei qi zhi	1
是为贼	shi wei zei	1
是闻也	shi wen ye	1
是吾忧也	shi wu you ye	1
是贤乎	shi xian hu	1
失言	shi yan	1
是也	shi ye	1
师也过	shi ye guo	1
师也辟	shi ye pi	1
食饐而餲	shi yi er ai	1
是以君子不为也	shi yi jun zi bu wei ye	1
是以君子恶居下流	shi yi jun zi wu ju xia liu	1
是亦为政	shi yi wei zheng	1
氏亦有反坫	shi yi you fan dian	1
始有	shi you	1
侍于君子有三愆	shi yu jun zi you san qian	1
师与商也孰贤	shi yu shang ye shu xian	1
使于四方	shi yu si fang	1
施于有政	shi yu you zheng	1
诗云	shi yun	1
诗云如切如磋	shi yun ru qie ru cuo	1
时哉时哉	shi zai shi zai	1
使者出	shi zhe chu	1
逝者如斯夫	shi zhe ru si fu	1
食旨不甘	shi zhi bu gan	1
是知津	shi zhi jin	1
是知其不	shi zhi qi bu	1
使之闻之	shi zhi wen zhi	1
是知也	shi zhi ye	1
事之以礼	shi zhi yi li	1
士志于道	shi zhi yu dao	1
师挚之始	shi zhi zhi shi	1
使子路反见之	shi zi lu fan jian zhi	1
使子路问津焉	shi zi lu wen jin yan	1
始作	shi zuo	1
守死善道	shou si shan dao	1
授之以政	shou zhi yi zheng	1
孰不可忍也	shu bu ke ren ye	1
孰不知礼	shu bu zhi li	1
述而不作	shu er bu zuo	1
述而第七	shu er di qi	1
孰敢不正	shu gan bu zheng	1
孰后倦焉	shu hou juan yan	1
孰能为之大	shu neng wei zhi da	1
叔孙武叔毁仲尼	shu sun wu shu hui zhong ni	1
叔孙武叔语大夫于朝	shu sun wu shu yu dai fu yu chao	1
孰为夫子	shu wei fu zi	1
孰谓鄹人之子知礼乎	shu wei zou ren zhi zi zhi li hu	1
孰先传焉	shu xian chuan yan	1
庶矣哉	shu yi zai	1
书云	shu yun	1
谁毁谁誉	shui hui shui yu	1
水火	shui huo	1
谁能出不由户	shui neng chu bu you hu	1
谁为	shui wei	1
舜亦以命禹	shun yi yi ming yu	1
舜有臣五人而天下治	shun you chen wu ren er tian xia zhi	1
舜有天下	shun you tian xia	1
舜禹之有天下也而不与焉	shun yu zhi you tian xia ye er bu yu yan	1
说而不绎	shuo er bu yi	1
说也	shuo ye	1
说之不以道	shuo zhi bu yi dao	1
说之虽不以道	shuo zhi sui bu yi dao	1
驷不及舌	si bu ji she	1
似不能言者	si bu neng yan zhe	1
斯不亦惠而不费乎	si bu yi hui er bu fei hu	1
斯不亦泰而不骄乎	si bu yi tai er bu jiao hu	1
斯不亦威而不猛乎	si bu yi wei er bu meng hu	1
斯出矣	si chu yi	1
私觌	si di	1
思而不学	si er bu xue	1
死而后已	si er hou yi	1
死而无悔者	si er wu hui zhe	1
四饭缺适秦	si fan que shi qin	1
四方之政行焉	si fang zhi zheng xing yan	1
四海困穷	si hai kun qiong	1
斯害也已	si hai ye yi	1
四海之内皆兄弟也	si hai zhi nei jie xiong di ye	1
斯己而已矣	si ji er yi yi	1
斯近信矣	si jin xin yi	1
斯可矣	si ke yi	1
斯可以从政矣	si ke yi cong zheng yi	1
司马牛问君子	si ma niu wen jun zi	1
司马牛问仁	si ma niu wen ren	1
司马牛忧曰	si ma niu you yue	1
斯民也	si min ye	1
斯人也而有斯疾也	si ren ye er you si ji ye	1
斯仁至矣	si ren zhi yi	1
斯辱矣	si ru yi	1
死生有命	si sheng you ming	1
四十而不惑	si shi er bu huo	1
四十五十而无闻焉	si shi wu shi er wu wen yan	1
四时行焉	si shi xing yan	1
斯疏矣	si shu yi	1
四体不勤	si ti bu qin	1
斯谓之君子已乎	si wei zhi jun zi yi hu	1
斯谓之仁已乎	si wei zhi ren yi hu	1
思无邪	si wu xie	1
斯亦不足	si yi bu zu	1
斯远暴慢矣	si yuan bao man yi	1
斯远鄙倍矣	si yuan bi bei yi	1
斯知仁矣	si zhi ren yi	1
死之日	si zhi ri	1
宋不足征也	song bu zu zheng ye	1
诵诗三百	song shi san bai	1
素衣	su yi	1
素以为绚兮	su yi wei xuan xi	1
虽百世	sui bai shi	1
岁不我与	sui bu wo yu	1
虽不吾以	sui bu wu yi	1
虽车马	sui che ma	1
虽得之	sui de zhi	1
虽多	sui duo	1
虽覆一篑	sui fu yi kui	1
虽告之曰	sui gao zhi yue	1
岁寒然后知松柏之后凋也	sui han ran hou zhi song bai zhi hou diao ye	1
虽令不从	sui ling bu cong	1
虽蛮貊之邦行矣	sui man mo zhi bang xing yi	1
虽赏之不窃	sui shang zhi bu qie	1
虽少	sui shao	1
遂事不谏	sui shi bu jian	1
虽疏食菜羹	sui shu shi cai geng	1
虽违众	sui wei zhong	1
虽狎	sui xia	1
虽小道	sui xiao dao	1
虽亵	sui xie	1
虽有粟	sui you su	1
虽有周亲	sui you zhou qin	1
虽欲从之	sui yu cong zhi	1
虽欲勿用	sui yu wu yong	1
虽曰不要君	sui yue bu yao jun	1
虽曰未学	sui yue wei xue	1
虽执鞭之士	sui zhi bian zhi shi	1
绥之斯来	sui zhi si lai	1
虽之夷狄	sui zhi yi di	1
损矣	sun yi	1
孙以出之	sun yi chu zhi	1
损者三乐	sun zhe san le	1
损者三友	sun zhe san you	1
所恶也	suo e ye	1
所损益	suo sun yi	1
所谓大臣者	suo wei da chen zhe	1
所谓立之斯立	suo wei li zhi si li	1
所重	suo zhong	1
他人之贤者	ta ren zhi xian zhe	1
他日又独立	ta ri you du li	1
泰伯	tai bo	1
泰伯第八	tai bo di ba	1
泰而不骄	tai er bu jiao	1
泰也	tai ye	1
太宰问于子贡曰	tai zai wen yu zi gong yue	1
太宰知我乎	tai zai zhi wo hu	1
唐棣之华	tang di zhi hua	1
堂堂乎张也	tang tang hu zhang ye	1
汤有天下	tang you tian xia	1
唐虞之际	tang yu zhi ji	1
滔滔者	tao tao zhe	1
天何言哉	tian he yan zai	1
天将以夫子为木铎	tian jiang yi fu zi wei mu duo	1
天禄永终	tian lu yong zhong	1
天丧予	tian sang yu	1
天生德于予	tian sheng de yu yu	1
天下	tian xia	1
天下归仁焉	tian xia gui ren yan	1
天下皆是也	tian xia jie shi ye	1
天下无道	tian xia wu dao	1
天下有道	tian xia you dao	1
天下有道则见	tian xia you dao ze jian	1
天下之恶皆归焉	tian xia zhi e jie gui yan	1
天下之通丧也	tian xia zhi tong sang ye	1
天下之无道也久矣	tian xia zhi wu dao ye jiu yi	1
天厌之	tian yan zhi	1
天之将丧斯文也	tian zhi jiang sang si wen ye	1
天之历数在尔躬	tian zhi li shu zai er gong	1
天之未丧斯文也	tian zhi wei sang si wen ye	1
天子穆穆	tian zi mu mu	1
听其言也厉	ting qi yan ye li	1
听思聪	ting si cong	1
听讼	ting song	1
童子见	tong zi jian	1
童子六七人	tong zi liu qi ren	1
退而省其私	tui er sheng qi si	1
拖绅	tuo shen	1
万方有罪	wan fang you zui	1
枉道而事人	wang dao er shi ren	1
亡而为有	wang er wei you	1
忘其身以及	wang qi shen yi ji	1
王孙贾问曰	wang sun jia wen yue	1
王孙贾治军旅	wang sun jia zhi jun lv	1
往也	wang ye	1
往者不可谏	wang zhe bu ke jian	1
枉者直	wang zhe zhi	1
亡之	wang zhi	1
罔之生也幸而免	wang zhi sheng ye xing er mian	1
望之俨然	wang zhi yan ran	1
危邦不入	wei bang bu ru	1
未尝饱也	wei chang bao ye	1
未尝至于偃之室也	wei chang zhi yu yan zhi shi ye	1
为臣不易	wei chen bu yi	1
未成一篑	wei cheng yi kui	1
唯赤则非邦也与	wei chi ze fei bang ye yu	1
畏大人	wei da ren	1
危而不持	wei er bu chi	1
威而不猛	wei er bu meng	1
卫公孙朝问于子贡曰	wei gong sun chao wen yu zi gong yue	1
微管仲	wei guan zhong	1
为国以礼	wei guo yi li	1
唯何甚	wei he shen	1
未见蹈仁而死者也	wei jian dao ren er si zhe ye	1
未见其人也	wei jian qi ren ye	1
未见其止也	wei jian qi zhi ye	1
未见颜色而言谓之瞽	wei jian yan shai er yan wei zhi gu	1
唯谨尔	wei jin er	1
未尽善也	wei jin shan ye	1
唯酒无量	wei jiu wu liang	1
卫君待子而为政	wei jun dai zi er wei zheng	1
为君难	wei jun nan	1
未可也	wei ke ye	1
未可与	wei ke yu	1
未可与立	wei ke yu li	1
未可与适道	wei ke yu shi dao	1
为孔丘	wei kong qiu	1
谓孔子曰	wei kong zi yue	1
为礼不敬	wei li bu jing	1
为力不同科	wei li bu tong ke	1
卫灵公第十五	wei ling gong di shi wu	1
卫灵公问陈于孔子	wei ling gong wen chen yu kong zi	1
谓柳下惠少连	wei liu xia hui shao lian	1
谓门弟子曰	wei men di zi yue	1
为命	wei ming	1
为难能也	wei nan neng ye	1
未能事人	wei neng shi ren	1
唯女子与小人为难养也	wei nv zi yu xiao ren wei nan yang ye	1
唯其言而	wei qi yan er	1
唯求则非邦也与	wei qiu ze fei bang ye yu	1
未仁乎	wei ren hu	1
为人谋而不忠乎	wei ren mou er bu zhong hu	1
为仁由己	wei ren you ji	1
唯仁者能好人	wei ren zhe neng hao ren	1
未入于室也	wei ru yu shi ye	1
未若贫而乐	wei ruo pin er le	1
未善也	wei shan ye	1
唯上知与下愚不移	wei shang zhi yu xia yu bu yi	1
微生亩谓孔子曰	wei sheng mu wei kong zi yue	1
畏圣人之言	wei sheng ren zhi yan	1
畏天命	wei tian ming	1
唯天为大	wei tian wei da	1
为同姓	wei tong xing	1
巍巍乎	wei wei hu	1
巍巍乎其有成功也	wei wei hu qi you cheng gong ye	1
未闻好学者也	wei wen hao xue zhe ye	1
唯我与尔有是夫	wei wo yu er you shi fu	1
谓武	wei wu	1
未信	wei xin	1
危行言孙	wei xing yan sun	1
危言危行	wei yan wei xing	1
唯尧则之	wei yao ze zhi	1
谓也	wei ye	1
未也	wei ye	1
畏也已	wei ye yi	1
未有小人而仁者也	wei you xiao ren er ren zhe ye	1
谓虞仲夷逸	wei yu zhong yi yi	1
为政第二	wei zheng di er	1
为政以德	wei zheng yi de	1
为之	wei zhi	1
未之	wei zhi	1
为之难	wei zhi nan	1
未知生	wei zhi sheng	1
未之思也	wei zhi si ye	1
谓之吴孟子	wei zhi wu meng zi	1
谓之有司	wei zhi you si	1
未之有也	wei zhi you ye	1
为仲由	wei zhong you	1
未坠于地	wei zhui yu di	1
唯子出	wei zi chu	1
微子第十八	wei zi di shi ba	1
微子去之	wei zi qu zhi	1
未足与议也	wei zu yu yi ye	1
文不在兹乎	wen bu zai zi hu	1
温故而知新	wen gu er zhi xin	1
问管仲	wen guan zhong	1
闻乐不乐	wen le bu le	1
闻礼	wen li	1
问仁	wen ren	1
问人于他邦	wen ren yu ta bang	1
闻韶	wen shao	1
文胜质则史	wen sheng zhi ze shi	1
闻诗	wen shi	1
闻斯二者	wen si er zhe	1
闻斯行之	wen si xing zhi	1
闻斯行诸	wen si xing zhu	1
文王既没	wen wang ji mei	1
文武之道	wen wu zhi dao	1
文献不足故也	wen xian bu zu gu ye	1
闻弦歌之声	wen xian ge zhi sheng	1
文行忠信	wen xing zhong xin	1
闻义不能徙	wen yi bu neng xi	1
问一得三	wen yi de san	1
文犹质也	wen you zhi ye	1
问于桀溺	wen yu jie ni	1
问于孔子	wen yu kong zi	1
问于曾子	wen yu zeng zi	1
问政	wen zheng	1
问知	wen zhi	1
文质彬彬	wen zhi bin bin	1
文之以礼乐	wen zhi yi li yue	1
问子西	wen zi xi	1
我爱其礼	wo ai qi li	1
我待贾者也	wo dai jia zhe ye	1
我独亡	wo du wang	1
我对曰	wo dui yue	1
我非生而知之者	wo fei sheng er zhi zhi zhe	1
我叩其两端而竭	wo kou qi liang duan er jie	1
我未见好仁者	wo wei jian hao ren zhe	1
我未见力不足者	wo wei jian li bu zu zhe	1
我未之见也	wo wei zhi jian ye	1
我无能焉	wo wu neng yan	1
我无是也	wo wu shi ye	1
我欲仁	wo yu ren	1
我则异于是	wo ze yi yu shi	1
我之不贤与	wo zhi bu xian yu	1
我之大贤与	wo zhi da xian yu	1
毋必	wu bi	1
吾必谓之学矣	wu bi wei zhi xue yi	1
吾不如老农	wu bu ru lao nong	1
吾不如老圃	wu bu ru lao pu	1
吾不试	wu bu shi	1
吾不徒行以为之椁	wu bu tu xing yi wei zhi guo	1
吾不信也	wu bu xin ye	1
吾不欲观之矣	wu bu yu guan zhi yi	1
吾不与祭	wu bu yu ji	1
吾不与也	wu bu yu ye	1
吾不知之矣	wu bu zhi zhi yi	1
吾尝终日不食	wu chang zhong ri bu shi	1
无臣而为有	wu chen er wei you	1
吾从下	wu cong xia	1
吾从众	wu cong zhong	1
吾从周	wu cong zhou	1
吾党	wu dang	1
吾党有直躬者	wu dang you zhi gong zhe	1
无道	wu dao	1
吾道一以贯之	wu dao yi yi guan zhi	1
吾得而食	wu de er shi	1
无得而逾焉	wu de er yu yan	1
无恶也	wu e ye	1
吾二臣者皆不欲也	wu er chen zhe jie bu yu ye	1
舞放郑声	wu fang zheng sheng	1
吾非斯人之徒与而谁与	wu fei si ren zhi tu yu er shui yu	1
无敢慢	wu gan man	1
勿攻人之恶	wu gong ren zhi e	1
毋固	wu gu	1
五谷不分	wu gu bu fen	1
吾何以观之哉	wu he yi guan zhi zai	1
吾何执	wu he zhi	1
呜呼	wu hu	1
吾见蹈而死者矣	wu jian dao er si zhe yi	1
吾见其进也	wu jian qi jin ye	1
吾见其居于位也	wu jian qi ju yu wei ye	1
吾见其人矣	wu jian qi ren yi	1
无见小利	wu jian xiao li	1
吾将仕矣	wu jiang shi yi	1
吾将问之	wu jiang wen zhi	1
恶居下流而讪	wu ju xia liu er shan	1
无倦	wu juan	1
无可无不可	wu ke wu bu ke	1
吾恐季孙之忧	wu kong ji sun zhi you	1
吾老矣	wu lao yi	1
吾力	wu li	1
巫马期以告	wu ma qi yi gao	1
务民之义	wu min zhi yi	1
吾末如之何也已矣	wu mo ru zhi he ye yi yi	1
无莫也	wu mo ye	1
无乃大简乎	wu nai da jian hu	1
无乃为佞乎	wu nai wei ning hu	1
吾能言之	wu neng yan zhi	1
无宁死于二三子之手乎	wu ning si yu er san zi zhi shou hu	1
吾岂	wu qi	1
吾其被发左衽矣	wu qi pi fa zuo ren yi	1
吾其为东周乎	wu qi wei dong zhou hu	1
勿欺也	wu qi ye	1
吾其与闻之	wu qi yu wen zhi	1
无求备于一人	wu qiu bei yu yi ren	1
无求生以害仁	wu qiu sheng yi hai ren	1
吾日三省吾身	wu ri san xing wu shen	1
武入于汉	wu ru yu han	1
吾少也贱	wu shao ye jian	1
侮圣人之言	wu sheng ren zhi yan	1
五十而知天命	wu shi er zhi tian ming	1
五世希不失矣	wu shi xi bu shi yi	1
无适也	wu shi ye	1
五十以学易	wu shi yi xue yi	1
吾十有五而志于学	wu shi you wu er zhi yu xue	1
勿施于人	wu shi yu ren	1
吾谁欺	wu shui qi	1
无所不佩	wu suo bu pei	1
无所祷也	wu suo dao ye	1
无所苟而已	wu suo gou er yi	1
无所归	wu suo gui	1
无所用心	wu suo yong xin	1
武王曰	wu wang yue	1
无违	wu wei	1
吾未尝不得见也	wu wei chang bu de jian ye	1
吾未尝无诲焉	wu wei chang wu hui yan	1
无为而治者	wu wei er zhi zhe	1
吾未见好德如好色者也	wu wei jian hao de ru hao se zhe ye	1
无为小人儒	wu wei xiao ren ru	1
吾闻君子不党	wu wen jun zi bu dang	1
吾闻其语矣	wu wen qi yu yi	1
吾闻之也	wu wen zhi ye	1
吾闻诸夫子	wu wen zhu fu zi	1
毋我	wu wo	1
吾无间然矣	wu wu jian ran yi	1
吾无行而不与二三子者	wu wu xing er bu yu er san zi zhe	1
毋吾以也	wu wu yi ye	1
吾无隐乎尔	wu wu yin hu er	1
无小大	wu xiao da	1
无益	wu yi	1
毋意	wu yi	1
无以立	wu yi li	1
无以立也	wu yi li ye	1
吾以女为死矣	wu yi nv wei si yi	1
无以尚之	wu yi shang zhi	1
无以万方	wu yi wan fang	1
无以为君子也	wu yi wei jun zi ye	1
无以为也	wu yi wei ye	1
吾亦为之	wu yi wei zhi	1
无以言	wu yi yan	1
吾已矣夫	wu yi yi fu	1
无以知人也	wu yi zhi ren ye	1
吾以子为异之问	wu yi zi wei yi zhi wen	1
无勇也	wu yong ye	1
无友不如己者	wu you bu ru ji zhe	1
毋友不如己者	wu you bu ru ji zhe	1
吾犹不足	wu you bu zu	1
吾友尝从事于斯矣	wu you chang cong shi yu si yi	1
吾犹及史之阙文也	wu you ji shi zhi que wen ye	1
吾犹人也	wu you ren ye	1
吾友张也	wu you zhang ye	1
吾有知乎哉	wu you zhi hu zai	1
吾与点也	wu yu dian ye	1
吾与回言终日	wu yu hui yan zhong ri	1
无欲速	wu yu su	1
吾知免夫小子	wu zhi mian fu xiao zi	1
吾止也	wu zhi ye	1
无知也	wu zhi ye	1
吾之于人也	wu zhi yu ren ye	1
吾执御矣	wu zhi yu yi	1
毋自辱焉	wu zi ru yan	1
吾自卫反鲁	wu zi wei fan lu	1
希不失矣	xi bu shi yi	1
席不正	xi bu zheng	1
奚而不丧	xi er bu sang	1
惜乎	xi hu	1
奚其丧	xi qi sang	1
奚其为为政	xi qi wei wei zheng	1
奚其正	xi qi zheng	1
奚取于三家之堂	xi qu yu san jia zhi tang	1
翕如也	xi ru ye	1
夕死可矣	xi si ke yi	1
奚为于丘之门	xi wei yu qiu zhi men	1
习相远也	xi xiang yuan ye	1
席也	xi ye	1
徙义	xi yi	1
昔者	xi zhe	1
昔者先王以为东蒙主	xi zhe xian wang yi wei dong meng zhu	1
昔者偃也闻诸夫子曰	xi zhe yan ye wen zhu fu zi yue	1
昔者由也闻诸夫子曰	xi zhe you ye wen zhu fu zi yue	1
奚自	xi zi	1
狎大人	xia da ren	1
下而饮	xia er yin	1
夏后氏以松	xia hou shi yi song	1
夏礼	xia li	1
下如授	xia ru shou	1
下学而上达	xia xue er shang da	1
先饭	xian fan	1
贤乎哉	xian hu zai	1
先进第十一	xian jin di shi yi	1
先进于礼乐	xian jin yu li yue	1
先生并行也	xian sheng bing xing ye	1
先生馔	xian sheng zhuan	1
先事后得	xian shi hou de	1
先王之道斯为美	xian wang zhi dao si wei mei	1
宪问耻	xian wen chi	1
宪问第十四	xian wen di shi si	1
贤贤易色	xian xian yi se	1
先行其言	xian xing qi yan	1
鲜矣	xian yi	1
鲜矣仁	xian yi ren	1
先有司	xian you si	1
贤哉回也	xian zai hui ye	1
贤者辟世	xian zhe pi shi	1
贤者识其大者	xian zhe shi qi da zhe	1
先之劳之	xian zhi lao zhi	1
乡党称弟焉	xiang dang cheng di yan	1
乡党第十	xiang dang di shi	1
翔而后集	xiang er hou ji	1
相夫子	xiang fu zi	1
享礼	xiang li	1
乡人皆恶之	xiang ren jie e zhi	1
乡人皆好之	xiang ren jie hao zhi	1
乡人傩	xiang ren nuo	1
乡人饮酒	xiang ren yin jiu	1
相维辟公	xiang wei pi gong	1
乡也吾见于夫子而问知	xiang ye wu jian yu fu zi er wen zhi	1
乡原	xiang yuan	1
小不忍则乱大谋	xiao bu ren ze luan da mou	1
小车无軏	xiao che wu yue	1
孝慈	xiao ci	1
小大由之	xiao da you zhi	1
小德出入可也	xiao de chu ru ke ye	1
孝弟也者	xiao di ye zhe	1
孝乎	xiao hu	1
孝乎惟孝	xiao hu wei xiao	1
小人比而不周	xiao ren bi er bu zhou	1
小人不可大受	xiao ren bu ke da shou	1
小人不知天命而不畏也	xiao ren bu zhi tian ming er bu wei ye	1
小人长戚戚	xiao ren chang qi qi	1
小人反是	xiao ren fan shi	1
小人怀惠	xiao ren huai hui	1
小人怀土	xiao ren huai tu	1
小人骄而不泰	xiao ren jiao er bu tai	1
小人难事而易说也	xiao ren nan shi er yi shuo ye	1
小人穷斯滥矣	xiao ren qiong si lan yi	1
小人求诸人	xiao ren qiu zhu ren	1
小人同而不和	xiao ren tong er bu he	1
小人下达	xiao ren xia da	1
小人学道则易使	xiao ren xue dao ze yi shi	1
小人有勇而无义为盗	xiao ren you yong er wu yi wei dao	1
小人喻于利	xiao ren yu yu li	1
小人哉	xiao ren zai	1
小人之德草	xiao ren zhi de cao	1
小人之过也	xiao ren zhi guo ye	1
孝哉	xiao zai	1
小子何莫学夫诗	xiao zi he mo xue fu shi	1
小子鸣鼓而	xiao zi ming gu er	1
亵裘长	xie qiu chang	1
信道不笃	xin dao bu du	1
信而好古	xin er hao gu	1
信而后谏	xin er hou jian	1
新谷既升	xin gu ji sheng	1
信乎	xin hu	1
信近于义	xin jin yu yi	1
信如君不君臣不臣父不父子不子	xin ru jun bu jun chen bu chen fu bu fu zi dun zi	1
信以成之	xin yi cheng zhi	1
信则民任焉	xin ze min ren yan	1
信则人任焉	xin ze ren ren yan	1
行必果	xing bi guo	1
行不笃	xing bu du	1
行不履阈	xing bu lv yu	1
行不由径	xing bu you jing	1
行笃敬	xing du jing	1
刑罚不中	xing fa bu zhong	1
行寡悔	xing gua hui	1
行己有耻	xing ji you chi	1
兴灭国	xing mie guo	1
行其义也	xing qi yi ye	1
行人子羽修饰之	xing ren zi yu xiu shi zhi	1
行夏之时	xing xia zhi shi	1
性相近也	xing xiang jin ye	1
行行如也	xing xing ru ye	1
行义以达其道	xing yi yi da qi dao	1
行有馀力	xing you yu li	1
兴于诗	xing yu shi	1
行之以忠	xing zhi yi zhong	1
行中虑	xing zhong lv	1
兄弟也	xiong di ye	1
兄弟怡怡	xiong di yi yi	1
凶服者式之	xiong fu zhe shi zhi	1
秀而不实者有矣夫	xiu er bu shi zhe you yi fu	1
修废官	xiu fei guan	1
修己以安百姓	xiu ji yi an bai xing	1
修己以安人	xiu ji yi an ren	1
修己以敬	xiu ji yi jing	1
修慝	xiu te	1
虚而为盈	xu er wei ying	1
选于众	xuan yu zhong	1
学而不思	xue er bu si	1
学而不厌	xue er bu yan	1
学而第一	xue er di yi	1
学而时习之	xue er shi xi zhi	1
学而优则仕	xue er you ze shi	1
学而知之者次也	xue er zhi zhi zhe ci ye	1
学礼乎	xue li hu	1
血气方刚	xue qi fang gang	1
血气既衰	xue qi ji shuai	1
血气未定	xue qi wei ding	1
学如不及	xue ru bu ji	1
学诗乎	xue shi hu	1
学也	xue ye	1
学则不固	xue ze bu gu	1
学之不讲	xue zhi bu jiang	1
迅雷风烈必变	xun lei feng lie bi bian	1
恂恂如也	xun xun ru ye	1
巽与之言	xun yu zhi yan	1
亚饭干适楚	ya fan gan shi chu	1
雅颂各得其所	ya song ge de qi suo	1
言必信	yan bi xin	1
言必有中	yan bi you zhong	1
言不及义	yan bu ji yi	1
言不可不慎也夫子之不可及	yan bu ke bu shen ye fu zi zhi bu ke ji	1
言不可以若是其几也	yan bu ke yi ruo shi qi ji ye	1
言不顺	yan bu shun	1
言不忠信	yan bu zhong xin	1
焉得俭	yan de jian	1
焉得知	yan de zhi	1
言而有信	yan er you xin	1
言寡尤	yan gua you	1
言乎	yan hu	1
言及之而不言谓之隐	yan ji zhi er bu yan wei zhi yin	1
言可复也	yan ke fu ye	1
焉可诬也	yan ke wu ye	1
颜路请子之车以为之椁	yan lu qing zi zhi che yi wei zhi guo	1
焉能事鬼	yan neng shi gui	1
焉能为亡	yan neng wei wang	1
焉能为有	yan neng wei you	1
焉能系而不食	yan neng xi er bu shi	1
厌其笑	yan qi xiao	1
俨然人望而畏之	yan ran ren wang er wei zhi	1
言思忠	yan si zhong	1
焉往	yan wang	1
言未及之而言谓之躁	yan wei ji zhi er yan wei zhi zao	1
焉用稼	yan yong jia	1
焉用杀	yan yong sha	1
言游过矣	yan you guo yi	1
言语	yan yu	1
颜渊第十二	yan yuan di shi er	1
颜渊后	yan yuan hou	1
颜渊喟然叹曰	yan yuan kui ran tan yue	1
颜渊闵子骞冉伯牛仲弓	yan yuan min zi qian ran bo niu zhong gong	1
颜渊死	yan yuan si	1
颜渊问仁	yan yuan wen ren	1
颜渊问为邦	yan yuan wen wei bang	1
颜渊曰	yan yuan yue	1
言之必可行也	yan zhi bi ke xing ye	1
言之得无讱乎	yan zhi de wu ren hu	1
焉知来者之不如今也	yan zhi lai zhe zhi bu ru jin ye	1
焉知死	yan zhi si	1
焉知贤才而举之	yan zhi xian cai er ju zhi	1
偃之言是也	yan zhi yan shi ye	1
言中伦	yan zhong lun	1
言忠信	yan zhong xin	1
阳货第十七	yang huo di shi qi	1
阳货欲见孔子	yang huo yu jian kong zi	1
洋洋乎盈耳哉	yang yang hu ying er zai	1
仰之弥高	yang zhi mi gao	1
尧舜其犹病	yao shun qi you bing	1
尧舜其犹病诸	yao shun qi you bing zhu	1
夭夭如也	yao yao ru ye	1
尧曰	yao yue	1
尧曰第二十	yao yue di er shi	1
叶公问孔子于子路	ye gong wen kong zi yu zi lu	1
叶公问政	ye gong wen zheng	1
叶公语孔子曰	ye gong yu kong zi yue	1
野人也	ye ren ye	1
野哉	ye zai	1
异邦人称之亦曰君夫人	yi bang ren cheng zhi yi yue jun fu ren	1
衣敝缊袍	yi bi yun pao	1
以别乎	yi bie hu	1
亦不从也	yi bu cong ye	1
以不教民战	yi bu jiao min zhan	1
亦不可行也	yi bu ke xing ye	1
亦不入于室	yi bu ru yu shi	1
弋不射宿	yi bu she su	1
亦不失言	yi bu shi yan	1
以成	yi cheng	1
一箪食	yi dan shi	1
以道事君	yi dao shi jun	1
以德报德	yi de bao de	1
以德报怨	yi de bao yuan	1
夷狄之有君	yi di zhi you jun	1
以多问于寡	yi duo wen yu gua	1
已而已而	yi er yi er	1
仪封人请见	yi feng ren qing jian	1
衣夫锦	yi fu jin	1
以服事殷	yi fu shi yin	1
以告者过也	yi gao zhe guo ye	1
亦各言其志也	yi ge yan qi zhi ye	1
亦各言其志也已矣	yi ge yan qi zhi ye yi yi	1
亦各言其子也	yi ge yan qi zi ye	1
异乎三子者之撰	yi hu san zi zhe zhi zhuan	1
异乎吾所闻	yi hu wu suo wen	1
以季孟之间待之	yi ji meng zhi jian dai zhi	1
以就有道	yi jiu you dao	1
亦可	yi ke	1
亦可以弗畔矣夫	yi ke yi fu pan yi fu	1
亦可以即戎矣	yi ke yi ji rong yi	1
亦可以胜残去杀矣	yi ke yi sheng can qu sha yi	1
亦可以为成人矣	yi ke yi wei cheng ren yi	1
一匡天下	yi kuang tian xia	1
以莅之	yi li zhi	1
以临其民	yi lin qi min	1
逸民	yi min	1
抑末也	yi mo ye	1
以能问于不能	yi neng wen yu bu neng	1
一瓢饮	yi piao yin	1
衣前后	yi qian hou	1
衣轻裘	yi qing qiu	1
义然后取	yi ran hou qu	1
揖让而升	yi rang er sheng	1
一日克己复礼	yi ri ke ji fu li	1
绎如也	yi ru ye	1
翼如也	yi ru ye	1
羿善射	yi shan she	1
以思	yi si	1
以俟君子	yi si jun zi	1
疑思问	yi si wen	1
揖所与立	yi suo yu li	1
以为谤己也	yi wei bang ji ye	1
抑为之不厌	yi wei zhi bu yan	1
以吾从大夫之后	yi wu cong da fu zhi hou	1
揖巫马期而进之	yi wu ma qi er jin zhi	1
以吾一日长乎尔	yi wu yi ri chang hu er	1
亦奚以为	yi xi yi wei	1
一言而可以兴邦	yi yan er ke yi xing bang	1
一言而丧邦	yi yan er sang bang	1
一言以蔽之	yi yan yi bi zhi	1
一言以为不知	yi yan yi wei bu zhi	1
益矣	yi yi	1
已矣乎	yi yi hu	1
抑亦可以为	yi yi ke yi wei	1
怡怡如也	yi yi ru ye	1
抑亦先觉者	yi yi xian jue zhe	1
以雍彻	yi yong che	1
亦有恶乎	yi you e hu	1
以友辅仁	yi you fu ren	1
以与尔邻里乡党乎	yi yu er lin li xiang dang hu	1
依于仁	yi yu ren	1
抑与之与	yi yu zhi yu	1
以约失之者鲜矣	yi yue shi zhi zhe xian yi	1
亿则屡中	yi ze lv zhong	1
一则以惧	yi ze yi ju	1
一则以喜	yi ze yi xi	1
以杖	yi zhang	1
以杖荷	yi zhang he	1
一朝之忿	yi zhao zhi fen	1
益者三乐	yi zhe san le	1
益者三友	yi zhe san you	1
益者与	yi zhe yu	1
以直报怨	yi zhi bao yuan	1
绎之为贵	yi zhi wei gui	1
亦只以异	yi zhi yi yi	1
义之与比	yi zhi yu bi	1
已知之矣	yi zhi zhi yi	1
以忠	yi zhong	1
亦足以发	yi zu yi fa	1
因不失其亲	yin bu shi qi qin	1
隐居放言	yin ju fang yan	1
隐居以	yin ju yi	1
殷礼	yin li	1
因民之所利而利之	yin min zhi suo li er li zhi	1
殷人以柏	yin ren yi bai	1
饮水	yin shui	1
訚訚如也	yin yin ru ye	1
殷因于夏礼	yin yin yu xia li	1
殷有三仁焉	yin you san ren yan	1
隐者也	yin zhe ye	1
因之以饥馑	yin zhi yi ji jin	1
用不臧	yong bu zang	1
用不足	yong bu zu	1
咏而归	yong er gui	1
勇而无礼则乱	yong er wu li ze luan	1
雍虽不敏	yong sui bu min	1
雍也	yong ye	1
雍也第六	yong ye di liu	1
勇者不必有仁	yong zhe bu bi you ren	1
勇者不惧	yong zhe bu ju	1
雍之言然	yong zhi yan ran	1
用之则行	yong zhi ze xing	1
有鄙夫问于我	you bi fu wen yu wo	1
游必有方	you bi you fang	1
友便辟	you bian pi	1
有耻且格	you chi qie ge	1
有德者必有言	you de zhe bi you yan	1
又多能也	you duo neng ye	1
友多闻	you duo wen	1
有恶	you e	1
耰而不辍	you er bu chuo	1
幼而不孙弟	you er bu sun di	1
有反坫	you fan dian	1
有妇人焉	you fu ren yan	1
有父兄在	you fu xiong zai	1
有棺而无椁	you guan er wu guo	1
又何加焉	you he jia yan	1
有荷蒉而过孔氏之门者	you he kuai er guo kong shi zhi men zhe	1
又何怨	you he yuan	1
有教无类	you jiao wu lei	1
又尽善也	you jin shan ye	1
又敬不违	you jing bu wei	1
有酒食	you jiu shi	1
犹可逾也	you ke yu ye	1
犹恐失之	you kong shi zhi	1
友谅	you liang	1
有马者	you ma zhe	1
有美玉于斯	you mei yu yu si	1
有民人焉	you min ren yan	1
犹能肆诸市朝	you neng si zhu shi chao	1
有能一日用其力于仁矣乎	you neng yi ri yong qi li yu ren yi hu	1
有朋自远方来	you peng zi yuan fang lai	1
有便佞	you pian ning	1
又其次也	you qi ci ye	1
友其士之仁者	you qi shi zhi ren zhe	1
有容色	you rong se	1
有若对曰	you ruo dui yue	1
有若无	you ruo wu	1
有杀身以成仁	you sha shen yi cheng ren	1
友善柔	you shan rou	1
有社稷	you she ji	1
有盛馔	you sheng zhuan	1
有事	you shi	1
有是言也	you shi yan ye	1
有始有卒者	you shi you zu zhe	1
有是哉	you shi zai	1
又谁怨	you shui yuan	1
有所不行	you suo bu xing	1
有澹台灭明者	you tan tai mie ming zhe	1
犹天之不可阶而升也	you tian zhi bu ke jie er sheng ye	1
有恸乎	you tong hu	1
又闻君子之远其子也	you wen jun zi zhi yuan qi zi ye	1
犹贤乎已	you xian hu yi	1
又相之	you xiang zhi	1
有心哉	you xin zai	1
有颜回者好学	you yan hui zhe hao xue	1
又焉贪	you yan tan	1
有言者不必有德	you yan zhe bu bi you de	1
由也	you ye	1
由也果	you ye guo	1
由也兼人	you ye jian ren	1
由也升堂矣	you ye sheng tang yi	1
由也为之	you ye wei zhi	1
由也问闻斯行诸	you ye wen wen si xing zhu	1
由也喭	you ye yan	1
有一言而可以终身行之者乎	you yi yan er ke yi zhong shen xing zhi zhe hu	1
又欲其死	you yu qi si	1
友于兄弟	you yu xiong di	1
游于艺	you yu yi	1
有政	you zheng	1
友直	you zhi	1
有之	you zhi	1
由之瑟	you zhi se	1
由之行诈也	you zhi xing zha ye	1
犹之与人也	you zhi yu ren ye	1
有诸	you zhu	1
有子曰	you zi yue	1
有罪不敢赦	you zui bu gan she	1
欲罢不能	yu ba bu neng	1
玉帛云乎哉	yu bo yun hu zai	1
予不得视犹子也	yu bu de shi you zi ye	1
于从政乎何有	yu cong zheng hu he you	1
欲而不贪	yu er bu tan	1
与父	yu fu	1
欲寡其过而未能也	yu gua qi guo er wei neng ye	1
浴乎沂	yu hu yi	1
禹稷躬稼而有天	yu ji gong jia er you tian	1
欲洁其身	yu jie qi shen	1
于今称之	yu jin cheng zhi	1
与君子人也	yu jun zi ren ye	1
鱼馁而肉败	yu nei er rou bai	1
于女安乎	yu nv an hu	1
与朋友交	yu peng you jiao	1
与朋友交而不信乎	yu peng you jiao er bu xin hu	1
与其不孙也	yu qi bu sun ye	1
与其洁也	yu qi jie ye	1
与其进也	yu qi jin ye	1
与其媚于奥	yu qi mei yu ao	1
与求之问	yu qiu zhi wen	1
欲仁而得仁	yu ren er de ren	1
与人恭而有礼	yu ren gong er you li	1
于人何所不容	yu ren he suo bu rong	1
与人忠	yu ren zhong	1
与如也	yu ru ye	1
与上大夫言	yu shang da fu yan	1
与师言之道与	yu shi yan zhi dao yu	1
于斯二者何先	yu si er zhe he xian	1
于斯三者何先	yu si san zhe he xian	1
于斯为盛	yu si wei sheng	1
于斯文也	yu si wen ye	1
予死于道路乎	yu si yu dao lu hu	1
欲速成者也	yu su cheng zhe ye	1
欲速则不达	yu su ze bu da	1
予所否者	yu suo fou zhe	1
与文子同升诸公	yu wen zi tong sheng zhu gong	1
于我	yu wo	1
于我殡	yu wo bin	1
予无乐乎为君	yu wu le hu wei jun	1
于吾言无所不说	yu wu yan wu suo bu shuo	1
与下大夫言	yu xia dai fu yan	1
予小子履	yu xiao zi lv	1
予也有三年之爱于其父母乎	yu ye you san nian zhi ai yu qi fu mu hu	1
与衣狐貉者立	yu yi hu he zhe li	1
与易也	yu yi ye	1
予一以贯之	yu yi yi guan zhi	1
予有乱臣十人	yu you luan chen shi ren	1
郁郁乎文哉	yu yu hu wen zai	1
愉愉如也	yu yu ru ye	1
予欲无言	yu yu wu yan	1
欲与之言	yu yu zhi yan	1
遇丈人	yu zhang ren	1
予之不仁也	yu zhi bu ren ye	1
语之而不惰者	yu zhi er bu duo zhe	1
与之釜	yu zhi fu	1
与之粟九百	yu zhi su jiu bai	1
与之庾	yu zhi yu	1
遇诸途	yu zhu tu	1
远耻辱也	yuan chi ru ye	1
怨乎	yuan hu	1
远佞人	yuan ning ren	1
原壤夷俟	yuan rang yi si	1
远人不服	yuan ren bu fu	1
原思为之宰	yuan si wei zhi zai	1
愿为小相焉	yuan wei xiao xiang yan	1
愿学焉	yuan xue yan	1
远者来	yuan zhe lai	1
远之事君	yuan zhi shi jun	1
远之有	yuan zhi you	1
远之则怨	yuan zhi ze yuan	1
约而为泰	yue er wei tai	1
乐节礼乐	yue jie li yue	1
约我以礼	yue wo yi li	1
月无忘其所能	yue wu wang qi suo neng	1
约之以礼	yue zhi yi li	1
韫椟而藏诸	yun du er cang zhu	1
允执其中	yun zhi qi zhong	1
再拜而送之	zai bai er song zhi	1
在邦必达	zai bang bi da	1
在邦必闻	zai bang bi wen	1
在邦无怨	zai bang wu yuan	1
在陈绝粮	zai chen jue liang	1
在家必达	zai jia bi da	1
在家必闻	zai jia bi wen	1
在家无怨	zai jia wu yuan	1
在陋巷	zai lou xiang	1
在人	zai ren	1
宰我出	zai wo chu	1
宰我对曰	zai wo dui yue	1
宰我问	zai wo wen	1
宰我问曰	zai wo wen yue	1
宰我子贡	zai wo zi gong	1
在舆	zai yu	1
在予一人	zai yu yi ren	1
臧文仲其窃位者与	zang wen zhong qi qie wei zhe yu	1
臧武仲以防求为后于鲁	zang wu zhong yi fang qiu wei hou yu lu	1
葬之以礼	zang zhi yi li	1
造次必于是	zao ci bi yu shi	1
则哀矜而勿喜	ze ai jin er wu xi	1
则安之	ze an zhi	1
择不处仁	ze bu chu ren	1
则不复也	ze bu fu ye	1
则不歌	ze bu ge	1
则不弃	ze bu qi	1
则不威	ze bu wei	1
则尝闻之矣	ze chang wen zhi yi	1
则殆	ze dai	1
则寡悔	ze gua hui	1
则寡尤	ze gua you	1
则何以哉	ze he yi zai	1
则见其倚于衡也	ze jian qi yi yu heng ye	1
则将焉用彼相矣	ze jiang yan yong bi xiang yi	1
则敬	ze jing	1
择可劳而劳之	ze ke lao er lao zhi	1
则可谓云尔已矣	ze ke wei yun er yi yi	1
则可矣	ze ke yi	1
则礼乐不兴	ze li yue bu xing	1
则礼乐征伐自天子出	ze li yue zheng fa zi tian zi chu	1
则礼乐征伐自诸侯	ze li yue zheng fa zi zhu hou	1
则民	ze min	1
则民不敬	ze min bu jing	1
则民不偷	ze min bu tou	1
则民服	ze min fu	1
则民莫敢不敬	ze min mo gan bu jing	1
则民莫敢不用情	ze min mo gan bu yong qing	1
则民无所错手足	ze min wu suo cuo shou zu	1
则民兴于仁	ze min xing yu ren	1
则民易使也	ze min yi shi ye	1
择其善者而从之	ze qi shan zhe er cong zhi	1
则劝	ze quan	1
则谁与	ze shei yu	1
则事不成	ze shi bu cheng	1
则庶人不议	ze shu ren bu yi	1
则四方之民襁负其子而至矣	ze si fang zhi min qiang fu qi zi er zhi yi	1
则罔	ze wang	1
则为之	ze wei zhi	1
则为之也难	ze wei zhi ye nan	1
则吾必在汶	ze wu bi zai wen	1
则吾从先进	ze wu cong xian jin	1
则吾岂敢	ze wu qi gan	1
则吾未之有得	ze wu wei zhi you de	1
则小子何述焉	ze xiao zi he shu yan	1
则刑罚不中	ze xing fa bu zhong	1
则修文德以来之	ze xiu wen de yi lai zhi	1
则言不顺	ze yan bu shun	1
则以为厉己也	ze yi wei li ji ye	1
则以学文	ze yi xue wen	1
则隐	ze yin	1
则有司存	ze you si cun	1
则远怨矣	ze yuan yuan yi	1
则政不在大夫	ze zheng bu zai dai fu	1
则忠	ze zhong	1
贼夫人之子	zei fu ren zhi zi	1
曾子言曰	zeng zi yan yue	1
曾子有疾	zeng zi you ji	1
曾子曰	zeng zi yue	1
斋战疾	zhai zhan ji	1
战战兢兢	zhan zhan jing jing	1
瞻之在前	zhan zhi zai qian	1
丈人曰	zhang ren yue	1
长幼之节	zhang you zhi jie	1
杖者出	zhang zhe chu	1
昭公知礼乎	zhao gong zhi li hu	1
召忽死之	zhao hu si zhi	1
召门弟子曰	zhao men di zi yue	1
朝闻道	zhao wen dao	1
袗絺绤	zhen chi xi	1
朕躬有罪	zhen gong you zui	1
政逮于大夫四世矣	zheng dai yu dai fu si shi yi	1
正其衣冠	zheng qi yi guan	1
郑声淫	zheng sheng yin	1
政事	zheng shi	1
正唯弟子不能学也	zheng wei di zi bu neng xue ye	1
正颜色	zheng yan shai	1
正也	zheng ye	1
政者	zheng zhe	1
治宾客	zhi bin ke	1
直道而事人	zhi dao er shi ren	1
执德不弘	zhi de bu hong	1
知德者鲜矣	zhi de zhe xian yi	1
直而无礼则绞	zhi er wu li ze jiao	1
执圭	zhi gui	1
知和	zhi he	1
知及之	zhi ji zhi	1
知礼	zhi li	1
知柳下惠之贤	zhi liu xia hui zhi xian	1
之民归心焉	zhi min gui xin yan	1
知其说者之于天下也	zhi qi shuo zhe zhi yu tian xia ye	1
指其掌	zhi qi zhang	1
植其杖而芸	zhi qi zhang er yun	1
知人	zhi ren	1
之三子告	zhi san zi gao	1
执射乎	zhi she hu	1
质胜文则野	zhi sheng wen ze ye	1
执事敬	zhi shi jing	1
志士仁人	zhi shi ren ren	1
之所以直道而行也	zhi suo yi zhi dao er xing ye	1
知我者其天乎	zhi wo zhe qi tian hu	1
知也	zhi ye	1
质犹文也	zhi you wen ye	1
至于道	zhi yu dao	1
志于道	zhi yu dao	1
执御乎	zhi yu hu	1
至于鲁	zhi yu lu	1
至于犬马	zhi yu quan ma	1
致远恐泥	zhi yuan kong ni	1
直在其中矣	zhi zai qi zhong yi	1
直哉史鱼	zhi zai shi yu	1
直则民不服	zhi ze min bu fu	1
至则行矣	zhi ze xing yi	1
知者不惑	zhi zhe bu huo	1
知者不失人	zhi zhe bu shi ren	1
知者动	zhi zhe dong	1
知者乐	zhi zhe le	1
知者乐水	zhi zhe le shui	1
知者利仁	zhi zhe li ren	1
之政	zhi zheng	1
知之次也	zhi zhi ci ye	1
质直而好义	zhi zhi er hao yi	1
知之为知之	zhi zhi wei zhi zhi	1
知之者	zhi zhi zhe	1
之直者异于是	zhi zhi zhe yi yu shi	1
止子路宿	zhi zi lu su	1
中道而废	zhong dao er fei	1
众恶之	zhong e zhi	1
忠告而善道之	zhong gao er shan dao zhi	1
仲弓为季氏宰	zhong gong wei ji shi zai	1
仲弓问仁	zhong gong wen ren	1
仲弓问子桑伯子	zhong gong wen zi sang bo zi	1
仲弓曰	zhong gong yue	1
钟鼓云乎哉	zhong gu yun hu zai	1
众好之	zhong hao zhi	1
仲尼	zhong ni	1
仲尼不可毁也	zhong ni bu ke hui ye	1
仲尼岂贤于子乎	zhong ni qi xian yu zi hu	1
仲尼焉学	zhong ni yan xue	1
中人以上	zhong ren yi shang	1
中人以下	zhong ren yi xia	1
忠恕而已矣	zhong shu er yi yi	1
仲叔圉	zhong shu yu	1
仲相桓公	zhong xiang huan gong	1
忠焉	zhong yan	1
终夜不寝	zhong ye bu qin	1
中矣	zhong yi	1
中庸之为德也	zhong yong zhi wei de ye	1
仲由可使从政也与	zhong you ke shi cong zheng ye yu	1
仲由冉求	zhong you ran qiu	1
仲知礼乎	zhong zhi li hu	1
周公谓鲁公曰	zhou gong wei lu gong yue	1
周监于二代	zhou jian yu er dai	1
周人以栗	zhou ren yi li	1
周任有言曰	zhou ren you yan yue	1
周因于	zhou yin yu	1
周有八士	zhou you ba shi	1
周有大赉	zhou you da lai	1
纣之不善	zhou zhi bu shan	1
周之德	zhou zhi de	1
诸片言可以折狱者	zhu pian yan ke yi zhe yu zhe	1
祝鮀治宗庙	zhu tuo zhi zong miao	1
主忠信	zhu zhong xin	1
庄以莅之	zhuang yi li zhi	1
子不语怪力乱神	zi bu yu guai li luan shen	1
自大夫出	zi da fu chu	1
子钓而不纲	zi diao er bu gang	1
子笃于亲	zi du yu qin	1
咨尔舜	zi er shun	1
子服景伯以告	zi fu jing bo yi gao	1
子服景伯以告子贡	zi fu jing bo yi gao zi gong	1
子告之曰	zi gao zhi yue	1
子贡	zi gong	1
子贡方人	zi gong fang ren	1
子贡问	zi gong wen	1
子贡问君子	zi gong wen jun zi	1
子贡问为仁	zi gong wen wei ren	1
子贡问友	zi gong wen you	1
子贡问曰	zi gong wen yue	1
子贡问政	zi gong wen zheng	1
子贡贤于仲尼	zi gong xian yu zhong ni	1
子贡欲去告朔之饩羊	zi gong yu qu gao shuo zhi xi yang	1
子贡曰	zi gong yue	1
自古皆有死	zi gu jie you si	1
子固穷	zi gu qiong	1
子罕第九	zi han di jiu	1
子罕言利与命与仁	zi han yan li yu ming yu ren	1
子华使于齐	zi hua shi yu qi	1
子疾病	zi ji bing	1
子击磬于卫	zi ji qing yu wei	1
子见夫子乎	zi jian fu zi hu	1
子见南子	zi jian nan zi	1
子见齐衰者冕衣裳者与瞽者	zi jian qi shuai zhe mian yi shang zhe yu gu zhe	1
子将奚先	zi jiang xi xian	1
自经于沟渎而莫之知也	zi jing yu gou du er mo zhi zhi ye	1
子绝四	zi jue si	1
自孔氏	zi kong shi	1
子哭之恸	zi ku zhi tong	1
子乐	zi le	1
子路	zi lu	1
子路不对	zi lu bu dui	1
子路不说	zi lu bu shuo	1
子路曾皙冉有公西华侍坐	zi lu ceng xi ran you gong xi hua shi zuo	1
子路从而后	zi lu cong er hou	1
子路第十三	zi lu di shi san	1
子路对曰	zi lu dui yue	1
子路拱而立	zi lu gong er li	1
子路共之	zi lu gong zhi	1
子路请祷	zi lu qing dao	1
子路使门人为臣	zi lu shi men ren wei chen	1
子路使子羔为费宰	zi lu shi zi gao wei fei zai	1
子路率尔而对曰	zi lu shuai er er dui yue	1
子路宿于石门	zi lu su yu shi men	1
子路问	zi lu wen	1
子路问成人	zi lu wen cheng ren	1
子路问君子	zi lu wen jun zi	1
子路问事君	zi lu wen shi jun	1
子路问曰	zi lu wen yue	1
子路问政	zi lu wen zheng	1
子路无宿诺	zi lu wu su nuo	1
子路行以告	zi lu xing yi gao	1
子路曰	zi lu yue	1
子路愠见曰	zi lu yun jian yue	1
子路终身诵之	zi lu zhong shen song zhi	1
子禽问于子贡曰	zi qin wen yu zi gong yue	1
子如不言	zi ru bu yan	1
子入太庙	zi ru tai miao	1
子生三年	zi sheng san nian	1
子适卫	zi shi wei	1
子食于有丧者之侧	zi shi yu you sang zhe zhi ce	1
子帅以正	zi shuai yi zheng	1
子所雅言	zi suo ya yan	1
子恸矣	zi tong yi	1
子退朝	zi tui chao	1
子谓伯鱼曰	zi wei bo yu yue	1
子为父隐	zi wei fu yin	1
子为恭也	zi wei gong ye	1
子未可以去乎	zi wei ke yi qu hu	1
子谓冉有曰	zi wei ran you yue	1
子谓韶	zi wei shao	1
子为谁	zi wei shui	1
子谓卫公子荆	zi wei wei gong zi jing	1
子谓颜渊曰	zi wei yan yuan yue	1
子畏于匡	zi wei yu kuang	1
子为政	zi wei zheng	1
子谓仲弓曰	zi wei zhong gong yue	1
子谓子夏曰	zi wei zi xia yue	1
子温而厉	zi wen er li	1
子问公叔文子于公明贾曰	zi wen gong shu wen zi yu gong ming jia yue	1
子问之	zi wen zhi	1
子闻之	zi wen zhi	1
子闻之曰	zi wen zhi yue	1
子奚不为政	zi xi bu wei zheng	1
子夏为莒父宰	zi xia wei ju fu zai	1
子夏问孝	zi xia wen xiao	1
子夏问曰	zi xia wen yue	1
子夏闻之	zi xia wen zhi	1
子夏曰	zi xia yue	1
子夏云何	zi xia yun he	1
子夏之门人问交于子张	zi xia zhi men ren wen jiao yu zi zhang	1
子夏之门人小子	zi xia zhi men ren xiao zi	1
子行三军	zi xing san jun	1
自行束修以上	zi xing shu xiu yi shang	1
子言卫灵公之无道也	zi yan wei ling gong zhi wu dao ye	1
子也	zi ye	1
缁衣	zi yi	1
子以四教	zi yi si jiao	1
子亦有异闻乎	zi yi you yi wen hu	1
子游对曰	zi you dui yue	1
子游为武城宰	zi you wei wu cheng zai	1
子游问孝	zi you wen xiao	1
子游曰	zi you yue	1
自牖执其手	zi you zhi qi shou	1
子游子夏	zi you zi xia	1
子欲居九夷	zi yu ju jiu yi	1
子语鲁大师乐	zi yu lu da shi le	1
子与人歌而善	zi yu ren ge er shan	1
子欲善而民善矣	zi yu shan er min shan yi	1
子于是日哭	zi yu shi ri ku	1
子欲往	zi yu wang	1
子曰	zi yue	1
子云	zi yun	1
子在	zi zai	1
子在川上曰	zi zai chuan shang yue	1
子在齐	zi zai qi	1
子张第十九	zi zhang di shi jiu	1
子张对曰	zi zhang dui yue	1
子张书诸绅	zi zhang shu zhu shen	1
子张问	zi zhang wen	1
子张问崇德辨惑	zi zhang wen chong de bian huo	1
子张问明	zi zhang wen ming	1
子张问仁于孔子	zi zhang wen ren yu kong zi	1
子张问善人之道	zi zhang wen shan ren zhi dao	1
子张问行	zi zhang wen xing	1
子张问于孔子曰	zi zhang wen yu kong zi yue	1
子张问曰	zi zhang wen yue	1
子张问政	zi zhang wen zheng	1
子张学干禄	zi zhang xue gan lu	1
子张曰	zi zhang yue	1
子之居丧	zi zhi ju sang	1
子之所慎	zi zhi suo shen	1
子之往也	zi zhi wang ye	1
子之武城	zi zhi wu cheng	1
子之燕居	zi zhi yan ju	1
子之迂也	zi zhi yu ye	1
自诸侯出	zi zhu hou chu	1
宗庙会同	zong miao hui tong	1
宗庙之事	zong miao zhi shi	1
宗也	zong ye	1
宗族称孝焉	zong zu cheng xiao yan	1
足兵	zu bing	1
俎豆之事	zu dou zhi shi	1
足躩	zu jue	1
足躩如也	zu jue ru ye	1
足食	zu shi	1
足蹜如有循	zu su ru you xun	1
足则吾能征之矣	zu ze wu neng zheng zhi yi	1
钻燧改火	zuan sui gai huo	1
钻之弥坚	zuan zhi mi jian	1
罪在朕躬	zui zai zhen gong	1
尊其瞻视	zun qi zhan shi	1
尊五美	zun wu mei	1
左右手	zuo you shou	1
作者七人矣	zuo zhe qi ren yi	1
